Year,Player,Position,Age,Team,Games,Minutes_played,Field_Goals,Field_Goal_Attempts,Goals_3P,Goals_3P_attempt,Goals_2P,Goals_2P_attempt,FT,FTA,Points
1980,Kareem Abdul-Jabbar*,C,32,LAL,82,3143,835,1383,0,1,835,1382,364,476,2034
1980,Tom Abernethy,PF,25,GSW,67,1222,153,318,0,1,153,317,56,82,362
1980,Alvan Adams,C,25,PHO,75,2168,465,875,0,2,465,873,188,236,1118
1980,Tiny Archibald*,PG,31,BOS,80,2864,383,794,4,18,379,776,361,435,1131
1980,Dennis Awtrey,C,31,CHI,26,560,27,60,0,0,27,60,32,50,86
1980,Gus Bailey,SG,28,WSB,20,180,16,35,1,1,15,34,5,13,38
1980,James Bailey,PF,22,SEA,67,726,122,271,0,0,122,271,68,101,312
1980,Greg Ballard,SF,25,WSB,82,2438,545,1101,16,47,529,1054,171,227,1277
1980,Mike Bantom,SF,28,IND,77,2330,384,760,1,3,383,757,139,209,908
1980,Marvin Barnes,PF,27,SDC,20,287,24,60,0,0,24,60,16,32,64
1980,Rick Barry*,SF,35,HOU,72,1816,325,771,73,221,252,550,143,153,866
1980,Tim Bassett,PF,28,TOT,12,164,12,34,0,0,12,34,10,15,34
1980,Tim Bassett,PF,28,NJN,7,92,8,22,0,0,8,22,8,12,24
1980,Tim Bassett,PF,28,SAS,5,72,4,12,0,0,4,12,2,3,10
1980,Billy Ray,SG,23,POR,16,235,72,146,8,19,64,127,28,39,180
1980,Ron Behagen,PF,29,WSB,6,64,9,23,0,0,9,23,5,6,23
1980,Kent Benson,C,25,TOT,73,1891,299,618,1,5,298,613,99,141,698
1980,Kent Benson,C,25,MIL,56,1389,213,431,0,1,213,430,66,97,492
1980,Kent Benson,C,25,DET,17,502,86,187,1,4,85,183,33,44,206
1980,Del Beshore,PG,23,CHI,68,869,88,250,10,26,78,224,58,87,244
1980,Henry Bibby,PG,30,PHI,82,2035,251,626,11,52,240,574,226,286,739
1980,Larry Bird*,PF,23,BOS,82,2955,693,1463,58,143,635,1320,301,360,1745
1980,Otis Birdsong,SG,24,KCK,82,2885,781,1546,10,36,771,1510,286,412,1858
1980,Ron Boone,SG,33,TOT,81,2392,405,915,19,50,386,865,175,196,1004
1980,Ron Boone,SG,33,LAL,6,106,14,40,0,0,14,40,6,7,34
1980,Ron Boone,SG,33,UTA,75,2286,391,875,19,50,372,825,169,189,970
1980,Lawrence Boston,PF,23,WSB,13,125,24,52,0,0,24,52,8,13,56
1980,Tom Boswell,PF,26,TOT,79,2077,346,613,5,10,341,603,206,273,903
1980,Tom Boswell,PF,26,DEN,18,522,72,135,1,2,71,133,58,70,203
1980,Tom Boswell,PF,26,UTA,61,1555,274,478,4,8,270,470,148,203,700
1980,Winford Boynes,SG,22,NJN,64,1102,221,467,0,4,221,463,104,136,546
1980,Alonzo Bradley,SF,26,HOU,22,96,17,48,1,1,16,47,6,9,41
1980,Dudley Bradley,SG,22,IND,82,2027,275,609,2,5,273,604,136,174,688
1980,Mike Bratz,PG,24,PHO,82,1589,269,687,21,86,248,601,141,162,700
1980,Jim Brewer,PF,28,POR,67,1016,90,184,0,5,90,179,14,29,194
1980,Ron Brewer,SG,24,POR,82,2815,548,1182,6,32,542,1150,184,219,1286
1980,Junior Bridgeman,SF,26,MIL,81,2316,594,1243,5,27,589,1216,230,266,1423
1980,Allan Bristow,SF,28,UTA,82,2304,377,785,2,7,375,778,197,243,953
1980,Fred Brown,SG,31,SEA,80,1701,404,843,39,88,365,755,113,135,960
1980,John Brown,SF,28,TOT,32,385,37,105,0,0,37,105,38,48,112
1980,John Brown,SF,28,UTA,4,24,0,7,0,0,0,7,4,4,4
1980,John Brown,SF,28,ATL,28,361,37,98,0,0,37,98,34,44,108
1980,Roger Brown,C,29,CHI,4,37,1,3,0,0,1,3,0,0,2
1980,Joe Bryant,PF,25,SDC,81,2328,294,682,5,34,289,648,161,217,754
1980,Quinn Buckner,PG,25,MIL,67,1690,306,655,2,5,304,650,105,143,719
1980,Tom Burleson,C,27,KCK,37,272,36,104,0,3,36,101,23,40,95
1980,Don Buse,PG,29,PHO,81,2499,261,589,19,79,242,510,85,128,626
1980,Marty Byrnes,SF,23,LAL,32,194,25,50,0,0,25,50,13,15,63
1980,Corky Calhoun,SF,29,IND,7,30,4,9,0,0,4,9,0,2,8
1980,Mack Calvin,PG,32,UTA,48,772,100,227,1,11,99,216,105,117,306
1980,Austin Carr,SG,31,CLE,77,1595,390,839,2,6,388,833,127,172,909
1980,Kenny Carr,PF,24,TOT,79,1838,378,768,0,4,378,764,173,263,929
1980,Kenny Carr,PF,24,LAL,5,57,7,16,0,0,7,16,2,2,16
1980,Kenny Carr,PF,24,CLE,74,1781,371,752,0,4,371,748,171,261,913
1980,M.L. Carr,SF,29,BOS,82,1994,362,763,12,41,350,722,178,241,914
1980,Bob Carrington,SG,26,SDC,10,134,15,37,0,2,15,35,6,8,36
1980,Ron Carter,SG,23,IND,13,117,15,37,0,0,15,37,2,7,32
1980,Bill Cartwright,C,22,NYK,82,3150,665,1215,0,0,665,1215,451,566,1781
1980,Harvey Catchings,C,28,MIL,72,1366,97,244,0,1,97,243,39,62,233
1980,Don Chaney,SG,33,BOS,60,523,67,189,1,6,66,183,32,42,167
1980,Maurice Cheeks,PG,23,PHI,79,2623,357,661,4,9,353,652,180,231,898
1980,Phil Chenier,SG,29,TOT,43,850,136,349,5,12,131,337,49,67,326
1980,Phil Chenier,SG,29,WSB,20,470,84,214,3,6,81,208,31,41,202
1980,Phil Chenier,SG,29,IND,23,380,52,135,2,6,50,129,18,26,124
1980,Jim Chones,C,30,LAL,82,2394,372,760,0,2,372,758,125,169,869
1980,Jim Cleamons,PG,30,TOT,79,1789,214,450,7,31,207,419,84,113,519
1980,Jim Cleamons,PG,30,NYK,22,254,30,69,3,8,27,61,12,15,75
1980,Jim Cleamons,PG,30,WSB,57,1535,184,381,4,23,180,358,72,98,444
1980,Doug Collins,SG,28,PHI,36,963,191,410,0,1,191,409,113,124,495
1980,Jeff Cook,PF,23,PHO,66,904,129,275,0,3,129,272,104,129,362
1980,Michael Cooper,SG,23,LAL,82,1973,303,578,5,20,298,558,111,143,722
1980,Wayne Cooper,PF,23,GSW,79,1781,367,750,1,4,366,746,136,181,871
1980,Hollis Copeland,SF,24,NYK,75,1142,182,368,0,2,182,366,63,86,427
1980,Dave Corzine,C,23,WSB,78,826,90,216,0,0,90,216,45,68,225
1980,John Coughran,SF,28,GSW,24,160,29,81,2,9,27,72,8,14,68
1980,Dave Cowens*,C,31,BOS,66,2159,422,932,1,12,421,920,95,122,940
1980,Charlie Criss,PG,31,ATL,81,1794,249,578,1,17,248,561,172,212,671
1980,Terry Crosby,PG,23,KCK,4,28,2,4,0,0,2,4,2,2,6
1980,Pat Cummings,C,23,MIL,71,900,187,370,0,0,187,370,94,123,468
1980,Bob Dandridge,SF,32,WSB,45,1457,329,729,2,11,327,718,123,152,783
1980,Adrian Dantley*,SF,23,UTA,68,2674,730,1267,0,2,730,1265,443,526,1903
1980,Brad Davis,PG,24,TOT,18,268,35,63,0,1,35,62,13,16,83
1980,Brad Davis,PG,24,IND,5,43,2,7,0,0,2,7,3,4,7
1980,Brad Davis,PG,24,UTA,13,225,33,56,0,1,33,55,10,12,76
1980,Harry Davis,SF,24,SAS,4,30,6,12,0,0,6,12,1,2,13
1980,Johnny Davis,PG,24,IND,82,2912,496,1159,4,42,492,1117,304,352,1300
1980,Walter Davis,SF,25,PHO,75,2309,657,1166,0,4,657,1162,299,365,1613
1980,Darryl Dawkins,C,23,PHI,80,2541,494,946,0,6,494,940,190,291,1178
1980,Paul Dawkins,SF,22,UTA,57,776,141,300,1,5,140,295,33,48,316
1980,Greg Deane,SG,22,UTA,7,48,2,11,1,1,1,10,5,7,10
1980,Larry Demic,PF,22,NYK,82,1872,230,528,0,0,230,528,110,183,570
1980,Coby Dietrick,C,31,CHI,79,1830,227,500,1,9,226,491,90,118,545
1980,Leon Douglas,C,25,DET,70,1782,221,455,0,1,221,454,125,185,567
1980,John Drew,SF,25,ATL,80,2306,535,1182,0,7,535,1175,489,646,1559
1980,Terry Duerod,SG,23,DET,67,1331,282,598,15,53,267,545,45,66,624
1980,Mike Dunleavy,PG,25,HOU,51,1036,148,319,3,20,145,299,111,134,410
1980,T.R. Dunn,SG,24,POR,82,1841,240,551,0,3,240,548,84,111,564
1980,James Edwards,C,24,IND,82,2314,528,1032,0,1,528,1031,231,339,1287
1980,Bob Elliott,PF,24,NJN,54,722,101,228,1,4,100,224,104,152,307
1980,Bo Ellis,PF,25,DEN,48,502,61,136,0,3,61,133,40,53,162
1980,Len Elmore,C,27,KCK,58,915,104,242,0,0,104,242,51,74,259
1980,Alex English*,SF,26,TOT,78,2401,553,1113,2,6,551,1107,210,266,1318
1980,Alex English*,SF,26,IND,54,1526,346,686,0,3,346,683,114,140,806
1980,Alex English*,SF,26,DEN,24,875,207,427,2,3,205,424,96,126,512
1980,Julius Erving*,SF,29,PHI,78,2812,838,1614,4,20,834,1594,420,534,2100
1980,Earl Evans,PF,24,DET,36,381,63,140,7,18,56,122,24,42,157
1980,Mike Evans,SG,24,SAS,79,1246,208,464,12,42,196,422,58,85,486
1980,Eric Fernsten,PF,26,BOS,56,431,71,153,0,0,71,153,33,52,175
1980,Chris Ford,SG,31,BOS,73,2115,330,709,70,164,260,545,86,114,816
1980,Don Ford,SF,27,TOT,73,999,131,274,1,3,130,271,45,53,308
1980,Don Ford,SF,27,LAL,52,580,66,130,0,1,66,129,23,28,155
1980,Don Ford,SF,27,CLE,21,419,65,144,1,2,64,142,22,25,153
1980,Phil Ford,PG,23,KCK,82,2621,489,1058,4,23,485,1035,346,423,1328
1980,Walt Frazier*,PG,34,CLE,3,27,4,11,0,1,4,10,2,2,10
1980,World B.,SG,26,SDC,68,2585,737,1556,9,25,728,1531,572,760,2055
1980,Terry Furlow,SG,25,TOT,76,2122,430,926,24,82,406,844,171,196,1055
1980,Terry Furlow,SG,25,ATL,21,404,66,161,1,9,65,152,44,51,177
1980,Terry Furlow,SG,25,UTA,55,1718,364,765,23,73,341,692,127,145,878
1980,Mike Gale,PG,29,SAS,67,1474,171,377,2,13,169,364,97,120,441
1980,Gary Garland,PG,22,DEN,78,1106,155,356,6,19,149,337,18,26,334
1980,Gus Gerard,SF,26,KCK,73,869,159,348,1,3,158,345,66,100,385
1980,George Gervin*,SG,27,SAS,78,2934,1024,1940,32,102,992,1838,505,593,2585
1980,John Gianelli,C,29,UTA,17,285,23,66,0,0,23,66,9,16,55
1980,Artis Gilmore*,C,30,CHI,48,1568,305,513,0,0,305,513,245,344,855
1980,Jack Givens,SF,23,ATL,82,1254,182,473,0,2,182,471,106,128,470
1980,Mike Glenn,SG,24,NYK,75,800,188,364,2,10,186,354,63,73,441
1980,Glen Gondrezick,SF,24,DEN,59,1020,148,286,2,6,146,280,92,121,390
1980,Mike Green,C,28,KCK,21,459,69,159,0,2,69,157,24,42,162
1980,Dave Greenwood,PF,22,CHI,82,2791,498,1051,1,7,497,1044,337,416,1334
1980,Kevin Grevey,SF,26,WSB,65,1818,331,804,34,92,297,712,216,249,912
1980,Paul Griffin,C,26,SAS,82,1812,173,313,0,0,173,313,174,240,520
1980,Bob Gross,SF,26,POR,62,1581,221,472,1,10,220,462,95,114,538
1980,Ernie Grunfeld,SF,24,KCK,80,1397,186,420,1,2,185,418,101,131,474
1980,Roy Hamilton,PG,22,DET,72,1116,115,287,0,2,115,285,103,150,333
1980,James Hardy,PF,23,UTA,76,1600,184,363,1,2,183,361,51,66,420
1980,Joe Hassett,SG,24,IND,74,1135,215,509,69,198,146,311,24,29,523
1980,Steve Hawes,PF,29,ATL,82,1853,304,605,3,8,301,597,150,182,761
1980,Elvin Hayes*,PF,34,WSB,81,3183,761,1677,3,13,758,1664,334,478,1859
1980,Spencer Haywood*,PF,30,LAL,76,1544,288,591,1,4,287,587,159,206,736
1980,Gar Heard,PF,31,PHO,82,1403,171,410,0,2,171,408,64,86,406
1980,Gerald Henderson,PG,24,BOS,76,1061,191,382,2,6,189,376,89,129,473
1980,Tom Henderson,PG,28,HOU,66,1551,154,323,0,2,154,321,56,77,364
1980,Johnny High,PG,22,PHO,82,1121,144,323,1,7,143,316,120,178,409
1980,Armond Hill,PG,26,ATL,79,2092,177,431,1,4,176,427,124,146,479
1980,Darnell Hillman,PF,30,GSW,49,708,82,179,0,0,82,179,34,68,198
1980,Brad Holland,SG,23,LAL,38,197,44,104,3,15,41,89,15,16,106
1980,Lionel Hollins,SG-PG,26,TOT,47,1209,212,526,3,20,209,506,101,140,528
1980,Lionel Hollins,PG,26,POR,20,413,82,213,1,10,81,203,34,53,199
1980,Lionel Hollins,SG,26,PHI,27,796,130,313,2,10,128,303,67,87,329
1980,Phil Hubbard,PF,23,DET,64,1189,210,451,0,2,210,449,165,220,585
1980,Kim Hughes,C,27,DEN,70,1208,102,202,0,0,102,202,15,41,219
1980,Geoff Huston,PG,22,NYK,71,923,94,241,3,17,91,224,28,38,219
1980,Dan Issel*,C,31,DEN,82,2938,715,1416,4,12,711,1404,517,667,1951
1980,Phil Jackson*,PF,34,NJN,16,194,29,46,0,2,29,44,7,10,65
1980,Abdul Jeelani,SF,25,POR,77,1286,288,565,0,6,288,559,161,204,737
1980,Cheese Johnson,SF,22,GSW,9,53,12,30,0,0,12,30,3,5,27
1980,Clemon Johnson,C,23,IND,79,1541,199,396,0,0,199,396,74,117,472
1980,Dennis Johnson*,SG,25,SEA,81,2937,574,1361,12,58,562,1303,380,487,1540
1980,Eddie Johnson,SG,24,ATL,79,2622,590,1212,5,13,585,1199,280,338,1465
1980,George Johnson,C,31,NJN,81,2119,248,543,0,1,248,542,89,126,585
1980,George Johnson,PF,23,DEN,75,1938,309,649,2,9,307,640,148,189,768
1980,John Johnson,SF,32,SEA,81,2533,377,772,0,0,377,772,161,201,915
1980,Magic Johnson*,SG,20,LAL,77,2795,503,949,7,31,496,918,374,462,1387
1980,Marques Johnson,SF,23,MIL,77,2686,689,1267,2,9,687,1258,291,368,1671
1980,Mickey Johnson,PF,27,IND,82,2647,588,1271,5,32,583,1239,385,482,1566
1980,Ollie Johnson,SF,30,CHI,79,1535,262,527,1,11,261,516,82,93,607
1980,Vinnie Johnson,SG,23,SEA,38,325,45,115,0,1,45,114,31,39,121
1980,Bobby Jones,PF,28,PHI,81,2125,398,748,0,3,398,745,257,329,1053
1980,Caldwell Jones,C,29,PHI,80,2771,232,532,0,2,232,530,124,178,588
1980,Dwight Jones,PF,27,TOT,74,1448,257,506,0,0,257,506,146,201,660
1980,Dwight Jones,PF,27,HOU,21,278,50,119,0,0,50,119,27,36,127
1980,Dwight Jones,PF,27,CHI,53,1170,207,387,0,0,207,387,119,165,533
1980,Major Jones,PF,26,HOU,82,1545,188,392,1,3,187,389,61,108,438
1980,Eddie Jordan,PG,25,NJN,82,2657,437,1017,12,48,425,969,201,258,1087
1980,Jeff Judkins,SF,23,BOS,65,674,139,276,11,27,128,249,62,76,351
1980,Rich Kelley,C,26,TOT,80,1839,229,484,0,3,229,481,244,310,702
1980,Rich Kelley,C,26,NJN,57,1466,186,399,0,3,186,396,197,250,569
1980,Rich Kelley,C,26,PHO,23,373,43,85,0,0,43,85,47,60,133
1980,Greg Kelser,SF,22,DET,50,1233,280,593,3,15,277,578,146,203,709
1980,Larry Kenon,PF,27,SAS,78,2798,647,1333,1,9,646,1324,270,345,1565
1980,Irv Kiffin,SF,28,SAS,26,212,32,96,0,0,32,96,18,25,82
1980,Carl Kilpatrick,C,23,UTA,2,6,1,2,0,0,1,2,1,2,3
1980,Bernard King*,SF,23,UTA,19,419,71,137,0,0,71,137,34,63,176
1980,Reggie King,PF,22,KCK,82,2052,257,499,0,1,257,498,159,219,673
1980,Billy Knight,SF,27,IND,75,1910,385,722,4,15,381,707,212,262,986
1980,Toby Knight,SF,24,NYK,81,2945,669,1265,0,2,669,1263,211,261,1549
1980,Arvid Kramer,C,23,DEN,8,45,7,22,0,0,7,22,2,2,16
1980,Joel Kramer,C,24,PHO,54,711,67,143,0,1,67,142,56,70,190
1980,John Kuester,PG,24,IND,24,100,12,34,0,1,12,33,5,7,29
1980,Kevin Kunnert,C,28,POR,18,302,50,114,0,0,50,114,26,43,126
1980,Mitch Kupchak,PF,25,WSB,40,451,67,160,0,2,67,158,52,75,186
1980,Sam Lacey,C,31,KCK,81,2412,303,677,0,1,303,676,137,185,743
1980,Tom LaGarde,C,24,SEA,82,1164,146,306,0,0,146,306,90,137,382
1980,John Lambert,PF,27,CLE,74,1324,165,400,0,3,165,397,73,101,403
1980,Mark Landsberger,C,24,TOT,77,1510,249,483,0,0,249,483,116,222,614
1980,Mark Landsberger,C,24,CHI,54,1136,183,346,0,0,183,346,87,166,453
1980,Mark Landsberger,C,24,LAL,23,374,66,137,0,0,66,137,29,56,161
1980,Bob Lanier*,C,31,TOT,63,2131,466,867,1,6,465,861,277,354,1210
1980,Bob Lanier*,C,31,DET,37,1392,319,584,0,5,319,579,164,210,802
1980,Bob Lanier*,C,31,MIL,26,739,147,283,1,1,146,282,113,144,408
1980,Allen Leavell,PG,22,HOU,77,2123,330,656,3,19,327,637,180,221,843
1980,Butch Lee,PG,23,TOT,14,55,6,24,0,0,6,24,6,8,18
1980,Butch Lee,PG,23,CLE,3,24,2,11,0,0,2,11,0,1,4
1980,Butch Lee,PG,23,LAL,11,31,4,13,0,0,4,13,6,7,14
1980,Ron Lee,PG,27,TOT,61,1167,113,305,22,59,91,246,44,70,292
1980,Ron Lee,PG,27,ATL,30,364,29,91,0,3,29,88,9,17,67
1980,Ron Lee,PG,27,DET,31,803,84,214,22,56,62,158,35,53,225
1980,John Long,SG,23,DET,69,2364,588,1164,1,12,587,1152,160,194,1337
1980,John Lucas,PG,26,GSW,80,2763,388,830,12,42,376,788,222,289,1010
1980,Maurice Lucas,PF,27,TOT,63,1884,371,813,2,9,369,804,179,239,923
1980,Maurice Lucas,PF,27,POR,41,1176,243,552,2,5,241,547,100,137,588
1980,Maurice Lucas,PF,27,NJN,22,708,128,261,0,4,128,257,79,102,335
1980,Ollie Mack,SG,22,TOT,50,681,98,199,0,5,98,194,38,51,234
1980,Ollie Mack,SG,22,LAL,27,155,21,50,0,1,21,49,9,18,51
1980,Ollie Mack,SG,22,CHI,23,526,77,149,0,4,77,145,29,33,183
1980,Moses Malone*,C,24,HOU,82,3140,778,1549,0,6,778,1543,563,783,2119
1980,Steve Malovic,PF,23,TOT,39,445,31,67,0,0,31,67,18,27,80
1980,Steve Malovic,PF,23,WSB,1,6,0,0,0,0,0,0,1,4,1
1980,Steve Malovic,PF,23,SDC,28,277,23,42,0,0,23,42,7,9,53
1980,Steve Malovic,PF,23,DET,10,162,8,25,0,0,8,25,10,14,26
1980,Pete Maravich*,SG,32,TOT,43,964,244,543,10,15,234,528,91,105,589
1980,Pete Maravich*,SG,32,UTA,17,522,121,294,7,11,114,283,41,50,290
1980,Pete Maravich*,SG,32,BOS,26,442,123,249,3,4,120,245,50,55,299
1980,Cedric Maxwell,SF,24,BOS,80,2744,457,750,0,0,457,750,436,554,1350
1980,Scott May,SF,25,CHI,54,1298,264,587,0,4,264,583,144,172,672
1980,Bob McAdoo*,PF,28,DET,58,2097,492,1025,3,24,489,1001,235,322,1222
1980,Jim McElroy,PG,26,TOT,67,1528,228,527,5,21,223,506,132,172,593
1980,Jim McElroy,PG,26,DET,36,1012,162,356,3,14,159,342,95,119,422
1980,Jim McElroy,PG,26,ATL,31,516,66,171,2,7,64,164,37,53,171
1980,George McGinnis,PF,29,TOT,73,2208,400,886,2,15,398,871,270,488,1072
1980,George McGinnis,PF,29,DEN,45,1424,268,584,1,7,267,577,166,307,703
1980,George McGinnis,PF,29,IND,28,784,132,302,1,8,131,294,104,181,369
1980,Billy McKinney,PG,24,KCK,76,1333,206,459,1,10,205,449,107,133,520
1980,Tom McMillen,C,27,ATL,53,1071,191,382,0,1,191,381,81,107,463
1980,John Mengelt,SG,30,CHI,36,387,90,166,0,6,90,160,39,49,219
1980,Joe Meriweather,PF,26,NYK,65,1565,252,477,0,1,252,476,78,121,582
1980,Dave Meyers,PF,26,MIL,79,2204,399,830,1,5,398,825,156,246,955
1980,Mike Mitchell,SF,24,CLE,82,2802,775,1482,0,6,775,1476,270,343,1820
1980,Steve Mix,SF,32,PHI,81,1543,363,703,4,10,359,693,207,249,937
1980,Paul Mokeski,C,23,HOU,12,113,11,33,0,0,11,33,7,9,29
1980,Sidney Moncrief,SG,22,MIL,77,1557,211,451,0,1,211,450,232,292,654
1980,Eric Money,SG-PG,24,TOT,61,1549,273,546,0,0,273,546,83,106,629
1980,Eric Money,PG,24,PHI,6,82,14,36,0,0,14,36,2,2,30
1980,Eric Money,SG,24,DET,55,1467,259,510,0,0,259,510,81,104,599
1980,Earl Monroe*,SG,35,NYK,51,633,161,352,0,0,161,352,56,64,378
1980,Calvin Murphy*,SG,31,HOU,76,2676,624,1267,1,25,623,1242,271,302,1520
1980,Swen Nater,C,30,SDC,81,2860,443,799,0,2,443,797,196,273,1082
1980,Calvin Natt,SF,23,TOT,78,2857,622,1298,3,9,619,1289,306,419,1553
1980,Calvin Natt,SF,23,NJN,53,2046,421,879,1,5,420,874,199,280,1042
1980,Calvin Natt,SF,23,POR,25,811,201,419,2,4,199,415,107,139,511
1980,Mike Newlin,SG,31,NJN,78,2510,611,1329,45,152,566,1177,367,415,1634
1980,Norm Nixon,PG,24,LAL,82,3226,624,1209,1,8,623,1201,197,253,1446
1980,Sylvester Norris,C,22,SAS,17,189,18,43,0,0,18,43,4,6,40
1980,Mark Olberding,SF,23,SAS,75,2111,291,609,0,3,291,606,210,264,792
1980,John Olive,SF,24,SDC,1,15,0,2,0,0,0,2,0,0,0
1980,Tom Owens,C,30,POR,76,2337,518,1008,1,2,517,1006,213,283,1250
1980,Robert Parish*,C,26,GSW,72,2119,510,1006,0,1,510,1005,203,284,1223
1980,Sonny Parker,SF,24,GSW,82,2849,483,988,0,2,483,986,237,302,1203
1980,Billy Paultz,C,31,TOT,84,2193,327,673,0,1,327,672,109,182,763
1980,Billy Paultz,C,31,SAS,47,1213,189,381,0,1,189,380,66,100,444
1980,Billy Paultz,C,31,HOU,37,980,138,292,0,0,138,292,43,82,319
1980,Jim Paxson,SG,22,POR,72,1270,189,460,1,22,188,438,64,90,443
1980,Wiley Peck,SF,22,SAS,52,628,73,169,0,2,73,167,34,55,180
1980,Sam Pellom,PF,28,ATL,44,373,44,108,0,0,44,108,21,30,109
1980,Roger Phegley,SG,23,TOT,78,1512,350,733,4,9,346,724,177,203,881
1980,Roger Phegley,SG,23,WSB,50,971,224,473,2,5,222,468,104,120,554
1980,Roger Phegley,SG,23,NJN,28,541,126,260,2,4,124,256,73,83,327
1980,Stan Pietkiewicz,PG,23,SDC,50,577,91,179,9,36,82,143,37,46,228
1980,Ben Poquette,C,24,UTA,82,2349,296,566,0,2,296,564,139,167,731
1980,Kevin Porter,PG,29,WSB,70,1494,201,438,0,4,201,434,110,137,512
1980,Clifford Ray,C,31,GSW,81,1683,203,383,0,2,203,381,84,149,490
1980,Marlon Redmond,SG,24,KCK,24,298,59,138,0,9,59,129,24,34,142
1980,Robert Reid,SF,24,HOU,76,2304,419,861,0,3,419,858,153,208,991
1980,Kevin Restani,SF,28,SAS,82,1966,369,727,5,29,364,698,131,161,874
1980,Clint Richardson,SG,23,PHI,52,988,159,348,1,3,158,345,28,45,347
1980,Micheal Ray,SG,24,NYK,82,3060,502,1063,27,110,475,953,223,338,1254
1980,Anthony Roberts,SF,24,DEN,23,486,69,181,0,1,69,180,39,60,177
1980,Rick Robey,C,24,BOS,82,1918,379,727,0,1,379,726,184,269,942
1980,Cliff Robinson,PF,19,NJN,70,1661,391,833,1,4,390,829,168,242,951
1980,Jackie Robinson,SF,24,DET,7,51,9,17,0,1,9,16,9,11,27
1980,Truck Robinson,PF,28,PHO,82,2710,545,1064,0,0,545,1064,325,487,1415
1980,Bill Robinzine,PF,27,KCK,81,1917,362,723,1,2,361,721,200,274,925
1980,Dave Robisch,C,30,CLE,82,2670,489,940,0,3,489,937,277,329,1255
1980,John Roche,PG,30,DEN,82,2286,354,741,49,129,305,612,175,202,932
1980,Tree Rollins,C,24,ATL,82,2123,287,514,0,0,287,514,157,220,731
1980,Dan Roundfield,PF,26,ATL,81,2588,502,1007,0,4,502,1003,330,465,1334
1980,Campy Russell,SF,28,CLE,41,1331,284,630,1,9,283,621,178,239,747
1980,Alvin Scott,SF,24,PHO,79,1303,127,301,1,3,126,298,95,122,350
1980,Charlie Scott,SG,31,DEN,69,1860,276,688,2,11,274,677,85,118,639
1980,Lonnie Shelton,PF,24,SEA,76,2243,425,802,1,5,424,797,184,241,1035
1980,Purvis Short,SF,22,GSW,62,1636,461,916,0,6,461,910,134,165,1056
1980,John Shumate,PF,27,TOT,65,1337,207,392,0,1,207,391,165,216,579
1980,John Shumate,PF,27,DET,9,228,35,65,0,0,35,65,17,25,87
1980,John Shumate,PF,27,HOU,29,332,34,64,0,0,34,64,33,44,101
1980,John Shumate,PF,27,SAS,27,777,138,263,0,1,138,262,115,147,391
1980,Jack Sikma,C,24,SEA,82,2793,470,989,0,1,470,988,235,292,1175
1980,James Silas,PG,30,SAS,77,2293,513,999,0,4,513,995,339,382,1365
1980,Paul Silas,PF,36,SEA,82,1595,113,299,0,0,113,299,89,136,315
1980,Ralph Simpson,SG,30,NJN,8,81,18,47,0,2,18,45,5,10,41
1980,Al Skinner,SG,27,PHI,2,10,1,2,0,0,1,2,0,0,2
1980,Bingo Smith,SF-SG,33,TOT,78,2123,385,891,23,81,362,810,100,115,893
1980,Bingo Smith,SG,33,CLE,8,135,33,72,1,5,32,67,7,8,74
1980,Bingo Smith,SF,33,SDC,70,1988,352,819,22,76,330,743,93,107,819
1980,Phil Smith,SG,27,GSW,51,1552,325,685,7,22,318,663,135,171,792
1980,Randy Smith,SG,31,CLE,82,2677,599,1326,10,53,589,1273,233,283,1441
1980,Robert Smith,PG,24,TOT,65,809,118,269,8,26,110,243,80,92,324
1980,Robert Smith,PG,24,UTA,6,73,5,15,0,0,5,15,5,5,15
1980,Robert Smith,PG,24,NJN,59,736,113,254,8,26,105,228,75,87,309
1980,Sam Smith,SF,25,CHI,30,496,97,230,8,35,89,195,57,63,259
1980,Willie Smith,PG,26,CLE,62,1051,121,315,17,71,104,244,40,52,299
1980,Ricky Sobers,PG,27,CHI,82,2673,470,1002,21,68,449,934,200,239,1161
1980,Jim Spanarkel,SG,22,PHI,40,442,72,153,0,2,72,151,54,65,198
1980,Larry Steele,SF,30,POR,16,446,62,146,0,4,62,142,22,27,146
1980,Earl Tatum,SG,26,CLE,33,225,36,94,2,6,34,88,11,19,85
1980,Brian Taylor,PG,28,SDC,78,2754,418,895,90,239,328,656,130,162,1056
1980,Reggie Theus,SG,22,CHI,82,3029,566,1172,28,105,538,1067,500,597,1660
1980,David Thompson*,SG,25,DEN,39,1239,289,617,7,19,282,598,254,335,839
1980,Rudy Tomjanovich,PF,31,HOU,62,1834,370,778,22,79,348,699,118,147,880
1980,Bernard Toone,PF,23,PHI,23,124,23,64,1,7,22,57,8,10,55
1980,Raymond Townsend,SG,24,GSW,75,1159,171,421,4,26,167,395,60,84,406
1980,Dave Twardzik,PG,29,POR,67,1594,183,394,4,7,179,387,197,252,567
1980,Terry Tyler,SF,23,DET,82,2670,430,925,2,12,428,913,143,187,1005
1980,Wes Unseld*,C,33,WSB,82,2973,327,637,1,2,326,635,139,209,794
1980,Jan Van,SF,28,NJN,82,2399,212,458,7,20,205,438,130,155,561
1980,Andre Wakefield,SG,25,UTA,8,47,6,15,0,0,6,15,3,3,15
1980,Foots Walker,PG,28,CLE,76,2422,258,568,1,9,257,559,195,243,712
1980,Wally Walker,SF,25,SEA,70,844,139,274,0,0,139,274,48,64,326
1980,Bill Walton*,C,27,SDC,14,337,81,161,0,0,81,161,32,54,194
1980,Lloyd Walton,PG,26,MIL,76,1243,110,242,1,3,109,239,49,71,270
1980,Kermit Washington,PF,28,POR,80,2657,421,761,0,3,421,758,231,360,1073
1980,Richard Washington,PF,24,MIL,75,1092,197,421,0,0,197,421,46,76,440
1980,Nick Weatherspoon,SF,29,SDC,57,1124,164,378,0,0,164,378,63,91,391
1980,Marvin Webster,C,27,NYK,20,298,38,79,0,0,38,79,12,16,88
1980,Scott Wedman,SF,27,KCK,68,2347,569,1112,7,22,562,1090,145,181,1290
1980,Paul Westphal,SG,29,PHO,82,2665,692,1317,26,93,666,1224,382,443,1792
1980,Jo Jo,PG,33,GSW,78,2052,336,706,1,6,335,700,97,114,770
1980,Rudy White,SG,26,HOU,9,106,13,24,0,0,13,24,10,13,36
1980,Jerome Whitehead,C,23,TOT,50,553,58,114,0,0,58,114,10,35,126
1980,Jerome Whitehead,C,23,SDC,18,225,27,45,0,0,27,45,5,18,59
1980,Jerome Whitehead,C,23,UTA,32,328,31,69,0,0,31,69,5,17,67
1980,Sidney Wicks,PF,30,SDC,71,2146,210,496,0,1,210,495,83,152,503
1980,Bob Wilkerson,SF,25,DEN,75,2381,430,1030,7,34,423,996,166,222,1033
1980,Jamaal Wilkes*,SF,26,LAL,82,3111,726,1358,3,17,723,1341,189,234,1644
1980,Duck Williams,PG,23,UTA,77,1794,232,519,0,12,232,507,42,60,506
1980,Freeman Williams,SG,23,SDC,82,2118,645,1343,42,128,603,1215,194,238,1526
1980,Gus Williams,PG,26,SEA,82,2969,739,1533,7,36,732,1497,331,420,1816
1980,Ray Williams,PG,25,NYK,82,2582,687,1384,7,37,680,1347,333,423,1714
1980,Sly Williams,SF,22,NYK,57,556,104,267,0,4,104,263,58,90,266
1980,John Williamson,SG,28,TOT,58,1374,359,817,11,35,348,782,116,138,845
1980,John Williamson,SG,28,NJN,28,771,206,461,8,19,198,442,76,88,496
1980,John Williamson,SG,28,WSB,30,603,153,356,3,16,150,340,40,50,349
1980,Bill Willoughby,SF,22,CLE,78,1447,219,457,1,9,218,448,96,127,535
1980,Bubba Wilson,SG,24,GSW,16,143,7,25,0,0,7,25,3,6,17
1980,Rick Wilson,SG,23,ATL,5,59,2,14,0,0,2,14,4,6,8
1980,Brian Winters,SG,27,MIL,80,2623,535,1116,38,102,497,1014,184,214,1292
1980,Larry Wright,PG,25,WSB,76,1286,229,500,4,16,225,484,96,108,558
1980,Tony Zeno,SF,22,IND,8,59,6,21,0,0,6,21,2,2,14
,,,,,,,,,,,,,,,
1981,Kareem Abdul-Jabbar*,C,33,LAL,80,2976,836,1457,0,1,836,1456,423,552,2095
1981,Tom Abernethy,SF,26,TOT,39,298,25,59,0,1,25,58,13,22,63
1981,Tom Abernethy,SF,26,GSW,10,39,1,3,0,0,1,3,2,3,4
1981,Tom Abernethy,SF,26,IND,29,259,24,56,0,1,24,55,11,19,59
1981,Alvan Adams,C,26,PHO,75,2054,458,870,0,0,458,870,199,259,1115
1981,Darrell Allums,PF,22,DAL,22,276,23,67,0,1,23,66,13,22,59
1981,Tiny Archibald*,PG,32,BOS,80,2820,382,766,0,9,382,757,342,419,1106
1981,Dennis Awtrey,C,32,SEA,47,607,44,93,0,0,44,93,14,20,102
1981,James Bailey,PF,23,SEA,82,2539,444,889,1,2,443,887,256,361,1145
1981,Greg Ballard,SF,26,WSB,82,2610,549,1186,7,32,542,1154,166,196,1271
1981,Mike Bantom,SF,29,IND,76,2375,431,882,0,6,431,876,199,281,1061
1981,Billy Ray,SG,24,POR,77,1560,439,902,14,54,425,848,170,199,1062
1981,Mel Bennett,PF,26,UTA,28,313,26,60,0,2,26,58,53,81,105
1981,Kent Benson,C,26,DET,59,1956,364,770,0,4,364,766,196,254,924
1981,Henry Bibby,PG,31,SDC,73,1112,118,306,32,95,86,211,67,98,335
1981,Larry Bird*,PF,24,BOS,82,3239,719,1503,20,74,699,1429,283,328,1741
1981,Otis Birdsong,SG,25,KCK,71,2593,710,1306,10,35,700,1271,317,455,1747
1981,Norman Black,SG,23,DET,3,28,3,10,0,0,3,10,2,8,8
1981,Ron Boone,SG,34,UTA,52,1146,160,371,11,39,149,332,75,94,406
1981,Winford Boynes,SG,23,DAL,44,757,121,313,0,0,121,313,45,55,287
1981,Dudley Bradley,SG,23,IND,82,1867,265,559,2,16,263,543,125,178,657
1981,Mike Bratz,PG,25,CLE,80,2595,319,817,57,169,262,648,107,132,802
1981,Jim Brewer,PF,29,LAL,78,1107,101,197,0,2,101,195,15,40,217
1981,Ron Brewer,SG,25,TOT,75,1452,275,631,1,7,274,624,91,114,642
1981,Ron Brewer,SG,25,POR,29,548,95,246,1,3,94,243,26,34,217
1981,Ron Brewer,SG,25,SAS,46,904,180,385,0,4,180,381,65,80,425
1981,Junior Bridgeman,SF,27,MIL,77,2215,537,1102,3,21,534,1081,213,241,1290
1981,Allan Bristow,SF,29,UTA,82,2001,271,611,5,18,266,593,166,198,713
1981,Dave Britton,PG,22,WSB,2,9,2,3,0,0,2,3,0,0,4
1981,Michael Brooks,SF,22,SDC,82,2479,488,1018,0,6,488,1012,226,320,1202
1981,Fred Brown,SG,32,SEA,78,1986,505,1035,23,64,482,971,173,208,1206
1981,Lewis Brown,C,25,WSB,2,5,0,3,0,0,0,3,2,5,2
1981,Rickey Brown,C,22,GSW,45,580,83,162,0,0,83,162,16,21,182
1981,Joe Bryant,PF,26,SDC,82,2359,379,791,2,15,377,776,193,244,953
1981,Quinn Buckner,PG,26,MIL,82,2384,471,956,1,6,470,950,149,203,1092
1981,Tom Burleson,C,28,ATL,31,363,41,99,0,0,41,99,20,41,102
1981,Don Buse,SG,30,IND,58,1095,114,287,19,58,95,229,50,65,297
1981,Marty Byrnes,SF,24,DAL,72,1360,216,451,9,20,207,431,120,157,561
1981,Mack Calvin,PG,33,CLE,21,128,13,39,1,5,12,34,25,35,52
1981,Austin Carr,SG,32,TOT,47,657,87,234,0,7,87,227,34,54,208
1981,Austin Carr,SG,32,DAL,8,77,7,28,0,0,7,28,2,4,16
1981,Austin Carr,SG,32,WSB,39,580,80,206,0,7,80,199,32,50,192
1981,Kenny Carr,PF,25,CLE,81,2615,469,918,0,4,469,914,292,409,1230
1981,M.L. Carr,SF,30,BOS,41,655,97,216,1,14,96,202,53,67,248
1981,Joe Barry,C,22,GSW,82,2919,616,1254,0,2,616,1252,315,440,1547
1981,Butch Carter,SF,22,LAL,54,672,114,247,3,10,111,237,70,95,301
1981,Reggie Carter,SG,23,NYK,60,536,59,179,0,3,59,176,51,69,169
1981,Bill Cartwright,C,23,NYK,82,2925,619,1118,0,1,619,1117,408,518,1646
1981,Harvey Catchings,PF,29,MIL,77,1635,134,300,0,0,134,300,59,92,327
1981,Maurice Cheeks,PG,24,PHI,81,2415,310,581,3,8,307,573,140,178,763
1981,Phil Chenier,SG,30,GSW,9,82,11,33,1,3,10,30,6,6,29
1981,Jim Chones,PF,31,LAL,82,2562,378,751,0,4,378,747,126,193,882
1981,Art Collins,SG,26,ATL,29,395,35,99,0,2,35,97,24,36,94
1981,Don Collins,SF,22,TOT,81,1845,360,811,0,6,360,805,211,272,931
1981,Don Collins,SF,22,ATL,47,1184,230,530,0,3,230,527,137,162,597
1981,Don Collins,SF,22,WSB,34,661,130,281,0,3,130,278,74,110,334
1981,Doug Collins,SG,29,PHI,12,329,62,126,0,0,62,126,24,29,148
1981,Darwin Cook,SG,22,NJN,81,1980,383,819,6,25,377,794,132,180,904
1981,Jeff Cook,SF,24,PHO,79,2192,286,616,0,5,286,611,100,155,672
1981,Michael Cooper,SG,24,LAL,81,2625,321,654,4,19,317,635,117,149,763
1981,Wayne Cooper,C,24,UTA,71,1420,213,471,1,3,212,468,62,90,489
1981,Dave Corzine,C,24,SAS,82,1960,366,747,0,3,366,744,125,175,857
1981,Charlie Criss,PG,32,ATL,66,1708,220,485,1,21,219,464,185,214,626
1981,Geoff Crompton,C,25,POR,6,33,4,8,0,0,4,8,1,5,9
1981,Pat Cummings,C,24,MIL,74,1084,248,460,0,2,248,458,99,140,595
1981,Earl Cureton,C,23,PHI,52,528,93,205,0,1,93,204,33,64,219
1981,Bob Dandridge,SF,33,WSB,23,545,101,237,0,1,101,236,28,39,230
1981,Adrian Dantley*,SF,24,UTA,80,3417,909,1627,2,7,907,1620,632,784,2452
1981,Brad Davis,PG,25,DAL,56,1686,230,410,3,17,227,393,163,204,626
1981,Johnny Davis,PG,25,IND,76,2536,426,917,4,33,422,884,238,299,1094
1981,Monti Davis,PF,22,TOT,2,10,1,5,0,0,1,5,1,5,3
1981,Monti Davis,PF,22,PHI,1,2,1,1,0,0,1,1,0,0,2
1981,Monti Davis,PF,22,DAL,1,8,0,4,0,0,0,4,1,5,1
1981,Ron Davis,SF,26,SDC,64,817,139,314,2,8,137,306,94,158,374
1981,Walter Davis,SG,26,PHO,78,2182,593,1101,7,17,586,1084,209,250,1402
1981,Darryl Dawkins,C,24,PHI,76,2088,423,697,0,0,423,697,219,304,1065
1981,Larry Demic,PF,23,NYK,76,964,128,254,0,2,128,252,58,92,314
1981,Coby Dietrick,C,32,CHI,82,1243,146,320,2,6,144,314,77,111,371
1981,James Donaldson,C,23,SEA,68,980,129,238,0,0,129,238,101,170,359
1981,Jacky Dorsey,SF,26,SEA,29,253,20,70,0,0,20,70,13,25,53
1981,Leon Douglas,C,26,KCK,79,1356,185,323,0,3,185,320,102,186,472
1981,John Drew,SF,26,ATL,67,2075,500,1096,0,7,500,1089,454,577,1454
1981,Larry Drew,PG,22,DET,76,1581,197,484,4,17,193,467,106,133,504
1981,Ralph Drollinger,C,26,DAL,6,67,7,14,0,0,7,14,1,4,15
1981,Terry Duerod,SG-SF,24,TOT,50,451,104,234,8,16,96,218,31,41,247
1981,Terry Duerod,SF,24,DAL,18,337,74,161,2,6,72,155,18,27,168
1981,Terry Duerod,SG,24,BOS,32,114,30,73,6,10,24,63,13,14,79
1981,Mike Dunleavy,SG,26,HOU,74,1609,310,632,1,16,309,616,156,186,777
1981,T.R. Dunn,SG,25,DEN,82,1427,146,354,0,2,146,352,79,121,371
1981,John Duren,PG,22,UTA,40,458,33,101,0,1,33,100,5,9,71
1981,James Edwards,C,25,IND,81,2375,511,1004,0,3,511,1001,244,347,1266
1981,Bob Elliott,C,25,NJN,73,1320,214,419,1,2,213,417,121,202,550
1981,Len Elmore,C,28,MIL,72,925,76,212,0,0,76,212,54,75,206
1981,Alex English*,SF,27,DEN,81,3093,768,1555,3,5,765,1550,390,459,1929
1981,Julius Erving*,SF,30,PHI,82,2874,794,1524,4,18,790,1506,422,536,2014
1981,Mike Evans,PG,25,MIL,71,911,134,291,2,14,132,277,50,64,320
1981,Eric Fernsten,C,27,BOS,45,279,38,79,0,0,38,79,20,30,96
1981,Chris Ford,SG,32,BOS,82,2723,314,707,36,109,278,598,64,87,728
1981,Don Ford,SF,28,CLE,64,996,100,224,0,3,100,221,22,24,222
1981,Phil Ford,PG,24,KCK,66,2287,424,887,11,36,413,851,294,354,1153
1981,World B.,SG,27,GSW,65,2370,516,1157,5,31,511,1126,528,649,1565
1981,Tony Fuller,SG,22,DET,15,248,24,66,0,1,24,65,12,16,60
1981,Mike Gale,PG,30,TOT,77,1112,157,309,2,7,155,302,55,68,371
1981,Mike Gale,PG,30,SAS,35,636,86,164,1,3,85,161,19,26,192
1981,Mike Gale,PG,30,POR,42,476,71,145,1,4,70,141,36,42,179
1981,Calvin Garrett,SF,24,HOU,70,1638,188,415,1,3,187,412,50,62,427
1981,Gus Gerard,SF,27,TOT,27,252,41,111,0,4,41,107,27,40,109
1981,Gus Gerard,SF,27,KCK,16,123,19,51,0,3,19,48,19,29,57
1981,Gus Gerard,SF,27,SAS,11,129,22,60,0,1,22,59,8,11,52
1981,George Gervin*,SG,28,SAS,82,2765,850,1729,9,35,841,1694,512,620,2221
1981,Artis Gilmore*,C,31,CHI,82,2832,547,816,0,0,547,816,375,532,1469
1981,Mike Glenn,PG,25,NYK,82,1506,285,511,4,11,281,500,98,110,672
1981,Mike Gminski,C,21,NJN,56,1579,291,688,0,1,291,687,155,202,737
1981,Glen Gondrezick,PF,25,DEN,73,1077,155,329,0,2,155,327,112,137,422
1981,Rickey Green,PG,26,UTA,47,1307,176,366,0,1,176,365,70,97,422
1981,Dave Greenwood,PF,23,CHI,82,2710,481,989,0,2,481,987,217,290,1179
1981,Kevin Grevey,SG,27,WSB,75,2616,500,1103,45,136,455,967,244,290,1289
1981,Paul Griffin,PF,27,SAS,82,1930,166,325,0,0,166,325,170,253,502
1981,Darrell Griffith,SG,22,UTA,81,2867,716,1544,10,52,706,1492,229,320,1671
1981,Bob Gross,SF,27,POR,82,1934,253,479,0,9,253,470,135,159,641
1981,Ernie Grunfeld,SF,25,KCK,79,1584,260,486,0,0,260,486,75,101,595
1981,Roy Hamilton,PG,23,POR,1,5,1,3,0,0,1,3,1,2,3
1981,Bill Hanzlik,SF,23,SEA,74,1259,138,289,1,5,137,284,119,150,396
1981,Alan Hardy,SG,23,LAL,22,111,22,59,0,0,22,59,7,10,51
1981,James Hardy,PF,24,UTA,23,509,52,111,0,0,52,111,11,20,115
1981,Mike Harper,PF,23,POR,55,461,56,136,0,3,56,133,37,85,149
1981,Joe Hassett,SG,25,TOT,41,714,143,340,53,156,90,184,17,21,356
1981,Joe Hassett,SG,25,DAL,17,280,59,142,10,40,49,102,10,13,138
1981,Joe Hassett,SG,25,GSW,24,434,84,198,43,116,41,82,7,8,218
1981,Steve Hawes,C,30,ATL,74,2309,333,637,1,4,332,633,222,278,889
1981,Elvin Hayes*,PF,35,WSB,81,2931,584,1296,0,10,584,1286,271,439,1439
1981,Gar Heard,PF,32,SDC,78,1631,149,396,0,7,149,389,79,101,377
1981,Gerald Henderson,PG,25,BOS,82,1608,261,579,1,16,260,563,113,157,636
1981,Tom Henderson,SG,29,HOU,66,1411,137,332,0,3,137,329,78,95,352
1981,Keith Herron,SG,24,DET,80,2270,432,954,2,11,430,943,228,267,1094
1981,Kenny Higgs,PG,26,DEN,72,1689,209,474,4,34,205,440,140,172,562
1981,Johnny High,PG,23,PHO,81,1750,246,576,2,24,244,552,183,264,677
1981,Armond Hill,PG,27,TOT,75,1738,117,335,0,7,117,328,141,172,375
1981,Armond Hill,PG,27,ATL,24,624,39,116,0,1,39,115,42,50,120
1981,Armond Hill,PG,27,SEA,51,1114,78,219,0,6,78,213,99,122,255
1981,Brad Holland,SG,24,LAL,41,295,47,111,1,3,46,108,35,49,130
1981,Lionel Hollins,PG,27,PHI,82,2154,327,696,2,15,325,681,125,171,781
1981,Cedrick Hordges,PF,24,DEN,68,1599,221,480,0,3,221,477,130,186,572
1981,Phil Hubbard,PF,24,DET,80,2289,433,880,1,3,432,877,294,426,1161
1981,Kim Hughes,C,28,TOT,53,490,27,70,0,0,27,70,1,2,55
1981,Kim Hughes,C,28,DEN,8,159,11,25,0,0,11,25,1,2,23
1981,Kim Hughes,C,28,CLE,45,331,16,45,0,0,16,45,0,0,32
1981,Geoff Huston,PG,23,TOT,81,2434,461,942,1,5,460,937,150,212,1073
1981,Geoff Huston,PG,23,DAL,56,1892,385,789,1,4,384,785,128,185,899
1981,Geoff Huston,PG,23,CLE,25,542,76,153,0,1,76,152,22,27,174
1981,Dan Issel*,C,32,DEN,80,2641,614,1220,2,12,612,1208,519,684,1749
1981,Tony Jackson,PG,23,LAL,2,14,1,3,0,0,1,3,0,0,2
1981,Abdul Jeelani,SF,26,DAL,66,1108,187,440,0,1,187,439,179,220,553
1981,Clemon Johnson,C,24,IND,81,1643,235,466,0,1,235,465,112,189,582
1981,Dennis Johnson*,PG,26,PHO,79,2615,532,1220,11,51,521,1169,411,501,1486
1981,Eddie Johnson,SG,25,ATL,75,2693,573,1136,6,20,567,1116,279,356,1431
1981,George Johnson,C,32,SAS,82,1935,164,347,0,0,164,347,80,109,408
1981,George Johnson,PF,24,IND,43,930,182,394,0,5,182,389,93,122,457
1981,John Johnson,SF,33,SEA,80,2324,373,866,0,1,373,865,173,214,919
1981,Lee Johnson,PF,23,TOT,12,90,7,25,0,0,7,25,3,5,17
1981,Lee Johnson,PF,23,HOU,10,80,7,23,0,0,7,23,3,5,17
1981,Lee Johnson,PF,23,DET,2,10,0,2,0,0,0,2,0,0,0
1981,Magic Johnson*,SG,21,LAL,37,1371,312,587,3,17,309,570,171,225,798
1981,Marques Johnson,SF,24,MIL,76,2542,636,1153,0,9,636,1144,269,381,1541
1981,Mickey Johnson,PF,28,MIL,82,2118,379,846,3,18,376,828,262,332,1023
1981,Ollie Johnson,SF,31,PHI,40,372,87,158,1,6,86,152,27,31,202
1981,Reggie Johnson,PF,23,SAS,79,1716,340,682,0,1,340,681,128,193,808
1981,Vinnie Johnson,PG,24,SEA,81,2311,419,785,1,5,418,780,214,270,1053
1981,Bobby Jones,PF,29,PHI,81,2046,407,755,0,3,407,752,282,347,1096
1981,Caldwell Jones,C,30,PHI,81,2639,218,485,0,0,218,485,148,193,584
1981,Dwight Jones,PF,28,CHI,81,1574,245,507,0,0,245,507,125,161,615
1981,Edgar Jones,PF,24,NJN,60,950,189,357,0,4,189,353,146,218,524
1981,Major Jones,PF,27,HOU,68,1003,117,252,0,1,117,251,64,101,298
1981,Eddie Jordan,PG,26,TOT,74,1226,150,352,6,22,144,330,87,127,393
1981,Eddie Jordan,PG,26,NJN,14,239,30,73,3,10,27,63,24,32,87
1981,Eddie Jordan,PG,26,LAL,60,987,120,279,3,12,117,267,63,95,306
1981,Walter Jordan,SF,24,CLE,30,207,29,75,0,0,29,75,10,17,68
1981,Jeff Judkins,SF,24,UTA,62,666,92,216,9,28,83,188,45,51,238
1981,Clarence Kea,PF,21,DAL,16,199,37,81,0,1,37,80,43,62,117
1981,Rich Kelley,C,27,PHO,81,1686,196,387,0,2,196,385,175,231,567
1981,Greg Kelser,SF,23,DET,25,654,120,285,0,2,120,283,68,106,308
1981,Larry Kenon,SF,28,CHI,77,2161,454,946,0,0,454,946,180,245,1088
1981,Chad Kinch,SG,22,TOT,41,353,52,141,0,0,52,141,14,18,118
1981,Chad Kinch,SG,22,CLE,29,247,38,96,0,0,38,96,4,5,80
1981,Chad Kinch,SG,22,DAL,12,106,14,45,0,0,14,45,10,13,38
1981,Bernard King*,SF,24,GSW,81,2914,731,1244,2,6,729,1238,307,437,1771
1981,Reggie King,PF,23,KCK,81,2743,472,867,0,0,472,867,264,386,1208
1981,Billy Knight,SG,28,IND,82,2385,546,1025,3,19,543,1006,341,410,1436
1981,Joel Kramer,PF,25,PHO,82,1065,136,258,0,1,136,257,63,91,335
1981,Wayne Kreklow,SG,24,BOS,25,100,11,47,1,4,10,43,7,10,30
1981,Kevin Kunnert,C,29,POR,55,842,101,216,0,0,101,216,42,54,244
1981,Mitch Kupchak,PF,26,WSB,82,1934,392,747,0,1,392,746,240,340,1024
1981,Sam Lacey,C,32,KCK,82,2228,237,536,1,5,236,531,92,117,567
1981,Tom LaGarde,C,25,DAL,82,2670,417,888,0,0,417,888,288,444,1122
1981,Bill Laimbeer,C,23,CLE,81,2460,337,670,0,0,337,670,117,153,791
1981,John Lambert,PF,28,TOT,46,483,68,165,0,2,68,163,18,23,154
1981,John Lambert,PF,28,CLE,3,8,3,5,0,0,3,5,0,0,6
1981,John Lambert,PF,28,KCK,43,475,65,160,0,2,65,158,18,23,148
1981,Mark Landsberger,PF,25,LAL,69,1086,164,327,0,1,164,326,62,116,390
1981,Bob Lanier*,C,32,MIL,67,1753,376,716,1,1,375,715,208,277,961
1981,Edmund Lawrence,C,28,DET,3,19,5,8,0,0,5,8,2,4,12
1981,Allen Leavell,PG,23,HOU,79,1686,258,548,2,17,256,531,124,149,642
1981,Ron Lee,PG,28,DET,82,1829,113,323,2,13,111,310,113,156,341
1981,Ronnie Lester,PG,22,CHI,8,83,10,24,0,0,10,24,10,11,30
1981,Scott Lloyd,C,28,DAL,72,2186,245,547,0,2,245,545,147,205,637
1981,John Long,SG,24,DET,59,1750,441,957,2,11,439,946,160,184,1044
1981,John Lucas,PG,27,GSW,66,1919,222,506,4,24,218,482,107,145,555
1981,Maurice Lucas,PF,28,NJN,68,2162,404,835,0,2,404,833,191,254,999
1981,Ollie Mack,SG,23,TOT,65,1682,279,606,0,9,279,597,80,125,638
1981,Ollie Mack,SG,23,CHI,3,16,1,6,0,0,1,6,1,2,3
1981,Ollie Mack,SG,23,DAL,62,1666,278,600,0,9,278,591,79,123,635
1981,Kyle Macy,PG,23,PHO,82,1469,272,532,12,51,260,481,107,119,663
1981,Rick Mahorn,PF,22,WSB,52,696,111,219,0,0,111,219,27,40,249
1981,Moses Malone*,C,25,HOU,80,3245,806,1545,1,3,805,1542,609,804,2222
1981,Wes Matthews,PG,21,TOT,79,2266,385,779,5,21,380,758,202,252,977
1981,Wes Matthews,PG,21,WSB,45,1161,224,449,5,15,219,434,99,129,552
1981,Wes Matthews,PG,21,ATL,34,1105,161,330,0,6,161,324,103,123,425
1981,Cedric Maxwell,SF,25,BOS,81,2730,441,750,0,1,441,749,352,450,1234
1981,Scott May,SF,26,CHI,63,815,165,338,0,0,165,338,113,149,443
1981,Bill Mayfield,SF,23,GSW,7,54,8,18,0,0,8,18,1,2,17
1981,Bob McAdoo*,PF,29,TOT,16,321,68,157,0,1,68,156,29,41,165
1981,Bob McAdoo*,PF,29,DET,6,168,30,82,0,0,30,82,12,20,72
1981,Bob McAdoo*,PF,29,NJN,10,153,38,75,0,1,38,74,17,21,93
1981,Andre McCarter,PG,27,WSB,43,448,51,135,2,8,49,127,18,24,122
1981,Keith McCord,SG,23,WSB,2,9,2,4,0,0,2,4,0,0,4
1981,Jim McElroy,PG,27,ATL,54,680,78,202,1,8,77,194,48,59,205
1981,George McGinnis,PF,30,IND,69,1845,348,768,0,7,348,761,207,385,903
1981,Kevin McHale*,PF,23,BOS,82,1645,355,666,0,2,355,664,108,159,818
1981,Billy McKinney,PG,25,TOT,84,2166,327,645,2,12,325,633,162,188,818
1981,Billy McKinney,PG,25,UTA,35,1032,124,233,1,2,123,231,44,48,293
1981,Billy McKinney,PG,25,DEN,49,1134,203,412,1,10,202,402,118,140,525
1981,Tom McMillen,C,28,ATL,79,1564,253,519,1,6,252,513,80,108,587
1981,John Mengelt,SG,31,GSW,2,11,0,4,0,0,0,4,0,0,0
1981,Joe Meriweather,C,27,KCK,74,1514,206,415,0,0,206,415,148,213,560
1981,Dick Miller,SF,22,TOT,8,53,4,9,0,1,4,8,0,0,8
1981,Dick Miller,SF,22,IND,5,34,2,6,0,1,2,5,0,0,4
1981,Dick Miller,SF,22,UTA,3,19,2,3,0,0,2,3,0,0,4
1981,Mike Mitchell,SF,25,CLE,82,3194,853,1791,4,9,849,1782,302,385,2012
1981,Steve Mix,SF,33,PHI,72,1327,288,575,0,3,288,572,200,240,776
1981,Paul Mokeski,C,24,DET,80,1815,224,458,0,1,224,457,120,200,568
1981,Sidney Moncrief,SG,23,MIL,80,2417,400,739,2,9,398,730,320,398,1122
1981,Johnny Moore,PG,22,SAS,82,1578,249,520,1,19,248,501,105,172,604
1981,Lowes Moore,PG,23,NJN,71,1406,212,478,4,27,208,451,69,92,497
1981,Calvin Murphy*,PG,32,HOU,76,2014,528,1074,4,17,524,1057,206,215,1266
1981,Swen Nater,C,31,SDC,82,2809,517,935,0,0,517,935,244,307,1278
1981,Calvin Natt,SF,24,POR,74,2111,395,794,4,8,391,786,200,283,994
1981,Kenny Natt,SG,22,IND,19,149,25,77,2,8,23,69,7,11,59
1981,Mike Newlin,SG,32,NJN,79,2911,632,1272,10,30,622,1242,414,466,1688
1981,Carl Nicks,PG,22,TOT,67,1109,172,359,0,4,172,355,71,126,415
1981,Carl Nicks,PG,22,DEN,27,493,65,149,0,1,65,148,35,59,165
1981,Carl Nicks,PG,22,UTA,40,616,107,210,0,3,107,207,36,67,250
1981,Mike Niles,SF,25,PHO,44,231,48,138,2,4,46,134,17,37,115
1981,Norm Nixon,PG,25,LAL,79,2962,576,1210,2,12,574,1198,196,252,1350
1981,Mike O'Koren,SF,22,NJN,79,2473,365,751,5,18,360,733,135,212,870
1981,Mark Olberding,SF,24,SAS,82,2408,348,685,1,7,347,678,315,380,1012
1981,Jawann Oldham,C,23,DEN,4,21,2,6,0,0,2,6,0,0,4
1981,Louis Orr,SF,22,IND,82,1787,348,709,0,6,348,703,163,202,859
1981,Tom Owens,PF,31,POR,79,1843,322,630,0,4,322,626,191,250,835
1981,Robert Parish*,C,27,BOS,82,2298,635,1166,0,1,635,1165,282,397,1552
1981,Sonny Parker,SG,25,GSW,73,1317,191,388,0,0,191,388,94,128,476
1981,Myles Patrick,SF,26,LAL,3,9,2,5,0,0,2,5,1,2,5
1981,Billy Paultz,PF,32,HOU,81,1659,262,517,0,3,262,514,75,153,599
1981,Jim Paxson,SG,23,POR,79,2701,585,1092,2,30,583,1062,182,248,1354
1981,Sam Pellom,PF,29,ATL,77,1472,186,380,0,1,186,379,81,116,453
1981,Roger Phegley,SG,24,CLE,82,2269,474,965,8,28,466,937,224,267,1180
1981,Stan Pietkiewicz,SG,24,TOT,42,461,57,138,19,48,38,90,11,14,144
1981,Stan Pietkiewicz,SG,24,SDC,6,30,2,5,0,0,2,5,0,0,4
1981,Stan Pietkiewicz,SG,24,DAL,36,431,55,133,19,48,36,85,11,14,140
1981,Ben Poquette,PF,25,UTA,82,2808,324,614,3,6,321,608,126,162,777
1981,Kevin Porter,PG,30,WSB,81,2577,446,859,3,12,443,847,191,247,1086
1981,Tony Price,SG,24,SDC,5,29,2,7,0,0,2,7,0,0,4
1981,Wally Rank,SF,22,SDC,25,153,21,57,0,0,21,57,13,28,55
1981,Kelvin Ransey,PG,22,POR,80,2431,525,1162,3,31,522,1131,164,219,1217
1981,Clifford Ray,C,32,GSW,66,838,64,152,0,0,64,152,29,62,157
1981,James Ray,PF,23,DEN,18,148,15,49,0,1,15,48,7,10,37
1981,Billy Reid,SG,23,GSW,59,597,84,185,0,5,84,180,22,39,190
1981,Robert Reid,SF,25,HOU,82,2963,536,1113,0,4,536,1109,229,303,1301
1981,Kevin Restani,SF,29,SAS,64,999,192,369,3,8,189,361,62,88,449
1981,Clint Richardson,SG,24,PHI,77,1313,227,464,0,1,227,463,84,108,538
1981,Micheal Ray,SG,25,NYK,79,3175,523,1116,23,102,500,1014,224,338,1293
1981,Anthony Roberts,SF,25,WSB,26,350,54,144,0,0,54,144,19,29,127
1981,Rick Robey,C,25,BOS,82,1569,298,547,0,1,298,546,144,251,740
1981,Cliff Robinson,PF,20,NJN,63,1822,525,1070,1,1,524,1069,178,248,1229
1981,Truck Robinson,PF,29,PHO,82,3088,647,1280,0,0,647,1280,249,396,1543
1981,Wayne Robinson,PF,22,DET,81,1592,234,509,0,6,234,503,175,240,643
1981,Bill Robinzine,PF,28,TOT,78,2016,392,826,1,6,391,820,218,281,1003
1981,Bill Robinzine,PF,28,CLE,8,84,14,32,0,0,14,32,5,8,33
1981,Bill Robinzine,PF,28,DAL,70,1932,378,794,1,6,377,788,213,273,970
1981,Dave Robisch,C,31,TOT,84,2116,330,740,0,0,330,740,200,247,860
1981,Dave Robisch,C,31,CLE,11,372,37,98,0,0,37,98,29,36,103
1981,Dave Robisch,C,31,DEN,73,1744,293,642,0,0,293,642,171,211,757
1981,John Roche,PG,31,DEN,26,611,82,179,9,27,73,152,58,77,231
1981,Tree Rollins,C,25,ATL,40,1044,116,210,0,1,116,209,46,57,278
1981,Lorenzo Romar,PG,22,GSW,53,726,87,211,2,6,85,205,43,63,219
1981,Dan Roundfield,PF,27,ATL,63,2128,426,808,0,1,426,807,256,355,1108
1981,Campy Russell,SF,29,NYK,79,2865,508,1095,8,26,500,1069,268,343,1292
1981,Frankie Sanders,SF,24,KCK,23,186,34,77,0,0,34,77,20,22,88
1981,DeWayne Scales,PF,22,NYK,44,484,94,225,1,6,93,219,26,39,215
1981,Alvin Scott,SF,25,PHO,82,1423,173,348,1,6,172,342,97,127,444
1981,Craig Shelton,SF,23,ATL,55,586,100,219,0,1,100,218,35,58,235
1981,Lonnie Shelton,PF,25,SEA,14,440,73,174,0,0,73,174,36,55,182
1981,Purvis Short,SF,23,GSW,79,2309,549,1157,3,17,546,1140,168,205,1269
1981,John Shumate,PF,28,TOT,24,527,56,131,0,0,56,131,55,76,167
1981,John Shumate,PF,28,SAS,22,519,56,128,0,0,56,128,53,73,165
1981,John Shumate,PF,28,SEA,2,8,0,3,0,0,0,3,2,3,2
1981,Jerry Sichting,PG,24,IND,47,450,34,95,0,5,34,90,25,32,93
1981,Jack Sikma,C,25,SEA,82,2920,595,1311,0,5,595,1306,340,413,1530
1981,James Silas,PG,31,SAS,75,2055,476,997,0,2,476,995,374,440,1326
1981,Larry Smith,PF,23,GSW,82,2578,304,594,0,0,304,594,177,301,785
1981,Phil Smith,SG,28,SDC,76,2378,519,1057,4,18,515,1039,237,313,1279
1981,Randy Smith,SG,32,CLE,82,2199,486,1043,1,28,485,1015,221,271,1194
1981,Robert Smith,PG,25,CLE,1,20,2,5,0,0,2,5,4,4,8
1981,Ricky Sobers,PG,28,CHI,71,1803,355,769,17,66,338,703,231,247,958
1981,Jim Spanarkel,SF,23,DAL,82,2317,404,866,1,10,403,856,375,423,1184
1981,Rory Sparrow,PG,22,NJN,15,212,22,63,0,0,22,63,12,16,56
1981,John Stroud,SF,23,HOU,9,88,11,34,0,0,11,34,3,4,25
1981,Brian Taylor,PG,29,SDC,80,2312,310,591,44,115,266,476,146,185,810
1981,Carlos Terry,SG,24,WSB,26,504,80,160,0,6,80,154,28,42,188
1981,Reggie Theus,SG,23,CHI,82,2820,543,1097,18,90,525,1007,445,550,1549
1981,David Thompson*,SG,26,DEN,77,2620,734,1451,10,39,724,1412,489,615,1967
1981,Mychal Thompson,C,26,POR,79,2790,569,1151,0,1,569,1150,207,323,1345
1981,Rudy Tomjanovich,PF,32,HOU,52,1264,263,563,12,51,251,512,65,82,603
1981,Andrew Toney,SG,23,PHI,75,1768,399,806,9,29,390,777,161,226,968
1981,Terry Tyler,SF,24,DET,82,2549,476,895,0,8,476,887,148,250,1100
1981,Wes Unseld*,C,34,WSB,63,2032,225,429,2,4,223,425,55,86,507
1981,Ronnie Valentine,SF,23,DEN,24,123,37,98,1,2,36,96,9,19,84
1981,Jan Van,SF,29,NJN,78,1426,100,245,2,8,98,237,98,117,300
1981,Kiki Vandeweghe,SF,22,DEN,51,1376,229,537,0,7,229,530,130,159,588
1981,Brett Vroman,C,25,UTA,11,93,10,27,0,1,10,26,14,19,34
1981,Foots Walker,PG,29,NJN,41,1172,72,169,2,9,70,160,88,111,234
1981,Wally Walker,SF,26,SEA,82,1796,290,626,0,3,290,623,109,169,689
1981,Lloyd Walton,PG,27,KCK,61,821,90,218,0,1,90,217,26,33,206
1981,Kermit Washington,PF,29,POR,73,2120,325,571,0,1,325,570,181,288,831
1981,Richard Washington,PF,25,TOT,80,1812,340,747,1,2,339,745,119,159,800
1981,Richard Washington,PF,25,DAL,11,307,51,117,0,0,51,117,17,23,119
1981,Richard Washington,PF,25,CLE,69,1505,289,630,1,2,288,628,102,136,681
1981,Marvin Webster,C,28,NYK,82,1708,159,341,1,4,158,337,104,163,423
1981,Scott Wedman,SF,28,KCK,81,2902,685,1437,25,77,660,1360,140,204,1535
1981,Paul Westphal,SG,30,SEA,36,1078,221,500,6,25,215,475,153,184,601
1981,Jo Jo,PG,34,KCK,13,236,36,82,0,0,36,82,11,18,83
1981,Rudy White,SG,27,TOT,16,208,23,65,0,1,23,64,15,16,61
1981,Rudy White,SG,27,GSW,4,43,9,18,0,0,9,18,4,4,22
1981,Rudy White,SG,27,SEA,12,165,14,47,0,1,14,46,11,12,39
1981,Jerome Whitehead,C,24,TOT,48,688,83,180,0,1,83,179,28,56,194
1981,Jerome Whitehead,C,24,DAL,7,118,16,38,0,0,16,38,5,11,37
1981,Jerome Whitehead,C,24,CLE,3,8,1,3,0,0,1,3,0,0,2
1981,Jerome Whitehead,C,24,SDC,38,562,66,139,0,1,66,138,23,45,155
1981,Hawkeye Whitney,SG,23,KCK,47,782,149,306,2,6,147,300,50,65,350
1981,Sidney Wicks,PF,31,SDC,49,1083,125,286,0,1,125,285,76,150,326
1981,Michael Wiley,PF,23,SAS,33,271,76,138,0,2,76,136,36,48,188
1981,Bob Wilkerson,SG,26,CHI,80,2238,330,715,1,10,329,705,137,163,798
1981,Jamaal Wilkes*,SF,27,LAL,81,3028,786,1495,1,13,785,1482,254,335,1827
1981,James Wilkes,SF,22,CHI,48,540,85,184,0,1,85,183,29,42,199
1981,Jeff Wilkins,C,25,UTA,56,1058,117,260,0,0,117,260,27,40,261
1981,Freeman Williams,SG,24,SDC,82,1976,642,1381,48,141,594,1240,253,297,1585
1981,Ray Williams,PG,26,NYK,79,2742,616,1335,16,68,600,1267,312,382,1560
1981,Sly Williams,PF,23,NYK,67,1976,349,708,2,8,347,700,185,268,885
1981,John Williamson,SG,29,WSB,9,112,18,56,1,6,17,50,5,6,42
1981,Bill Willoughby,SF,23,HOU,55,1145,150,287,0,0,150,287,49,64,349
1981,Brian Winters,SG,28,MIL,69,1771,331,697,18,51,313,646,119,137,799
1981,Mike Woodson,SG,22,NYK,81,949,165,373,1,5,164,368,49,64,380
1981,Sam Worthen,PG,23,CHI,64,945,95,192,0,4,95,188,45,60,235
1981,Larry Wright,PG,26,DET,45,997,140,303,2,7,138,296,53,66,335
,,,,,,,,,,,,,,,
1982,Kareem Abdul-Jabbar*,C,34,LAL,76,2677,753,1301,0,3,753,1298,312,442,1818
1982,Alvan Adams,C,27,PHO,79,2393,507,1027,0,1,507,1026,182,233,1196
1982,Mark Aguirre,SF,22,DAL,51,1468,381,820,25,71,356,749,168,247,955
1982,Danny Ainge,SG,22,BOS,53,564,79,221,5,17,74,204,56,65,219
1982,Tiny Archibald*,PG,33,BOS,68,2167,308,652,6,16,302,636,236,316,858
1982,Dennis Awtrey,C,33,POR,10,121,5,15,0,0,5,15,5,9,15
1982,Carl Bailey,C,23,POR,1,7,1,1,0,0,1,1,0,0,2
1982,James Bailey,PF,24,TOT,77,1468,261,505,0,0,261,505,137,224,659
1982,James Bailey,PF,24,SEA,10,180,31,65,0,0,31,65,4,11,66
1982,James Bailey,PF,24,NJN,67,1288,230,440,0,0,230,440,133,213,593
1982,Greg Ballard,SF,27,WSB,79,2946,621,1307,9,22,612,1285,235,283,1486
1982,Gene Banks,SF,22,SAS,80,1700,311,652,0,8,311,644,145,212,767
1982,Mike Bantom,SF,30,TOT,82,2016,334,712,2,6,332,706,168,267,838
1982,Mike Bantom,SF,30,IND,39,1037,178,406,1,3,177,403,101,153,458
1982,Mike Bantom,SF,30,PHI,43,979,156,306,1,3,155,303,67,114,380
1982,Billy Ray,SG,25,POR,75,1229,327,692,12,41,315,651,166,211,832
1982,Mel Bennett,PF,27,CLE,3,23,2,4,0,0,2,4,1,6,5
1982,Kent Benson,C,27,DET,75,2467,405,802,3,11,402,791,127,158,940
1982,Larry Bird*,PF,25,BOS,77,2923,711,1414,11,52,700,1362,328,380,1761
1982,Otis Birdsong,SG,26,NJN,37,1025,225,480,0,10,225,470,74,127,524
1982,Rolando Blackman,SG,22,DAL,82,1979,439,855,1,4,438,851,212,276,1091
1982,Ray Blume,SG,23,CHI,49,546,102,222,4,18,98,204,18,28,226
1982,Alex Bradley,SF,22,NYK,39,331,54,103,0,1,54,102,29,48,137
1982,Charles Bradley,SG,22,BOS,51,339,55,122,0,1,55,121,42,62,152
1982,Dudley Bradley,SG,24,PHO,64,937,125,281,1,4,124,277,74,100,325
1982,Brad Branson,PF,23,CLE,10,176,21,52,0,0,21,52,11,12,53
1982,Mike Bratz,PG,26,SAS,81,1616,230,565,46,138,184,427,119,152,625
1982,Jim Brewer,PF,30,LAL,71,966,81,175,1,6,80,169,7,19,170
1982,Ron Brewer,SG,26,TOT,72,2319,569,1194,8,31,561,1163,211,260,1357
1982,Ron Brewer,SG,26,SAS,25,595,182,361,3,10,179,351,77,88,444
1982,Ron Brewer,SG,26,CLE,47,1724,387,833,5,21,382,812,134,172,913
1982,Junior Bridgeman,SF,28,MIL,41,924,209,433,4,9,205,424,89,103,511
1982,Allan Bristow,SF,30,DAL,82,2035,218,499,3,18,215,481,134,164,573
1982,Jim Brogan,SG,23,SDC,63,1027,165,364,9,32,156,332,61,84,400
1982,Michael Brooks,SF,23,SDC,82,2750,537,1066,0,7,537,1059,202,267,1276
1982,Fred Brown,SG,33,SEA,82,1785,393,863,25,77,368,786,111,129,922
1982,Rickey Brown,C,23,GSW,82,1260,192,418,0,0,192,418,86,122,470
1982,Joe Bryant,SF,27,SDC,75,1988,341,701,8,30,333,671,194,247,884
1982,Quinn Buckner,PG,27,MIL,70,2156,396,822,4,15,392,807,110,168,906
1982,Roger Burkman,SG,23,CHI,6,30,0,4,0,1,0,3,5,6,5
1982,David Burns,PG,23,TOT,9,87,7,16,0,0,7,16,9,15,23
1982,David Burns,PG,23,NJN,3,34,2,5,0,0,2,5,3,6,7
1982,David Burns,PG,23,DEN,6,53,5,11,0,0,5,11,6,9,16
1982,Don Buse,PG,31,IND,82,2529,312,685,73,189,239,496,100,123,797
1982,Kenny Carr,PF,26,TOT,74,1926,348,692,1,10,347,682,198,302,895
1982,Kenny Carr,PF,26,CLE,46,1482,271,524,1,9,270,515,145,220,688
1982,Kenny Carr,PF,26,DET,28,444,77,168,0,1,77,167,53,82,207
1982,M.L. Carr,SF,31,BOS,56,1296,184,409,5,17,179,392,82,116,455
1982,Joe Barry,C,23,GSW,76,2627,527,1016,0,1,527,1015,235,323,1289
1982,Butch Carter,SG,23,IND,75,1035,188,402,8,25,180,377,58,70,442
1982,Reggie Carter,SG,24,NYK,75,923,119,280,0,0,119,280,64,80,302
1982,Bill Cartwright,C,24,NYK,72,2060,390,694,0,0,390,694,257,337,1037
1982,Harvey Catchings,PF,30,MIL,80,1603,94,224,0,0,94,224,41,69,229
1982,Bobby Cattage,PF,23,UTA,49,337,60,135,0,2,60,133,30,41,150
1982,Tom Chambers,PF,22,SDC,81,2682,554,1056,0,2,554,1054,284,458,1392
1982,Maurice Cheeks,PG,25,PHI,79,2498,352,676,6,22,346,654,171,220,881
1982,Jim Chones,C,32,WSB,59,867,74,171,0,0,74,171,36,46,184
1982,Don Collins,SG,23,WSB,79,1609,334,653,1,12,333,641,121,169,790
1982,Darwin Cook,PG,23,NJN,82,2090,387,803,7,31,380,772,118,162,899
1982,Jeff Cook,PF,25,PHO,76,1298,151,358,0,2,151,356,89,134,391
1982,Joe Cooper,C,24,NJN,1,11,1,2,0,0,1,2,0,0,2
1982,Michael Cooper,SG,25,LAL,76,2197,383,741,2,17,381,724,139,171,907
1982,Wayne Cooper,C,25,DAL,76,1818,281,669,1,8,280,661,119,160,682
1982,Hollis Copeland,SF,26,NYK,18,118,16,38,0,0,16,38,5,6,37
1982,Dave Corzine,C,25,SAS,82,2189,336,648,1,4,335,644,159,213,832
1982,Charlie Criss,PG,33,TOT,55,1392,222,498,10,29,212,469,141,159,595
1982,Charlie Criss,PG,33,ATL,27,552,84,210,2,8,82,202,65,73,235
1982,Charlie Criss,PG,33,SDC,28,840,138,288,8,21,130,267,76,86,360
1982,Geoff Crompton,C,26,MIL,35,203,11,32,0,0,11,32,6,15,28
1982,Pat Cummings,PF,25,MIL,78,1132,219,430,0,2,219,428,67,91,505
1982,Earl Cureton,PF,24,PHI,66,956,149,306,0,2,149,304,51,94,349
1982,Bob Dandridge,SF,34,MIL,11,174,21,55,0,0,21,55,10,17,52
1982,Adrian Dantley*,SF,25,UTA,81,3222,904,1586,1,3,903,1583,648,818,2457
1982,Brad Davis,PG,26,DAL,82,2614,397,771,14,49,383,722,185,230,993
1982,Charles Davis,SF,23,WSB,54,575,88,184,0,2,88,182,30,37,206
1982,Johnny Davis,SG,26,IND,82,2664,538,1153,5,27,533,1126,315,394,1396
1982,Ron Davis,SF,27,SDC,7,67,10,25,0,0,10,25,3,6,23
1982,Walter Davis,SF,27,PHO,55,1182,350,669,3,16,347,653,91,111,794
1982,Darryl Dawkins,C,25,PHI,48,1124,207,367,0,2,207,365,114,164,528
1982,Larry Demic,PF,24,NYK,48,356,39,83,0,1,39,82,14,39,92
1982,Kenny Dennard,PF,23,KCK,30,607,62,121,0,0,62,121,26,40,150
1982,Coby Dietrick,C,33,CHI,74,999,92,200,0,1,92,199,38,54,222
1982,Mickey Dillard,PG,23,CLE,33,221,29,79,0,4,29,75,15,23,73
1982,James Donaldson,C,24,SEA,82,1710,255,419,0,0,255,419,151,240,661
1982,John Douglas,SG,25,SDC,64,1031,181,389,18,59,163,330,67,102,447
1982,Leon Douglas,C,27,KCK,63,1093,70,140,0,0,70,140,32,80,172
1982,John Drew,SF,27,ATL,70,2040,465,957,4,12,461,945,364,491,1298
1982,Larry Drew,PG,23,KCK,81,1973,358,757,8,27,350,730,150,189,874
1982,Terry Duerod,SG,25,BOS,21,146,34,77,0,1,34,76,4,12,72
1982,Mike Dunleavy,SG,27,HOU,70,1315,206,450,33,86,173,364,75,106,520
1982,T.R. Dunn,SG,26,DEN,82,2519,258,504,0,1,258,503,153,215,669
1982,John Duren,PG,23,UTA,79,1056,121,268,3,11,118,257,27,37,272
1982,Craig Dykema,SF,22,PHO,32,103,17,37,2,4,15,33,7,9,43
1982,Franklin Edwards,PG,22,PHI,42,291,65,150,0,9,65,141,20,27,150
1982,James Edwards,C,26,CLE,77,2539,528,1033,0,4,528,1029,232,339,1288
1982,Len Elmore,C,29,NJN,81,2100,300,652,0,0,300,652,135,170,735
1982,Alex English*,SF,28,DEN,82,3015,855,1553,0,8,855,1545,372,443,2082
1982,Julius Erving*,SF,31,PHI,81,2789,780,1428,3,11,777,1417,411,539,1974
1982,Mike Evans,PG,26,TOT,22,270,35,86,0,6,35,80,13,20,83
1982,Mike Evans,PG,26,MIL,14,196,24,51,0,2,24,49,8,12,56
1982,Mike Evans,PG,26,CLE,8,74,11,35,0,4,11,31,5,8,27
1982,Eric Fernsten,C,28,BOS,43,202,19,49,0,0,19,49,19,30,57
1982,Chris Ford,SG,33,BOS,76,1591,188,450,20,63,168,387,39,56,435
1982,Don Ford,SF,29,CLE,21,201,9,24,0,1,9,23,5,6,23
1982,Phil Ford,PG,25,KCK,72,1952,285,649,7,32,278,617,136,166,713
1982,World B.,SG,28,GSW,78,2796,650,1452,10,56,640,1396,479,647,1789
1982,Mike Gale,PG,31,GSW,75,1793,185,373,0,5,185,368,51,65,421
1982,Calvin Garrett,SF,25,HOU,51,858,105,242,3,10,102,232,17,26,230
1982,George Gervin*,SG,29,SAS,79,2817,993,1987,10,36,983,1951,555,642,2551
1982,Artis Gilmore*,C,32,CHI,82,2796,546,837,1,1,545,836,424,552,1517
1982,Mike Glenn,SG,26,ATL,49,833,158,291,1,2,157,289,59,67,376
1982,Mike Gminski,C,22,NJN,64,740,119,270,0,0,119,270,97,118,335
1982,Glen Gondrezick,SF,26,DEN,80,1699,250,495,0,3,250,492,160,217,660
1982,Rickey Green,PG,27,UTA,81,2822,500,1015,0,8,500,1007,202,264,1202
1982,Dave Greenwood,PF,24,CHI,82,2914,480,1014,0,3,480,1011,240,291,1200
1982,Kevin Grevey,SG,28,WSB,71,2164,376,857,28,82,348,775,165,193,945
1982,Paul Griffin,PF,28,SAS,23,459,32,66,0,0,32,66,24,37,88
1982,Darrell Griffith,SG,23,UTA,80,2597,689,1429,15,52,674,1377,189,271,1582
1982,Bob Gross,SF,28,POR,59,1377,173,322,3,6,170,316,78,104,427
1982,Ernie Grunfeld,SG,26,KCK,81,1892,420,822,2,14,418,808,188,229,1030
1982,Petur Gudmundsson,C,23,POR,68,845,83,166,1,1,82,165,52,76,219
1982,Glenn Hagan,PG,26,DET,4,25,3,7,0,0,3,7,1,1,7
1982,Bill Hanzlik,SF,24,SEA,81,1974,167,357,0,4,167,353,138,176,472
1982,Alan Hardy,SG,24,DET,38,310,62,136,0,5,62,131,18,29,142
1982,James Hardy,SF,25,UTA,82,1814,179,369,0,1,179,368,64,93,422
1982,Mike Harper,PF,24,POR,68,1433,184,370,0,1,184,369,96,153,464
1982,Joe Hassett,SG,26,GSW,68,787,144,382,71,214,73,168,31,37,390
1982,Steve Hawes,PF,31,ATL,49,1317,178,370,4,10,174,360,96,126,456
1982,Elvin Hayes*,PF,36,HOU,82,3032,519,1100,0,5,519,1095,280,422,1318
1982,Steve Hayes,C,26,TOT,35,487,54,111,0,0,54,111,32,53,140
1982,Steve Hayes,C,26,SAS,9,75,8,18,0,0,8,18,7,12,23
1982,Steve Hayes,C,26,DET,26,412,46,93,0,0,46,93,25,41,117
1982,Spencer Haywood*,PF,32,WSB,76,2086,395,829,0,3,395,826,219,260,1009
1982,Gerald Henderson,PG,26,BOS,82,1844,353,705,2,12,351,693,125,172,833
1982,Tom Henderson,SG,30,HOU,75,1721,183,403,0,2,183,401,105,150,471
1982,Keith Herron,SG,25,CLE,30,269,39,106,0,1,39,105,7,8,85
1982,Kenny Higgs,PG,27,DEN,76,1696,202,468,4,21,198,447,161,197,569
1982,Armond Hill,PG,28,TOT,40,723,53,126,0,2,53,124,39,55,145
1982,Armond Hill,PG,28,SEA,21,243,19,37,0,0,19,37,17,23,55
1982,Armond Hill,PG,28,SDC,19,480,34,89,0,2,34,87,22,32,90
1982,Brad Holland,SG,25,TOT,14,194,27,78,0,3,27,75,3,6,57
1982,Brad Holland,SG,25,WSB,13,185,27,73,0,3,27,70,3,4,57
1982,Brad Holland,SG,25,MIL,1,9,0,5,0,0,0,5,0,2,0
1982,Lionel Hollins,PG,28,PHI,81,2257,380,797,2,16,378,781,132,188,894
1982,Cedrick Hordges,PF,25,DEN,77,1372,204,414,3,13,201,401,116,199,527
1982,Phil Hubbard,SF,25,TOT,83,1839,326,665,0,4,326,661,191,280,843
1982,Phil Hubbard,SF,25,DET,52,1104,207,410,0,3,207,407,106,163,520
1982,Phil Hubbard,SF,25,CLE,31,735,119,255,0,1,119,254,85,117,323
1982,Geoff Huston,PG,24,CLE,78,2409,325,672,3,10,322,662,153,200,806
1982,Dan Issel*,C,33,DEN,81,2472,651,1236,4,6,647,1230,546,655,1852
1982,Tracy Jackson,SG,22,TOT,49,478,79,172,0,0,79,172,38,49,196
1982,Tracy Jackson,SG,22,BOS,11,66,10,26,0,0,10,26,6,10,26
1982,Tracy Jackson,SG,22,CHI,38,412,69,146,0,0,69,146,32,39,170
1982,Clay Johnson,SG,25,LAL,7,65,11,20,0,0,11,20,3,6,25
1982,Clemon Johnson,C,25,IND,79,1979,312,641,0,0,312,641,123,189,747
1982,Dennis Johnson*,SG,27,PHO,80,2937,577,1228,8,42,569,1186,399,495,1561
1982,Eddie Johnson,SG,26,ATL,68,2314,455,1011,7,30,448,981,294,385,1211
1982,Eddie Johnson,SF,22,KCK,74,1517,295,643,1,11,294,632,99,149,690
1982,Frank Johnson,PG,23,WSB,79,2027,336,812,17,79,319,733,153,204,842
1982,George Johnson,C,33,SAS,75,1578,91,195,0,0,91,195,43,64,225
1982,George Johnson,PF,25,IND,59,720,120,291,0,2,120,289,60,80,300
1982,John Johnson,SF,34,SEA,14,187,22,45,0,0,22,45,15,20,59
1982,Magic Johnson*,SG,22,LAL,78,2991,556,1036,6,29,550,1007,329,433,1447
1982,Marques Johnson,SF,25,MIL,60,1900,404,760,0,4,404,756,182,260,990
1982,Mickey Johnson,PF,29,MIL,76,1934,372,757,1,7,371,750,233,291,978
1982,Ollie Johnson,SF,32,PHI,26,150,27,54,1,3,26,51,6,7,61
1982,Reggie Johnson,PF,24,TOT,75,1904,351,662,0,1,351,661,118,156,820
1982,Reggie Johnson,PF,24,SAS,21,504,94,194,0,0,94,194,32,40,220
1982,Reggie Johnson,PF,24,CLE,23,617,94,175,0,0,94,175,35,44,223
1982,Reggie Johnson,PF,24,KCK,31,783,163,293,0,1,163,292,51,72,377
1982,Steve Johnson,C,24,KCK,78,1741,395,644,0,0,395,644,212,330,1002
1982,Vinnie Johnson,SG,25,TOT,74,1295,217,444,3,12,214,432,107,142,544
1982,Vinnie Johnson,SG,25,SEA,7,104,9,22,0,1,9,21,9,12,27
1982,Vinnie Johnson,SG,25,DET,67,1191,208,422,3,11,205,411,98,130,517
1982,Bobby Jones,PF,30,PHI,76,2181,416,737,0,3,416,734,263,333,1095
1982,Caldwell Jones,C,31,PHI,81,2446,231,465,0,3,231,462,179,219,641
1982,Dwight Jones,PF,29,CHI,78,2040,303,572,1,1,302,571,172,238,779
1982,Edgar Jones,PF,25,DET,48,802,142,259,1,2,141,257,90,129,375
1982,Major Jones,PF,28,HOU,60,746,113,213,0,3,113,210,42,77,268
1982,Eddie Jordan,PG,27,LAL,58,608,89,208,1,9,88,199,43,54,222
1982,Jeff Judkins,SF,25,DET,30,251,31,81,1,10,30,71,16,26,79
1982,Clarence Kea,PF,22,DAL,35,248,26,49,0,0,26,49,29,42,81
1982,Rich Kelley,C,28,PHO,81,1892,236,505,0,1,236,504,167,223,639
1982,Greg Kelser,SF,24,TOT,60,741,116,271,0,3,116,268,105,160,337
1982,Greg Kelser,SF,24,DET,11,183,35,86,0,3,35,83,27,41,97
1982,Greg Kelser,SF,24,SEA,49,558,81,185,0,0,81,185,78,119,240
1982,Larry Kenon,PF,29,CHI,60,1036,192,412,0,0,192,412,50,88,434
1982,Albert King,SF,22,NJN,76,1694,391,812,3,13,388,799,133,171,918
1982,Bernard King*,SF,25,GSW,79,2861,740,1307,1,5,739,1302,352,499,1833
1982,Reggie King,SF,24,KCK,80,2609,383,752,0,0,383,752,201,285,967
1982,Billy Knight,SF,29,IND,81,1803,378,764,9,32,369,732,233,282,998
1982,Toby Knight,SF,26,NYK,40,550,102,183,0,0,102,183,17,25,221
1982,Joel Kramer,PF,26,PHO,56,549,55,133,0,0,55,133,33,42,143
1982,Kevin Kunnert,C,30,POR,21,237,20,48,0,0,20,48,9,17,49
1982,Mitch Kupchak,PF,27,LAL,26,821,153,267,0,0,153,267,65,98,371
1982,Sam Lacey,C,33,TOT,56,670,67,154,0,1,67,153,27,37,161
1982,Sam Lacey,C,33,KCK,2,20,3,5,0,0,3,5,0,2,6
1982,Sam Lacey,C,33,NJN,54,650,64,149,0,1,64,148,27,35,155
1982,Tom LaGarde,C,26,DAL,47,909,113,269,0,2,113,267,86,166,312
1982,Bill Laimbeer,C,24,TOT,80,1829,265,536,4,13,261,523,184,232,718
1982,Bill Laimbeer,C,24,CLE,50,894,119,253,3,6,116,247,93,120,334
1982,Bill Laimbeer,C,24,DET,30,935,146,283,1,7,145,276,91,112,384
1982,John Lambert,PF,29,TOT,63,764,86,197,1,7,85,190,34,42,207
1982,John Lambert,PF,29,KCK,42,493,60,139,1,6,59,133,21,28,142
1982,John Lambert,PF,29,SAS,21,271,26,58,0,1,26,57,13,14,65
1982,Jeff Lamp,SF,22,POR,54,617,100,196,0,1,100,195,50,61,250
1982,Mark Landsberger,PF,26,LAL,75,1134,144,329,0,2,144,327,33,65,321
1982,Bob Lanier*,C,33,MIL,74,1986,407,729,0,2,407,727,182,242,996
1982,Allen Leavell,PG,24,HOU,79,2150,370,793,9,31,361,762,115,135,864
1982,Rock Lee,C,26,SDC,2,10,1,2,0,0,1,2,0,4,2
1982,Ron Lee,PG,29,DET,81,1467,88,246,18,59,70,187,84,119,278
1982,Ronnie Lester,PG,23,CHI,75,2252,329,657,4,8,325,649,208,256,870
1982,Alton Lister,C,23,MIL,80,1186,149,287,0,0,149,287,64,123,362
1982,Lewis Lloyd,SG,22,GSW,16,95,25,45,0,0,25,45,7,11,57
1982,Scott Lloyd,PF,29,DAL,74,1047,108,285,2,4,106,281,69,91,287
1982,Kevin Loder,SF,22,KCK,71,1139,208,448,0,11,208,437,77,107,493
1982,John Long,SG,25,DET,69,2211,637,1294,2,15,635,1279,238,275,1514
1982,John Lucas,PG,28,WSB,79,1940,263,618,2,22,261,596,138,176,666
1982,Maurice Lucas,PF,29,NYK,80,2671,505,1001,0,3,505,998,253,349,1263
1982,Ollie Mack,SG,24,DAL,13,150,19,59,0,2,19,57,6,8,44
1982,Rudy Macklin,SF,23,ATL,79,1516,210,484,0,3,210,481,134,173,554
1982,Kyle Macy,PG,24,PHO,82,2845,486,945,39,100,447,845,152,169,1163
1982,Rick Mahorn,PF,23,WSB,80,2664,414,816,0,3,414,813,148,234,976
1982,Moses Malone*,C,26,HOU,81,3398,945,1822,0,6,945,1816,630,827,2520
1982,Wes Matthews,PG,22,ATL,47,837,131,298,2,8,129,290,60,79,324
1982,Cedric Maxwell,SF,26,BOS,78,2590,397,724,0,3,397,721,357,478,1151
1982,Scott May,SF,27,MIL,65,1187,212,417,0,4,212,413,159,193,583
1982,Bob McAdoo*,C,30,LAL,41,746,151,330,0,5,151,325,90,126,392
1982,John McCullough,SG,25,PHO,8,23,9,13,0,0,9,13,3,5,21
1982,Hank McDowell,PF,22,GSW,30,335,34,84,0,0,34,84,27,41,95
1982,Jim McElroy,PG,28,ATL,20,349,52,125,1,5,51,120,29,36,134
1982,Mike McGee,SF,22,LAL,39,352,80,172,0,4,80,168,31,53,191
1982,George McGinnis,PF,31,IND,76,1341,141,378,0,3,141,375,72,159,354
1982,Kevin McHale*,PF,24,BOS,82,2332,465,875,0,0,465,875,187,248,1117
1982,Kevin McKenna,SG,23,LAL,36,237,28,87,0,2,28,85,11,17,67
1982,Billy McKinney,PG,26,DEN,81,1963,369,699,0,17,369,682,137,170,875
1982,Tom McMillen,C,29,ATL,73,1792,291,572,1,3,290,569,140,170,723
1982,Joe Meriweather,C,28,KCK,18,380,47,91,0,0,47,91,31,40,125
1982,Mike Mitchell,SF,26,TOT,84,3063,753,1477,0,7,753,1470,220,302,1726
1982,Mike Mitchell,SF,26,CLE,27,973,229,504,0,6,229,498,72,100,530
1982,Mike Mitchell,SF,26,SAS,57,2090,524,973,0,1,524,972,148,202,1196
1982,Steve Mix,SF,34,PHI,75,1235,202,399,1,4,201,395,136,172,541
1982,Paul Mokeski,C,25,TOT,67,868,84,193,0,3,84,190,48,63,216
1982,Paul Mokeski,C,25,DET,39,523,49,111,0,1,49,110,25,33,123
1982,Paul Mokeski,C,25,CLE,28,345,35,82,0,2,35,80,23,30,93
1982,Sidney Moncrief,SG,24,MIL,80,2980,556,1063,1,14,555,1049,468,573,1581
1982,Johnny Moore,PG,23,SAS,79,2294,309,667,1,21,308,646,122,182,741
1982,Lowes Moore,PG,24,CLE,4,70,19,38,1,5,18,33,6,8,45
1982,Calvin Murphy*,PG,33,HOU,64,1204,277,648,1,16,276,632,100,110,655
1982,Larry Nance,PF,22,PHO,80,1186,227,436,0,1,227,435,75,117,529
1982,Swen Nater,C,32,SDC,21,575,101,175,1,1,100,174,59,79,262
1982,Calvin Natt,SF,25,POR,75,2599,515,894,2,8,513,886,294,392,1326
1982,Mike Newlin,SG,33,NYK,76,1507,286,615,7,23,279,592,126,147,705
1982,Carl Nicks,SG,23,UTA,80,1322,252,555,0,5,252,550,85,150,589
1982,Kurt Nimphius,C,23,DAL,63,1085,137,297,0,0,137,297,63,108,337
1982,Norm Nixon,PG,26,LAL,82,3024,628,1274,3,12,625,1262,181,224,1440
1982,Mike O'Koren,SF,23,NJN,80,2018,383,778,8,23,375,755,135,189,909
1982,Mark Olberding,PF,25,SAS,68,2098,333,705,2,12,331,693,273,338,941
1982,Jawann Oldham,C,24,HOU,22,124,13,36,0,0,13,36,8,14,34
1982,Louis Orr,SF,23,IND,80,1951,357,719,1,8,356,711,203,254,918
1982,Tom Owens,PF,32,IND,74,1599,299,636,1,2,298,634,181,226,780
1982,Robert Parish*,C,28,BOS,80,2534,669,1235,0,0,669,1235,252,355,1590
1982,Sonny Parker,SF,26,GSW,71,899,116,245,0,0,116,245,48,72,280
1982,Billy Paultz,C,33,HOU,65,807,89,226,0,0,89,226,34,65,212
1982,Jim Paxson,SG,24,POR,82,2756,662,1258,8,35,654,1223,220,287,1552
1982,Sam Pellom,PF,30,ATL,69,1037,114,251,0,1,114,250,61,79,289
1982,Roger Phegley,SG,25,TOT,81,1183,233,507,5,31,228,476,85,109,556
1982,Roger Phegley,SG,25,CLE,27,566,104,214,4,13,100,201,36,45,248
1982,Roger Phegley,SG,25,SAS,54,617,129,293,1,18,128,275,49,64,308
1982,Ben Poquette,PF,26,UTA,82,1698,220,428,3,10,217,418,97,120,540
1982,Mark Radford,SG,22,SEA,43,369,54,100,2,3,52,97,35,69,145
1982,Ed Rains,SF,25,SAS,49,637,77,177,0,2,77,175,38,64,192
1982,Kurt Rambis,PF,23,LAL,64,1131,118,228,0,1,118,227,59,117,295
1982,Kelvin Ransey,PG,23,POR,78,2418,504,1095,3,38,501,1057,242,318,1253
1982,James Ray,PF,24,DEN,40,262,51,116,1,1,50,115,21,36,124
1982,Robert Reid,SF,26,HOU,77,2913,437,958,1,10,436,948,160,214,1035
1982,Kevin Restani,PF,30,TOT,47,483,32,88,0,2,32,86,10,16,74
1982,Kevin Restani,PF,30,SAS,13,145,9,28,0,1,9,27,3,4,21
1982,Kevin Restani,PF,30,CLE,34,338,23,60,0,1,23,59,7,12,53
1982,Clint Richardson,SG,25,PHI,77,1040,140,310,2,2,138,308,69,88,351
1982,Micheal Ray,PG,26,NYK,82,3044,619,1343,19,101,600,1242,212,303,1469
1982,Rick Robey,C,26,BOS,80,1186,185,375,0,2,185,373,84,157,454
1982,Cliff Robinson,PF,21,TOT,68,2175,518,1143,0,4,518,1139,222,313,1258
1982,Cliff Robinson,PF,21,KCK,38,1229,322,708,0,3,322,705,125,180,769
1982,Cliff Robinson,PF,21,CLE,30,946,196,435,0,1,196,434,97,133,489
1982,Jackie Robinson,SF,26,CHI,3,29,3,9,0,0,3,9,4,4,10
1982,Truck Robinson,PF,30,PHO,74,2745,579,1128,1,1,578,1127,255,371,1414
1982,Bill Robinzine,PF,29,UTA,56,651,131,294,0,0,131,294,61,75,323
1982,Dave Robisch,C,32,DEN,12,257,48,106,0,0,48,106,48,55,144
1982,John Roche,SG,32,DEN,39,501,68,150,23,52,45,98,28,38,187
1982,Tree Rollins,C,26,ATL,79,2018,202,346,0,0,202,346,79,129,483
1982,Lorenzo Romar,PG,23,GSW,79,1259,203,403,3,15,200,388,79,96,488
1982,Dan Roundfield,PF,28,ATL,61,2217,424,910,1,5,423,905,285,375,1134
1982,Jeff Ruland,C,23,WSB,82,2214,420,749,1,3,419,746,342,455,1183
1982,Campy Russell,SF,30,NYK,77,2358,410,858,25,57,385,801,228,294,1073
1982,DeWayne Scales,PF,23,NYK,3,24,1,5,0,0,1,5,1,2,3
1982,Danny Schayes,C,22,UTA,82,1623,252,524,0,1,252,523,140,185,644
1982,Alvin Scott,SF,26,PHO,81,1740,189,380,0,2,189,378,108,148,486
1982,Craig Shelton,SF,24,ATL,4,21,2,6,0,0,2,6,1,2,5
1982,Lonnie Shelton,PF,26,SEA,81,2667,508,1046,0,8,508,1038,188,240,1204
1982,Purvis Short,SF,24,GSW,76,1782,456,935,6,28,450,907,177,221,1095
1982,Jerry Sichting,PG,25,IND,51,800,91,194,1,9,90,185,29,38,212
1982,Jack Sikma,C,26,SEA,82,3049,581,1212,2,13,579,1199,447,523,1611
1982,James Silas,SG,32,CLE,67,1447,251,573,0,5,251,568,246,286,748
1982,Jim Smith,PF,23,SDC,72,858,86,169,0,0,86,169,39,85,211
1982,Larry Smith,PF,24,GSW,74,2213,220,412,0,1,220,411,88,159,528
1982,Phil Smith,SG,29,TOT,74,2042,340,761,5,27,335,734,163,223,848
1982,Phil Smith,SG,29,SDC,48,1446,253,575,5,24,248,551,123,168,634
1982,Phil Smith,SG,29,SEA,26,596,87,186,0,3,87,183,40,55,214
1982,Randy Smith,SG,33,NYK,82,2033,348,748,3,11,345,737,122,151,821
1982,Robert Smith,PG,26,MIL,17,316,52,110,2,10,50,100,10,12,116
1982,Ricky Sobers,SG,29,CHI,80,1938,363,801,19,76,344,725,195,254,940
1982,Jim Spanarkel,SG,24,DAL,82,1755,270,564,8,24,262,540,279,327,827
1982,Rory Sparrow,PG,23,ATL,82,2610,366,730,1,15,365,715,124,148,857
1982,Larry Spriggs,SF,22,HOU,4,37,7,11,0,0,7,11,0,2,14
1982,Kevin Stacom,SG,30,MIL,7,90,14,34,1,2,13,32,1,2,30
1982,Brian Taylor,PG,30,SDC,41,1274,165,328,23,63,142,265,90,110,443
1982,Carlos Terry,SG,25,WSB,13,60,3,15,0,3,3,12,3,4,9
1982,Reggie Theus,SG,24,CHI,82,2838,560,1194,25,100,535,1094,363,449,1508
1982,Isiah Thomas*,PG,20,DET,72,2433,453,1068,17,59,436,1009,302,429,1225
1982,David Thompson*,SG,27,DEN,61,1246,313,644,4,14,309,630,276,339,906
1982,Mychal Thompson,C,27,POR,79,3129,681,1303,0,0,681,1303,280,446,1642
1982,Ray Tolbert,PF,23,TOT,64,607,100,202,0,2,100,200,19,35,219
1982,Ray Tolbert,PF,23,NJN,12,115,20,44,0,1,20,43,4,8,44
1982,Ray Tolbert,PF,23,SEA,52,492,80,158,0,1,80,157,15,27,175
1982,Andrew Toney,SG,24,PHI,77,1909,511,979,25,59,486,920,227,306,1274
1982,Raymond Townsend,SG,26,IND,14,95,11,41,2,9,9,32,11,20,35
1982,Kelly Tripucka,SF,22,DET,82,3077,636,1281,5,22,631,1259,495,621,1772
1982,Elston Turner,SF,22,DAL,80,1996,282,639,0,4,282,635,97,138,661
1982,Terry Tyler,PF,25,DET,82,1989,336,643,1,4,335,639,142,192,815
1982,Darnell Valentine,PG,22,POR,82,1387,187,453,0,9,187,444,152,200,526
1982,Jan Van,SF,30,NJN,41,452,41,82,0,2,41,80,62,76,144
1982,Kiki Vandeweghe,PF,23,DEN,82,2775,706,1260,1,13,705,1247,347,405,1760
1982,Pete Verhoeven,PF,22,POR,71,1207,149,296,0,0,149,296,51,72,349
1982,Jay Vincent,PF,22,DAL,81,2626,719,1448,1,4,718,1444,293,409,1732
1982,Danny Vranes,SF,23,SEA,77,1075,143,262,0,1,143,261,89,148,375
1982,Foots Walker,PG,30,NJN,77,1861,156,378,3,9,153,369,141,194,456
1982,Wally Walker,SF,27,SEA,70,1965,302,629,0,2,302,627,90,134,694
1982,Kermit Washington,PF,30,POR,20,418,38,78,0,0,38,78,24,41,100
1982,Richard Washington,PF,26,CLE,18,313,50,115,0,2,50,113,9,15,109
1982,Marvin Webster,C,29,NYK,82,1883,199,405,0,0,199,405,108,170,506
1982,Scott Wedman,SF,29,CLE,54,1638,260,589,5,23,255,566,66,90,591
1982,Paul Westphal,SG,31,NYK,18,451,86,194,2,8,84,186,36,47,210
1982,Jerome Whitehead,C,25,SDC,72,2214,406,726,0,0,406,726,184,241,996
1982,Hawkeye Whitney,SG,24,KCK,23,266,25,71,0,1,25,70,4,7,54
1982,Michael Wiley,PF,24,SDC,61,1013,203,359,0,5,203,354,98,141,504
1982,Bob Wilkerson,SF,27,CLE,65,1805,284,679,3,18,281,661,145,185,716
1982,Jamaal Wilkes*,SF,28,LAL,82,2906,744,1417,0,4,744,1413,246,336,1734
1982,James Wilkes,SF,23,CHI,57,862,128,266,0,1,128,265,58,80,314
1982,Jeff Wilkins,C,26,UTA,82,2274,314,718,0,3,314,715,137,176,765
1982,Buck Williams,PF,21,NJN,82,2825,513,881,0,1,513,880,242,388,1268
1982,Freeman Williams,SG,25,TOT,60,997,276,623,28,94,248,529,140,166,720
1982,Freeman Williams,SG,25,SDC,37,808,234,513,24,74,210,439,118,140,610
1982,Freeman Williams,SG,25,ATL,23,189,42,110,4,20,38,90,22,26,110
1982,Gus Williams,PG,28,SEA,80,2876,773,1592,9,40,764,1552,320,436,1875
1982,Herb Williams,C,23,IND,82,2277,407,854,2,7,405,847,126,188,942
1982,Ray Williams,SG,27,NJN,82,2732,639,1383,9,54,630,1329,387,465,1674
1982,Sam Williams,PF,22,GSW,59,1073,154,277,0,0,154,277,49,89,357
1982,Sly Williams,SF,24,NYK,60,1521,349,628,2,9,347,619,131,173,831
1982,Bill Willoughby,SF,24,HOU,69,1475,240,464,3,7,237,457,56,77,539
1982,Brian Winters,SG,29,MIL,61,1829,404,806,36,93,368,713,123,156,967
1982,Garry Witts,SF,22,WSB,46,493,49,84,1,2,48,82,33,40,132
1982,Al Wood,SG,23,TOT,48,930,179,381,3,24,176,357,93,119,454
1982,Al Wood,SG,23,ATL,19,238,36,105,0,6,36,99,20,28,92
1982,Al Wood,SG,23,SDC,29,692,143,276,3,18,140,258,73,91,362
1982,Howard Wood,SF,22,UTA,42,342,55,120,0,1,55,119,34,52,144
1982,Mike Woodson,SG,23,TOT,83,2331,538,1069,7,25,531,1044,221,286,1304
1982,Mike Woodson,SG,23,NJN,7,145,30,68,0,1,30,67,23,32,83
1982,Mike Woodson,SG,23,KCK,76,2186,508,1001,7,24,501,977,198,254,1221
1982,Orlando Woolridge,SF,22,CHI,75,1188,202,394,0,3,202,391,144,206,548
1982,Sam Worthen,PG,24,UTA,5,22,2,5,0,0,2,5,0,0,4
1982,Larry Wright,PG,27,DET,1,6,0,1,0,0,0,1,0,0,0
1982,Rich Yonakor,PF,23,SAS,10,70,14,26,0,0,14,26,5,7,33
,,,,,,,,,,,,,,,
1983,Kareem Abdul-Jabbar*,C,35,LAL,79,2554,722,1228,0,2,722,1226,278,371,1722
1983,Alvan Adams,C,28,PHO,80,2447,477,981,1,3,476,978,180,217,1135
1983,Mark Aguirre,SF,23,DAL,81,2784,767,1589,16,76,751,1513,429,589,1979
1983,Danny Ainge,SG,23,BOS,80,2048,357,720,5,29,352,691,72,97,791
1983,Dwight Anderson,PG,22,DEN,5,33,7,14,0,0,7,14,7,10,21
1983,J.J. Anderson,SF,22,TOT,65,1202,190,379,0,4,190,375,100,175,480
1983,J.J. Anderson,SF,22,PHI,13,48,8,22,0,1,8,21,1,3,17
1983,J.J. Anderson,SF,22,UTA,52,1154,182,357,0,3,182,354,99,172,463
1983,Richard Anderson,C,22,SDC,78,1274,174,431,7,19,167,412,48,69,403
1983,Tiny Archibald*,PG,34,BOS,66,1811,235,553,5,24,230,529,220,296,695
1983,John Bagley,PG,22,CLE,68,990,161,373,0,14,161,359,64,84,386
1983,James Bailey,PF,25,TOT,75,1765,385,774,0,1,385,773,226,322,996
1983,James Bailey,PF,25,NJN,6,50,9,18,0,0,9,18,2,2,20
1983,James Bailey,PF,25,HOU,69,1715,376,756,0,1,376,755,224,320,976
1983,Greg Ballard,SF,28,WSB,78,2840,603,1274,13,37,590,1237,182,233,1401
1983,Gene Banks,PF,23,SAS,81,2722,505,919,0,5,505,914,196,278,1206
1983,Billy Ray,SG,26,TOT,19,304,55,145,2,5,53,140,11,22,123
1983,Billy Ray,SG,26,WSB,15,277,53,129,2,5,51,124,10,20,118
1983,Billy Ray,SG,26,LAL,4,27,2,16,0,0,2,16,1,2,5
1983,Dave Batton,C,26,WSB,54,558,85,191,0,3,85,188,8,17,178
1983,Kent Benson,C,28,DET,21,599,85,182,0,1,85,181,38,50,208
1983,Larry Bird*,PF,26,BOS,79,2982,747,1481,22,77,725,1404,351,418,1867
1983,Otis Birdsong,SG,27,NJN,62,1885,426,834,2,6,424,828,82,145,936
1983,Rolando Blackman,SG,23,DAL,75,2349,513,1042,3,15,510,1027,297,381,1326
1983,Charles Bradley,SG,23,BOS,51,532,69,176,0,3,69,173,46,90,184
1983,Dudley Bradley,SG,25,CHI,58,683,82,159,1,5,81,154,36,45,201
1983,Brad Branson,PF,24,IND,62,680,131,308,0,1,131,307,76,108,338
1983,Mike Bratz,PG,27,CHI,15,140,14,42,1,8,13,34,10,13,39
1983,Ron Brewer,SG,27,TOT,74,1964,344,807,7,18,337,789,142,170,837
1983,Ron Brewer,SG,27,CLE,21,563,98,245,0,3,98,242,44,51,240
1983,Ron Brewer,SG,27,GSW,53,1401,246,562,7,15,239,547,98,119,597
1983,Junior Bridgeman,SF,29,MIL,70,1855,421,856,1,13,420,843,164,196,1007
1983,Allan Bristow,SF,31,DAL,37,371,44,99,6,13,38,86,10,14,104
1983,Jim Brogan,SG,24,SDC,58,466,91,213,3,13,88,200,34,43,219
1983,Michael Brooks,SF,24,SDC,82,2457,402,830,5,15,397,815,193,277,1002
1983,Fred Brown,PG,34,SEA,80,1432,371,714,14,32,357,682,58,72,814
1983,Rickey Brown,C,24,TOT,76,1048,167,349,0,3,167,346,65,105,399
1983,Rickey Brown,C,24,GSW,50,743,118,245,0,2,118,243,40,65,276
1983,Rickey Brown,C,24,ATL,26,305,49,104,0,1,49,103,25,40,123
1983,Joe Bryant,SF,28,HOU,81,2055,344,768,8,36,336,732,116,165,812
1983,Quinn Buckner,SG,28,BOS,72,1565,248,561,0,4,248,557,74,117,570
1983,Don Buse,PG,32,POR,41,643,72,182,9,35,63,147,41,46,194
1983,Marty Byrnes,SF,26,IND,80,1436,157,374,6,26,151,348,71,95,391
1983,Kenny Carr,PF,27,POR,82,2331,362,717,2,6,360,711,255,366,981
1983,M.L. Carr,SF,32,BOS,77,883,135,315,3,19,132,296,60,81,333
1983,Joe Barry,C,24,GSW,79,2988,785,1529,0,3,785,1526,337,469,1907
1983,Butch Carter,SG,24,IND,81,1716,354,706,17,51,337,655,124,154,849
1983,Bill Cartwright,C,25,NYK,82,2468,455,804,0,0,455,804,380,511,1290
1983,Harvey Catchings,C,31,MIL,74,1554,90,197,0,0,90,197,62,92,242
1983,Tom Chambers,PF,23,SDC,79,2665,519,1099,0,8,519,1091,353,488,1391
1983,Maurice Cheeks,PG,26,PHI,79,2465,404,745,1,6,403,739,181,240,990
1983,Don Collins,SF,24,WSB,65,1575,332,635,0,6,332,629,101,136,765
1983,Lester Conner,PG,23,GSW,75,1416,145,303,0,4,145,299,79,113,369
1983,Darwin Cook,PG,24,NJN,82,2625,443,986,8,38,435,948,186,242,1080
1983,Jeff Cook,PF,26,TOT,75,1333,148,304,0,3,148,301,79,104,375
1983,Jeff Cook,PF,26,PHO,45,551,61,142,0,2,61,140,41,54,163
1983,Jeff Cook,PF,26,CLE,30,782,87,162,0,1,87,161,38,50,212
1983,Joe Cooper,C,25,TOT,20,333,37,72,0,0,37,72,16,29,90
1983,Joe Cooper,C,25,LAL,2,11,1,4,0,0,1,4,0,0,2
1983,Joe Cooper,C,25,WSB,5,47,5,9,0,0,5,9,5,9,15
1983,Joe Cooper,C,25,SDC,13,275,31,59,0,0,31,59,11,20,73
1983,Michael Cooper,SG,26,LAL,82,2148,266,497,5,21,261,476,102,130,639
1983,Wayne Cooper,C,26,POR,80,2099,320,723,0,5,320,718,135,197,775
1983,Dave Corzine,C,26,CHI,82,2496,457,920,0,2,457,918,232,322,1146
1983,Dave Cowens*,PF,34,MIL,40,1014,136,306,0,2,136,304,52,63,324
1983,Chubby Cox,SG,27,WSB,7,78,13,37,0,2,13,35,3,6,29
1983,Charlie Criss,PG,34,MIL,66,922,169,375,6,31,163,344,68,76,412
1983,Geoff Crompton,C,27,SAS,14,148,14,34,0,0,14,34,3,5,31
1983,Pat Cummings,C,26,DAL,81,2317,433,878,0,1,433,877,148,196,1014
1983,Terry Cummings,PF,21,SDC,70,2531,684,1309,0,1,684,1308,292,412,1660
1983,Earl Cureton,C,25,PHI,73,987,108,258,0,0,108,258,33,67,249
1983,Quintin Dailey,SG,22,CHI,76,2081,470,1008,5,25,465,983,206,282,1151
1983,Adrian Dantley*,SF,26,UTA,22,887,233,402,0,0,233,402,210,248,676
1983,Brad Davis,PG,27,DAL,79,2323,359,628,11,43,348,585,186,220,915
1983,Charles Davis,SF,24,WSB,74,1161,251,534,2,10,249,524,56,89,560
1983,Johnny Davis,SG,27,ATL,53,1465,258,567,5,18,253,549,164,206,685
1983,Mike Davis,PF,26,NYK,8,28,4,10,0,0,4,10,6,10,14
1983,Walter Davis,SG,28,PHO,80,2491,665,1289,7,23,658,1266,184,225,1521
1983,Darryl Dawkins,C,26,NJN,81,2093,401,669,0,0,401,669,166,257,968
1983,Kenny Dennard,PF,24,KCK,22,224,11,34,0,0,11,34,6,9,28
1983,Coby Dietrick,C,34,SAS,8,34,1,5,0,0,1,5,0,2,2
1983,James Donaldson,C,25,SEA,82,1789,289,496,0,0,289,496,150,218,728
1983,John Douglas,SG,26,SDC,3,12,1,6,1,2,0,4,2,2,5
1983,Leon Douglas,C,28,KCK,5,46,2,3,0,0,2,3,0,2,4
1983,John Drew,SF,28,UTA,44,1206,318,671,0,5,318,666,296,392,932
1983,Larry Drew,PG,24,KCK,75,2690,599,1218,2,16,597,1202,310,378,1510
1983,Terry Duerod,SG,26,GSW,5,49,9,19,0,0,9,19,0,0,18
1983,Mike Dunleavy,PG,28,SAS,79,1619,213,510,67,194,146,316,120,154,613
1983,T.R. Dunn,SG,27,DEN,82,2640,254,527,0,1,254,526,119,163,627
1983,John Duren,PG,24,IND,82,1433,163,360,0,13,163,347,43,54,369
1983,Mark Eaton,C,26,UTA,81,1528,146,353,0,1,146,352,59,90,351
1983,Jerry Eaves,PG,23,UTA,82,1588,280,575,1,8,279,567,200,247,761
1983,Keith Edmonson,SG,22,ATL,32,309,48,139,0,2,48,137,16,27,112
1983,Franklin Edwards,PG,23,PHI,81,1266,228,483,0,8,228,475,86,113,542
1983,James Edwards,C,27,TOT,31,667,128,263,0,0,128,263,69,108,325
1983,James Edwards,C,27,CLE,15,382,73,150,0,0,73,150,38,61,184
1983,James Edwards,C,27,PHO,16,285,55,113,0,0,55,113,31,47,141
1983,Len Elmore,C,30,NJN,74,975,97,244,0,1,97,243,54,84,248
1983,Chris Engler,C,23,GSW,54,369,38,94,0,0,38,94,5,16,81
1983,Alex English*,SF,29,DEN,82,2988,959,1857,2,12,957,1845,406,490,2326
1983,Julius Erving*,SF,32,PHI,72,2421,605,1170,2,7,603,1163,330,435,1542
1983,Mike Evans,SG,27,DEN,42,695,115,243,0,9,115,234,33,41,263
1983,Bruce Flowers,PF,25,CLE,53,699,110,206,0,2,110,204,41,53,261
1983,Sleepy Floyd,PG,22,TOT,76,1248,226,527,10,25,216,502,150,180,612
1983,Sleepy Floyd,PG,22,NJN,43,494,92,216,4,14,88,202,38,45,226
1983,Sleepy Floyd,PG,22,GSW,33,754,134,311,6,11,128,300,112,135,386
1983,Phil Ford,PG,26,TOT,77,1610,213,445,1,9,212,436,97,123,524
1983,Phil Ford,PG,26,NJN,7,163,20,35,0,1,20,34,7,10,47
1983,Phil Ford,PG,26,MIL,70,1447,193,410,1,8,192,402,90,113,477
1983,World B.,SG,29,TOT,73,2638,649,1423,15,45,634,1378,430,583,1743
1983,World B.,SG,29,GSW,19,700,164,364,0,3,164,361,106,149,434
1983,World B.,SG,29,CLE,54,1938,485,1059,15,42,470,1017,324,434,1309
1983,Bill Garnett,C,22,DAL,75,1411,170,319,0,3,170,316,129,174,469
1983,Calvin Garrett,SF,26,HOU,4,34,4,11,0,1,4,10,2,2,10
1983,George Gervin*,SG,30,SAS,78,2830,757,1553,12,33,745,1520,517,606,2043
1983,Artis Gilmore*,C,33,SAS,82,2797,556,888,0,6,556,882,367,496,1479
1983,Mike Glenn,SG,27,ATL,73,1124,230,444,0,1,230,443,74,89,534
1983,Mike Gminski,C,23,NJN,80,1255,213,426,0,1,213,425,175,225,601
1983,Glen Gondrezick,PF,27,DEN,76,1130,134,294,0,3,134,291,82,114,350
1983,Rickey Green,PG,28,UTA,78,2783,464,942,2,13,462,929,185,232,1115
1983,Dave Greenwood,PF,25,CHI,79,2355,312,686,0,4,312,682,165,233,789
1983,John Greig,SF,21,SEA,9,26,7,13,0,0,7,13,5,6,19
1983,Kevin Grevey,SF,29,WSB,41,756,114,294,15,38,99,256,54,69,297
1983,Paul Griffin,PF,29,SAS,53,956,60,116,0,0,60,116,53,76,173
1983,Darrell Griffith,SG,24,UTA,77,2787,752,1554,38,132,714,1422,167,246,1709
1983,Bob Gross,SF,29,SDC,27,373,35,82,1,3,34,79,12,19,83
1983,Ernie Grunfeld,SF,27,NYK,77,1422,167,377,0,4,167,373,81,98,415
1983,Bill Hanzlik,SF,25,DEN,82,1547,187,437,1,7,186,430,125,160,500
1983,Joe Hassett,SG,27,GSW,6,139,19,44,1,9,18,35,0,0,39
1983,Scott Hastings,C-PF,22,TOT,31,140,13,38,0,3,13,35,11,20,37
1983,Scott Hastings,C,22,NYK,21,98,8,22,0,1,8,21,7,14,23
1983,Scott Hastings,PF,22,ATL,10,42,5,16,0,2,5,14,4,6,14
1983,Steve Hawes,PF,32,TOT,77,1416,163,390,5,21,158,369,69,94,400
1983,Steve Hawes,PF,32,ATL,46,860,91,244,2,14,89,230,46,62,230
1983,Steve Hawes,PF,32,SEA,31,556,72,146,3,7,69,139,23,32,170
1983,Elvin Hayes*,PF,37,HOU,81,2302,424,890,2,4,422,886,196,287,1046
1983,Steve Hayes,C,27,CLE,65,1058,104,217,0,1,104,216,29,51,237
1983,Spencer Haywood*,PF,33,WSB,38,775,125,312,0,1,125,311,63,87,313
1983,Gerald Henderson,PG,27,BOS,82,1551,286,618,3,16,283,602,96,133,671
1983,Tom Henderson,SG,31,HOU,51,789,107,263,0,2,107,261,45,57,259
1983,Rod Higgins,SF,23,CHI,82,2196,313,698,13,41,300,657,209,264,848
1983,Johnny High,SG,25,PHO,82,1155,100,217,1,5,99,212,63,136,264
1983,Armond Hill,PG,29,MIL,14,169,14,26,0,0,14,26,18,22,46
1983,Craig Hodges,SG,22,SDC,76,2022,318,704,20,90,298,614,94,130,750
1983,Lionel Hollins,PG,29,SDC,56,1844,313,717,3,21,310,696,129,179,758
1983,Phil Hubbard,SF,26,CLE,82,1953,288,597,0,2,288,595,204,296,780
1983,Geoff Huston,PG,25,CLE,80,2716,401,832,4,12,397,820,168,245,974
1983,Marc Iavaroni,PF,26,PHI,80,1612,163,353,0,2,163,351,78,113,404
1983,Dan Issel*,C,34,DEN,80,2431,661,1296,4,19,657,1277,400,479,1726
1983,Tracy Jackson,SG,23,CHI,78,1309,199,426,2,13,197,413,92,126,492
1983,Clay Johnson,SG,26,LAL,48,447,53,135,0,2,53,133,38,48,144
1983,Clemon Johnson,C,26,TOT,83,1914,299,581,0,1,299,580,111,180,709
1983,Clemon Johnson,C,26,IND,51,1216,208,399,0,1,208,398,77,122,493
1983,Clemon Johnson,C,26,PHI,32,698,91,182,0,0,91,182,34,58,216
1983,Dennis Johnson*,PG,28,PHO,77,2551,398,861,5,31,393,830,292,369,1093
1983,Eddie Johnson,SG,27,ATL,61,1813,389,858,14,41,375,817,186,237,978
1983,Eddie Johnson,SF,23,KCK,82,2933,677,1370,20,71,657,1299,247,317,1621
1983,Frank Johnson,PG,24,WSB,68,2324,321,786,14,61,307,725,196,261,852
1983,George Johnson,C,34,ATL,37,461,25,57,0,0,25,57,14,19,64
1983,George Johnson,SF,26,IND,82,2297,409,858,7,38,402,820,126,172,951
1983,Magic Johnson*,SG,23,LAL,79,2907,511,933,0,21,511,912,304,380,1326
1983,Marques Johnson,SF,26,MIL,80,2853,723,1420,4,20,719,1400,264,359,1714
1983,Mickey Johnson,PF,30,TOT,78,2053,391,921,3,36,388,885,312,380,1097
1983,Mickey Johnson,PF,30,MIL,6,153,30,66,0,2,30,64,7,9,67
1983,Mickey Johnson,PF,30,NJN,42,1001,199,496,2,17,197,479,164,201,564
1983,Mickey Johnson,PF,30,GSW,30,899,162,359,1,17,161,342,141,170,466
1983,Reggie Johnson,SF,25,TOT,79,1541,247,509,1,4,246,505,95,130,590
1983,Reggie Johnson,SF,25,KCK,50,992,178,355,1,4,177,351,73,100,430
1983,Reggie Johnson,SF,25,PHI,29,549,69,154,0,0,69,154,22,30,160
1983,Steve Johnson,C,25,KCK,79,1544,371,595,0,0,371,595,186,324,928
1983,Vinnie Johnson,SG,26,DET,82,2511,520,1013,11,40,509,973,245,315,1296
1983,Jim Johnstone,PF-C,22,TOT,23,191,11,30,0,0,11,30,9,20,31
1983,Jim Johnstone,C,22,SAS,7,54,2,10,0,0,2,10,3,5,7
1983,Jim Johnstone,PF,22,DET,16,137,9,20,0,0,9,20,6,15,24
1983,Bobby Jones,PF,31,PHI,74,1749,250,460,0,1,250,459,165,208,665
1983,Caldwell Jones,C,32,HOU,82,2440,307,677,0,2,307,675,162,206,776
1983,Dwight Jones,PF,30,TOT,81,1164,148,325,0,1,148,324,79,123,375
1983,Dwight Jones,PF,30,CHI,49,673,86,193,0,0,86,193,47,75,219
1983,Dwight Jones,PF,30,LAL,32,491,62,132,0,1,62,131,32,48,156
1983,Edgar Jones,PF,26,TOT,77,1658,237,479,2,9,235,470,201,286,677
1983,Edgar Jones,PF,26,DET,49,1036,145,294,2,6,143,288,117,172,409
1983,Edgar Jones,PF,26,SAS,28,622,92,185,0,3,92,182,84,114,268
1983,Hutch Jones,SF,23,SDC,9,85,17,37,0,0,17,37,6,6,40
1983,Major Jones,PF,29,HOU,60,878,142,311,0,2,142,309,56,102,340
1983,Eddie Jordan,PG,28,LAL,35,333,40,132,3,16,37,116,11,17,94
1983,Jeff Judkins,SF,26,POR,34,309,39,88,2,8,37,80,25,30,105
1983,Rich Kelley,C,29,TOT,70,1345,130,293,0,0,130,293,142,175,402
1983,Rich Kelley,C,29,DEN,38,565,59,141,0,0,59,141,55,70,173
1983,Rich Kelley,C,29,UTA,32,780,71,152,0,0,71,152,87,105,229
1983,Clark Kellogg,PF,21,IND,81,2761,680,1420,4,18,676,1402,261,352,1625
1983,Greg Kelser,SF,25,SEA,80,1507,247,450,0,3,247,447,173,257,667
1983,Larry Kenon,PF,30,TOT,48,770,119,257,0,1,119,256,42,57,280
1983,Larry Kenon,PF,30,CHI,5,25,2,6,0,0,2,6,0,0,4
1983,Larry Kenon,PF,30,GSW,11,121,17,39,0,0,17,39,7,11,41
1983,Larry Kenon,PF,30,CLE,32,624,100,212,0,1,100,211,35,46,235
1983,Albert King,SF,23,NJN,79,2447,582,1226,6,23,576,1203,176,227,1346
1983,Bernard King*,SF,26,NYK,68,2207,603,1142,0,6,603,1136,280,388,1486
1983,Reggie King,SF,25,KCK,58,995,104,225,0,0,104,225,73,96,281
1983,Billy Knight,SG,30,IND,80,2262,512,984,3,19,509,965,343,408,1370
1983,Joe Kopicki,PF,22,WSB,17,201,23,51,0,1,23,50,21,25,67
1983,Joel Kramer,C,27,PHO,54,458,44,104,0,1,44,103,14,16,102
1983,Sam Lacey,C,34,CLE,60,1232,111,264,2,9,109,255,29,37,253
1983,Bill Laimbeer,C,25,DET,82,2871,436,877,2,13,434,864,245,310,1119
1983,Jeff Lamp,SF,23,POR,59,690,107,252,1,6,106,246,42,52,257
1983,Mark Landsberger,PF,27,LAL,39,356,43,102,0,0,43,102,12,25,98
1983,Bob Lanier*,C,34,MIL,39,978,163,332,0,1,163,331,91,133,417
1983,Allen Leavell,PG,25,HOU,79,2602,439,1059,42,175,397,884,247,297,1167
1983,Ronnie Lester,PG,24,CHI,65,1437,202,446,0,5,202,441,124,171,528
1983,Fat Lever,PG,22,POR,81,2020,256,594,5,15,251,579,116,159,633
1983,Cliff Levingston,PF,22,DET,62,879,131,270,0,1,131,269,84,147,346
1983,Steve Lingenfelter,PF,24,WSB,7,53,4,6,0,0,4,6,0,4,8
1983,Alton Lister,PF,24,MIL,80,1885,272,514,0,0,272,514,130,242,674
1983,Lewis Lloyd,SG,23,GSW,73,1350,293,566,1,4,292,562,100,139,687
1983,Scott Lloyd,C,30,DAL,15,206,19,50,0,1,19,49,11,17,49
1983,Kevin Loder,SF,23,KCK,66,818,138,300,5,9,133,291,53,80,334
1983,John Long,SG,26,DET,70,1485,312,692,2,7,310,685,111,146,737
1983,John Lucas,PG,29,WSB,35,386,62,131,0,5,62,126,21,42,145
1983,Maurice Lucas,PF,30,PHO,77,2586,495,1045,1,3,494,1042,278,356,1269
1983,Rudy Macklin,SF,24,ATL,73,1171,170,360,0,4,170,356,101,131,441
1983,Kyle Macy,PG,25,PHO,82,1836,328,634,23,76,305,558,129,148,808
1983,Dave Magley,SF,23,CLE,14,56,4,16,0,1,4,15,4,8,12
1983,Rick Mahorn,PF,24,WSB,82,3023,376,768,0,3,376,765,146,254,898
1983,Moses Malone*,C,27,PHI,78,2922,654,1305,0,1,654,1304,600,788,1908
1983,Wes Matthews,PG,23,ATL,64,1187,171,424,14,48,157,376,86,112,442
1983,Cedric Maxwell,SF,27,BOS,79,2252,331,663,0,1,331,662,280,345,942
1983,Scott May,SF,28,DET,9,155,21,50,0,0,21,50,17,21,59
1983,Bob McAdoo*,C,31,LAL,47,1019,292,562,0,1,292,561,119,163,703
1983,Hank McDowell,PF,23,TOT,56,505,58,126,0,2,58,124,47,61,163
1983,Hank McDowell,PF,23,GSW,14,130,13,29,0,0,13,29,14,18,40
1983,Hank McDowell,PF,23,POR,42,375,45,97,0,2,45,95,33,43,123
1983,Mike McGee,SF,23,LAL,39,381,69,163,1,7,68,156,17,23,156
1983,Kevin McHale*,PF,25,BOS,82,2345,483,893,0,1,483,892,193,269,1159
1983,Billy McKinney,PG,27,DEN,68,1559,266,546,0,7,266,539,136,167,668
1983,Tom McMillen,C,30,ATL,61,1364,198,424,0,1,198,423,108,133,504
1983,Mark McNamara,C,23,PHI,36,182,29,64,0,0,29,64,20,45,78
1983,Joe Meriweather,C,29,KCK,78,1706,258,453,0,0,258,453,102,163,618
1983,Mike Mitchell,SF,27,SAS,80,2803,686,1342,0,3,686,1339,219,289,1591
1983,Steve Mix,SF,35,TOT,58,809,137,283,1,4,136,279,75,88,350
1983,Steve Mix,SF,35,MIL,57,792,133,273,1,4,132,269,74,87,341
1983,Steve Mix,SF,35,LAL,1,17,4,10,0,0,4,10,1,1,9
1983,Paul Mokeski,C,26,TOT,73,1128,119,260,0,1,119,259,50,68,288
1983,Paul Mokeski,C,26,CLE,23,539,55,121,0,0,55,121,16,26,126
1983,Paul Mokeski,C,26,MIL,50,589,64,139,0,1,64,138,34,42,162
1983,Sidney Moncrief,SG,25,MIL,76,2710,606,1156,1,10,605,1146,499,604,1712
1983,Johnny Moore,PG,24,SAS,77,2552,394,841,5,22,389,819,148,199,941
1983,Lowes Moore,PG,25,SDC,37,642,81,190,6,23,75,167,42,56,210
1983,Guy Morgan,SG,22,IND,8,46,7,24,0,0,7,24,1,4,15
1983,Calvin Murphy*,PG,34,HOU,64,1423,337,754,4,14,333,740,138,150,816
1983,Larry Nance,PF,23,PHO,82,2914,588,1069,1,3,587,1066,193,287,1370
1983,Swen Nater,C,33,SDC,7,51,6,20,0,0,6,20,4,4,16
1983,Calvin Natt,SF,26,POR,80,2879,644,1187,3,20,641,1167,339,428,1630
1983,Kenny Natt,SG,24,UTA,22,210,38,73,0,2,38,71,9,14,85
1983,Ed Nealy,PF,22,KCK,82,1643,147,247,0,0,147,247,70,114,364
1983,Chuck Nevitt,C,23,HOU,6,64,11,15,0,0,11,15,1,4,23
1983,Carl Nicks,SG,24,CLE,9,148,26,59,0,1,26,58,11,17,63
1983,Kurt Nimphius,C,24,DAL,81,1515,174,355,1,1,173,354,77,140,426
1983,Norm Nixon,PG,27,LAL,79,2711,533,1123,0,13,533,1110,125,168,1191
1983,Audie Norris,C,22,POR,30,311,26,63,0,0,26,63,14,30,66
1983,Mike O'Koren,SF,24,NJN,46,803,136,259,2,9,134,250,34,48,308
1983,Mark Olberding,PF,26,CHI,80,1817,251,522,2,12,249,510,194,248,698
1983,Jawann Oldham,C,25,CHI,16,171,31,58,0,0,31,58,12,22,74
1983,Louis Orr,SF,24,NYK,82,1666,274,593,0,2,274,591,140,175,688
1983,Tom Owens,C,33,DET,49,725,81,192,0,0,81,192,45,66,207
1983,Robert Parish*,C,29,BOS,78,2459,619,1125,0,1,619,1124,271,388,1509
1983,Billy Paultz,C,34,TOT,64,820,101,227,0,0,101,227,27,59,229
1983,Billy Paultz,C,34,HOU,57,695,89,200,0,0,89,200,26,57,204
1983,Billy Paultz,C,34,SAS,7,125,12,27,0,0,12,27,1,2,25
1983,Jim Paxson,SG,25,POR,81,2740,682,1323,4,25,678,1298,388,478,1756
1983,Sam Pellom,PF,31,TOT,6,29,6,16,0,0,6,16,0,0,12
1983,Sam Pellom,PF,31,ATL,2,9,2,6,0,0,2,6,0,0,4
1983,Sam Pellom,PF,31,MIL,4,20,4,10,0,0,4,10,0,0,8
1983,Roger Phegley,SG,26,SAS,62,599,120,267,3,14,117,253,43,56,286
1983,Eddie Phillips,SF,21,NJN,48,416,56,138,0,2,56,136,40,59,152
1983,Ricky Pierce,SG,23,DET,39,265,33,88,1,7,32,81,18,32,85
1983,Charles Pittman,PF,24,PHO,28,170,19,40,0,1,19,39,25,37,63
1983,Ben Poquette,PF,27,UTA,75,2331,329,697,1,5,328,692,166,221,825
1983,Kevin Porter,PG,32,WSB,11,210,21,40,0,0,21,40,5,6,47
1983,Paul Pressey,SG,24,MIL,79,1528,213,466,1,9,212,457,105,176,532
1983,Mark Radford,SG,23,SEA,54,439,84,172,4,18,80,154,30,73,202
1983,Ed Rains,SF,26,SAS,34,292,33,83,0,1,33,82,29,43,95
1983,Kurt Rambis,PF,24,LAL,78,1806,235,413,0,2,235,411,114,166,584
1983,Kelvin Ransey,PG,24,DAL,76,1607,343,746,2,16,341,730,152,199,840
1983,James Ray,PF,25,DEN,45,433,70,153,0,1,70,152,33,51,173
1983,Clint Richardson,SG,26,PHI,77,1755,259,559,0,6,259,553,71,111,589
1983,Micheal Ray,PG,27,TOT,64,2076,346,815,8,51,338,764,106,163,806
1983,Micheal Ray,PG,27,GSW,33,1074,176,427,4,31,172,396,55,87,411
1983,Micheal Ray,PG,27,NJN,31,1002,170,388,4,20,166,368,51,76,395
1983,Rick Robey,C,27,BOS,59,855,100,214,0,0,100,214,45,78,245
1983,Cliff Robinson,PF,22,CLE,77,2601,587,1230,0,5,587,1225,213,301,1387
1983,Oliver Robinson,SG,22,SAS,35,147,35,97,1,11,34,86,30,45,101
1983,Truck Robinson,PF,31,NYK,81,2426,326,706,0,0,326,706,118,201,770
1983,Dave Robisch,C,33,DEN,61,711,96,251,0,1,96,250,92,118,284
1983,Tree Rollins,C,27,ATL,80,2472,261,512,0,1,261,511,98,135,620
1983,Lorenzo Romar,PG,24,GSW,82,2130,266,572,10,33,256,539,78,105,620
1983,Dan Roundfield,PF,29,ATL,77,2811,561,1193,5,27,556,1166,337,450,1464
1983,Jeff Ruland,C,24,WSB,79,2862,580,1051,1,3,579,1048,375,544,1536
1983,Walker Russell,PG,22,DET,68,757,67,184,2,18,65,166,47,58,183
1983,Mike Sanders,SF,22,SAS,26,393,76,157,0,2,76,155,31,43,183
1983,Danny Schayes,C,23,TOT,82,2284,342,749,0,1,342,748,228,295,912
1983,Danny Schayes,C,23,UTA,50,1638,231,514,0,1,231,513,157,195,619
1983,Danny Schayes,C,23,DEN,32,646,111,235,0,0,111,235,71,100,293
1983,Russ Schoene,PF,22,TOT,77,1222,207,435,1,4,206,431,61,83,476
1983,Russ Schoene,PF,22,PHI,46,702,106,207,0,1,106,206,21,28,233
1983,Russ Schoene,PF,22,IND,31,520,101,228,1,3,100,225,40,55,243
1983,Alvin Scott,SF,27,PHO,81,1139,124,259,0,2,124,257,81,110,329
1983,Lonnie Shelton,PF,27,SEA,82,2572,437,915,1,6,436,909,141,187,1016
1983,Ed Sherod,PG,23,NYK,64,1624,171,421,1,13,170,408,52,80,395
1983,Purvis Short,SF,25,GSW,67,2397,589,1209,4,15,585,1194,255,308,1437
1983,Jerry Sichting,PG,26,IND,78,2435,316,661,3,18,313,643,92,107,727
1983,Jack Sikma,C,27,SEA,75,2564,484,1043,0,8,484,1035,400,478,1368
1983,Jose Slaughter,SG,22,IND,63,515,89,238,9,41,80,197,38,59,225
1983,Derek Smith,SF,21,GSW,27,154,21,51,0,2,21,49,17,25,59
1983,Jim Smith,PF,24,DET,4,18,3,4,0,0,3,4,2,4,8
1983,Larry Smith,PF,25,GSW,49,1433,180,306,0,0,180,306,53,99,413
1983,Phil Smith,SG,30,SEA,79,1238,175,400,3,8,172,392,101,133,454
1983,Randy Smith,SG,34,TOT,80,1406,273,565,3,18,270,547,114,131,663
1983,Randy Smith,SG,34,SDC,65,1264,244,499,3,16,241,483,101,117,592
1983,Randy Smith,SG,34,ATL,15,142,29,66,0,2,29,64,13,14,71
1983,Robert Smith,PG,27,TOT,12,68,7,24,0,2,7,22,9,10,23
1983,Robert Smith,PG,27,SDC,5,43,2,13,0,1,2,12,7,8,11
1983,Robert Smith,PG,27,SAS,7,25,5,11,0,1,5,10,2,2,12
1983,Ricky Sobers,SG,30,WSB,41,1438,234,534,23,55,211,479,154,185,645
1983,Jim Spanarkel,SG,25,DAL,48,722,91,197,2,10,89,187,88,113,272
1983,Rory Sparrow,PG,24,TOT,81,2428,392,810,5,22,387,788,147,199,936
1983,Rory Sparrow,PG,24,ATL,49,1548,264,512,3,15,261,497,84,113,615
1983,Rory Sparrow,PG,24,NYK,32,880,128,298,2,7,126,291,63,86,321
1983,Larry Spriggs,SF,23,CHI,9,39,8,20,0,0,8,20,5,7,21
1983,Brook Steppe,SG,23,KCK,62,606,84,176,1,7,83,169,76,100,245
1983,Jeff Taylor,SG,23,HOU,44,774,64,160,0,1,64,159,30,46,158
1983,Vince Taylor,SG,22,NYK,31,321,37,102,0,0,37,102,21,32,95
1983,Terry Teagle,SG,22,HOU,73,1708,332,776,10,29,322,747,87,125,761
1983,Carlos Terry,SG,26,WSB,55,514,39,106,0,2,39,104,10,15,88
1983,Reggie Theus,PG,25,CHI,82,2856,749,1567,21,91,728,1476,434,542,1953
1983,David Thirdkill,SF,22,PHO,49,521,74,170,1,7,73,163,45,78,194
1983,Isiah Thomas*,PG,21,DET,81,3093,725,1537,36,125,689,1412,368,518,1854
1983,Corny Thompson,PF,22,DAL,44,520,43,137,0,0,43,137,36,46,122
1983,David Thompson*,SG,28,SEA,75,2155,445,925,2,10,443,915,298,380,1190
1983,LaSalle Thompson,C,21,KCK,71,987,147,287,0,1,147,286,89,137,383
1983,Mychal Thompson,C,28,POR,80,3017,505,1033,0,1,505,1032,249,401,1259
1983,Darren Tillis,C,22,TOT,52,526,76,181,0,1,76,180,16,28,168
1983,Darren Tillis,C,22,BOS,15,44,7,23,0,1,7,22,2,6,16
1983,Darren Tillis,C,22,CLE,37,482,69,158,0,0,69,158,14,22,152
1983,Ray Tolbert,PF,24,TOT,73,1107,157,314,0,3,157,311,52,103,366
1983,Ray Tolbert,PF,24,SEA,45,712,100,190,0,2,100,188,24,44,224
1983,Ray Tolbert,PF,24,DET,28,395,57,124,0,1,57,123,28,59,142
1983,Andrew Toney,SG,25,PHI,81,2474,626,1250,22,76,604,1174,324,411,1598
1983,Linton Townes,SF,23,POR,55,516,105,234,9,25,96,209,28,38,247
1983,Kelly Tripucka,SF,23,DET,58,2252,565,1156,14,37,551,1119,392,464,1536
1983,Trent Tucker,SG,23,NYK,78,1830,299,647,14,30,285,617,43,64,655
1983,Elston Turner,SF,23,DAL,59,879,96,238,2,3,94,235,20,30,214
1983,Terry Tyler,SF,26,DET,82,2543,421,880,2,15,419,865,146,196,990
1983,Darnell Valentine,PG,23,POR,47,1298,209,460,0,1,209,459,169,213,587
1983,Jan Van,SF,31,NJN,13,63,5,14,0,0,5,14,5,6,15
1983,Kiki Vandeweghe,PF,24,DEN,82,2909,841,1537,15,51,826,1486,489,559,2186
1983,Pete Verhoeven,PF,23,POR,48,527,87,171,0,1,87,170,21,31,195
1983,Jay Vincent,PF,23,DAL,81,2726,622,1272,0,3,622,1269,269,343,1513
1983,Danny Vranes,SF,24,SEA,82,2054,226,429,0,1,226,428,115,209,567
1983,Foots Walker,PG,31,NJN,79,1388,114,250,2,12,112,238,116,149,346
1983,Wally Walker,SF,28,HOU,82,2251,362,806,1,4,361,802,72,116,797
1983,Bill Walton*,C,30,SDC,33,1099,200,379,0,0,200,379,65,117,465
1983,Bryan Warrick,PG,23,WSB,43,727,65,171,0,5,65,166,42,57,172
1983,Marvin Webster,C,30,NYK,82,1472,168,331,0,1,168,330,106,180,442
1983,Scott Wedman,SF,30,TOT,75,1793,374,788,10,32,364,756,85,107,843
1983,Scott Wedman,SF,30,CLE,35,1290,280,583,9,22,271,561,65,77,634
1983,Scott Wedman,SF,30,BOS,40,503,94,205,1,10,93,195,20,30,209
1983,Paul Westphal,SG,32,NYK,80,1978,318,693,14,48,304,645,148,184,798
1983,Rory White,SF,23,PHO,65,626,127,234,0,1,127,233,70,109,324
1983,Jerome Whitehead,C,26,SDC,46,905,164,306,0,0,164,306,72,87,400
1983,Bob Wilkerson,SF,28,CLE,77,1702,213,511,0,4,213,507,93,124,519
1983,Jamaal Wilkes*,SF,29,LAL,80,2552,684,1290,0,6,684,1284,203,268,1571
1983,James Wilkes,SF,24,DET,9,129,11,34,0,1,11,33,12,15,34
1983,Dominique Wilkins*,SF,23,ATL,82,2697,601,1220,2,11,599,1209,230,337,1434
1983,Jeff Wilkins,C,27,UTA,81,2307,389,816,0,3,389,813,156,200,934
1983,Buck Williams,PF,22,NJN,82,2961,536,912,0,4,536,908,324,523,1396
1983,Freeman Williams,SG,26,UTA,18,210,36,101,2,7,34,94,18,25,92
1983,Gus Williams,PG,29,SEA,80,2761,660,1384,2,43,658,1341,278,370,1600
1983,Herb Williams,C,24,IND,78,2513,580,1163,0,7,580,1156,155,220,1315
1983,Ray Williams,PG,28,KCK,72,2170,419,1068,15,74,404,994,256,333,1109
1983,Rickey Williams,SG,25,UTA,44,346,56,135,0,3,56,132,35,53,147
1983,Rob Williams,PG,21,DEN,74,1443,191,468,2,15,189,453,131,174,515
1983,Sam Williams,PF,23,GSW,75,1533,252,479,0,1,252,478,123,171,627
1983,Sly Williams,PF,25,NYK,68,1385,314,647,2,19,312,628,176,259,806
1983,Bill Willoughby,SF,25,TOT,62,1146,147,324,6,14,141,310,43,55,343
1983,Bill Willoughby,SF,25,SAS,52,1062,136,295,6,13,130,282,41,53,319
1983,Bill Willoughby,SF,25,NJN,10,84,11,29,0,1,11,28,2,2,24
1983,Brian Winters,SG,30,MIL,57,1361,255,587,22,68,233,519,73,85,605
1983,Al Wood,SF,24,SDC,76,1822,343,740,15,50,328,690,124,161,825
1983,Mike Woodson,SG,24,KCK,81,2426,584,1154,7,33,577,1121,298,377,1473
1983,Orlando Woolridge,SF,23,CHI,57,1627,361,622,0,3,361,619,217,340,939
1983,James Worthy*,SF,21,LAL,77,1970,447,772,1,4,446,768,138,221,1033
1983,Jim Zoet,C,29,DET,7,30,1,5,0,0,1,5,0,0,2
,,,,,,,,,,,,,,,
1984,Kareem Abdul-Jabbar*,C,36,LAL,80,2622,716,1238,0,1,716,1237,285,394,1717
1984,Alvan Adams,C,29,PHO,70,1452,269,582,0,4,269,578,132,160,670
1984,Mark Aguirre,SF,24,DAL,79,2900,925,1765,15,56,910,1709,465,621,2330
1984,Danny Ainge,SG,24,BOS,71,1154,166,361,6,22,160,339,46,56,384
1984,J.J. Anderson,SF,23,UTA,48,311,55,130,0,3,55,127,12,29,122
1984,Richard Anderson,PF,23,DEN,78,1380,272,638,3,19,269,619,116,150,663
1984,Tiny Archibald*,PG,35,MIL,46,1038,136,279,4,18,132,261,64,101,340
1984,Ken Austin,SF,22,DET,7,28,6,13,0,0,6,13,0,0,12
1984,John Bagley,PG,23,CLE,76,1712,257,607,2,17,255,590,157,198,673
1984,James Bailey,PF,26,HOU,73,1174,254,517,0,1,254,516,138,192,646
1984,Thurl Bailey,PF,22,UTA,81,2009,302,590,0,0,302,590,88,117,692
1984,Greg Ballard,SF,29,WSB,82,2701,510,1061,2,15,508,1046,166,208,1188
1984,Gene Banks,PF,24,SAS,80,2600,424,747,1,6,423,741,200,270,1049
1984,Dave Batton,C,27,SAS,4,31,5,10,0,0,5,10,0,0,10
1984,Kent Benson,C,29,DET,82,1734,248,451,0,1,248,450,83,101,579
1984,Larry Bird*,PF,27,BOS,79,3028,758,1542,18,73,740,1469,374,421,1908
1984,Otis Birdsong,SG,28,NJN,69,2168,583,1147,5,20,578,1127,194,319,1365
1984,Rolando Blackman,SG,24,DAL,81,3025,721,1320,1,11,720,1309,372,458,1815
1984,Tom Boswell,PF,30,UTA,38,261,28,52,1,1,27,51,16,21,73
1984,Charles Bradley,SG,24,SEA,8,39,3,7,0,0,3,7,5,7,11
1984,Mike Bratz,PG,28,GSW,82,1428,213,521,15,51,198,470,120,137,561
1984,Randy Breuer,C,23,MIL,57,472,68,177,0,0,68,177,32,46,168
1984,Ron Brewer,SG,28,TOT,53,992,179,403,3,14,176,389,52,67,413
1984,Ron Brewer,SG,28,GSW,13,210,27,58,0,1,27,57,11,17,65
1984,Ron Brewer,SG,28,SAS,40,782,152,345,3,13,149,332,41,50,348
1984,Junior Bridgeman,SF,30,MIL,81,2431,509,1094,6,31,503,1063,196,243,1220
1984,Michael Brooks,SF,25,SDC,47,1405,213,445,0,5,213,440,104,151,530
1984,Fred Brown,SG,35,SEA,71,1129,258,506,9,34,249,472,77,86,602
1984,Rickey Brown,C,25,ATL,68,785,94,201,0,0,94,201,48,65,236
1984,Wallace Bryant,C,24,CHI,29,317,52,133,0,0,52,133,14,33,118
1984,Quinn Buckner,PG,29,BOS,79,1249,138,323,0,6,138,317,48,74,324
1984,Don Buse,PG,33,KCK,76,1327,150,352,18,59,132,293,63,80,381
1984,Kenny Carr,PF,28,POR,82,2455,518,923,0,5,518,918,247,367,1283
1984,M.L. Carr,SF,33,BOS,60,585,70,171,3,15,67,156,42,48,185
1984,Joe Barry,C,25,GSW,80,2962,663,1390,0,1,663,1389,313,433,1639
1984,Butch Carter,SG,25,IND,73,2045,413,862,15,46,398,816,136,178,977
1984,Howard Carter,SG,22,DEN,55,688,145,316,5,19,140,297,47,61,342
1984,Bill Cartwright,C,26,NYK,77,2487,453,808,0,1,453,807,404,502,1310
1984,Harvey Catchings,PF,32,MIL,69,1156,61,153,0,1,61,152,22,42,144
1984,Tom Chambers,PF,24,SEA,82,2570,554,1110,0,12,554,1098,375,469,1483
1984,Maurice Cheeks,PG,27,PHI,75,2494,386,702,8,20,378,682,170,232,950
1984,Carlos Clark,SG,23,BOS,31,127,19,52,0,2,19,50,16,18,54
1984,Don Collins,SG,25,GSW,61,957,187,387,1,5,186,382,65,89,440
1984,Leroy Combs,SF,23,IND,48,446,81,163,0,3,81,160,56,91,218
1984,Lester Conner,SG,24,GSW,82,2573,360,730,1,6,359,724,186,259,907
1984,Darwin Cook,PG,25,NJN,82,1870,304,687,11,46,293,641,95,126,714
1984,Jeff Cook,C,27,CLE,81,1950,188,387,1,2,187,385,94,130,471
1984,Michael Cooper,SG,27,LAL,82,2387,273,549,38,121,235,428,155,185,739
1984,Wayne Cooper,C,27,POR,81,1662,304,663,0,7,304,656,185,230,793
1984,Dave Corzine,C,27,CHI,82,2674,385,824,3,9,382,815,231,275,1004
1984,Charlie Criss,PG,35,TOT,15,215,20,52,1,6,19,46,12,16,53
1984,Charlie Criss,PG,35,MIL,6,107,11,30,1,6,10,24,7,11,30
1984,Charlie Criss,PG,35,ATL,9,108,9,22,0,0,9,22,5,5,23
1984,Geoff Crompton,C,28,CLE,7,23,1,8,0,0,1,8,3,6,5
1984,Russell Cross,C,22,GSW,45,354,64,112,0,0,64,112,38,91,166
1984,Pat Cummings,PF,27,DAL,80,2492,452,915,0,2,452,913,141,190,1045
1984,Terry Cummings,PF,22,SDC,81,2907,737,1491,0,3,737,1488,380,528,1854
1984,Earl Cureton,C,26,DET,73,907,81,177,0,1,81,176,31,59,193
1984,Quintin Dailey,SG,23,CHI,82,2449,583,1229,4,32,579,1197,321,396,1491
1984,Adrian Dantley*,SF,27,UTA,79,2984,802,1438,1,4,801,1434,813,946,2418
1984,Brad Davis,PG,28,DAL,81,2665,345,651,7,38,338,613,199,238,896
1984,Charles Davis,SF,25,WSB,46,467,103,218,1,9,102,209,24,39,231
1984,Johnny Davis,PG,28,ATL,75,2079,354,800,0,8,354,792,217,256,925
1984,Walter Davis,SG,29,PHO,78,2546,652,1274,20,87,632,1187,233,270,1557
1984,Darryl Dawkins,C,27,NJN,81,2417,507,855,2,5,505,850,341,464,1357
1984,Darren Daye,SF,23,WSB,75,1174,180,408,0,6,180,402,95,133,455
1984,Kenny Dennard,PF,25,DEN,43,413,36,99,3,10,33,89,15,24,90
1984,James Donaldson,C,26,SDC,82,2525,360,604,0,0,360,604,249,327,969
1984,John Drew,SF,29,UTA,81,1797,511,1067,6,22,505,1045,402,517,1430
1984,Larry Drew,PG,25,KCK,73,2363,474,1026,3,10,471,1016,243,313,1194
1984,Clyde Drexler*,SG,21,POR,82,1408,252,559,1,4,251,555,123,169,628
1984,Mike Dunleavy,PG,29,MIL,17,404,70,127,19,45,51,82,32,40,191
1984,T.R. Dunn,SG,28,DEN,80,2705,174,370,0,1,174,369,106,145,454
1984,Mark Eaton,C,27,UTA,82,2139,194,416,0,1,194,415,73,123,461
1984,Jerry Eaves,PG,24,UTA,80,1034,132,293,0,6,132,287,92,132,356
1984,Keith Edmonson,SG,23,TOT,55,622,158,321,0,0,158,321,94,126,410
1984,Keith Edmonson,SG,23,SAS,40,521,135,274,0,0,135,274,76,101,346
1984,Keith Edmonson,SG,23,DEN,15,101,23,47,0,0,23,47,18,25,64
1984,Franklin Edwards,PG,24,PHI,60,654,84,221,0,1,84,220,34,48,202
1984,James Edwards,C,28,PHO,72,1897,438,817,0,1,438,816,183,254,1059
1984,Craig Ehlo,SG,22,HOU,7,63,11,27,0,0,11,27,1,1,23
1984,Dale Ellis,SF,23,DAL,67,1059,225,493,12,29,213,464,87,121,549
1984,Len Elmore,PF,31,NYK,65,832,64,157,0,0,64,157,27,38,155
1984,Chris Engler,C,24,GSW,46,360,33,83,0,0,33,83,14,23,80
1984,Alex English*,SF,30,DEN,82,2870,907,1714,1,7,906,1707,352,427,2167
1984,Julius Erving*,SF,33,PHI,77,2683,678,1324,7,21,671,1303,364,483,1727
1984,Mike Evans,PG,28,DEN,78,1687,243,564,32,89,211,475,111,131,629
1984,Eric Fernsten,PF,30,NYK,32,402,29,52,0,0,29,52,25,34,83
1984,Sleepy Floyd,PG,23,GSW,77,2555,484,1045,8,45,476,1000,315,386,1291
1984,Phil Ford,PG,27,HOU,81,2020,236,470,2,15,234,455,98,117,572
1984,Rod Foster,PG,23,PHO,80,1424,260,580,22,84,238,496,122,155,664
1984,World B.,SG,30,CLE,75,2375,626,1407,22,69,604,1338,395,504,1669
1984,Bill Garnett,PF,23,DAL,80,1529,141,299,0,2,141,297,129,176,411
1984,Calvin Garrett,SF,27,LAL,41,478,78,152,2,6,76,146,30,39,188
1984,John Garris,PF,24,CLE,33,267,52,102,0,0,52,102,27,34,131
1984,George Gervin*,SG,31,SAS,76,2584,765,1561,10,24,755,1537,427,507,1967
1984,Mike Gibson,PF,23,WSB,32,229,21,55,0,0,21,55,11,17,53
1984,Artis Gilmore*,C,34,SAS,64,2034,351,556,0,3,351,553,280,390,982
1984,Mike Glenn,SG,28,ATL,81,1503,312,554,1,2,311,552,56,70,681
1984,Mike Gminski,C,24,NJN,82,1655,237,462,0,3,237,459,147,184,621
1984,Stewart Granger,PG,22,CLE,56,738,97,226,4,13,93,213,53,70,251
1984,Rickey Green,PG,29,UTA,81,2768,439,904,2,17,437,887,192,234,1072
1984,Sidney Green,PF,23,CHI,49,667,100,228,0,0,100,228,55,77,255
1984,Dave Greenwood,PF,26,CHI,78,2718,369,753,0,1,369,752,213,289,951
1984,Kevin Grevey,SG,30,MIL,64,923,178,395,15,53,163,342,75,84,446
1984,Darrell Griffith,SG,25,UTA,82,2650,697,1423,91,252,606,1171,151,217,1636
1984,Ernie Grunfeld,SG,28,NYK,76,1119,166,362,2,9,164,353,64,83,398
1984,Bob Hansen,SG,23,UTA,55,419,65,145,0,8,65,137,18,28,148
1984,Bill Hanzlik,SF,26,DEN,80,1469,132,306,3,12,129,294,167,207,434
1984,Derek Harper,PG,22,DAL,82,1712,200,451,3,26,197,425,66,98,469
1984,Scott Hastings,PF,23,ATL,68,1135,111,237,1,4,110,233,82,104,305
1984,Steve Hawes,PF,33,SEA,79,1153,114,237,1,4,113,233,61,78,290
1984,Elvin Hayes*,PF,38,HOU,81,994,158,389,0,2,158,387,86,132,402
1984,Steve Hayes,C,28,SEA,43,253,26,50,0,0,26,50,5,14,57
1984,Gerald Henderson,PG,28,BOS,78,2088,376,718,20,57,356,661,136,177,908
1984,Rod Higgins,SF,24,CHI,78,1577,193,432,1,22,192,410,113,156,500
1984,Johnny High,PG,26,PHO,29,512,18,52,0,2,18,50,10,29,46
1984,Armond Hill,PG,30,ATL,15,181,14,46,0,0,14,46,17,21,45
1984,Roy Hinson,SF,22,CLE,80,1858,184,371,0,0,184,371,69,117,437
1984,Craig Hodges,SG,23,SDC,76,1571,258,573,10,46,248,527,66,88,592
1984,Lionel Hollins,PG,30,DET,32,216,24,63,0,2,24,61,11,13,59
1984,Phil Hubbard,SF,27,CLE,80,1799,321,628,0,1,321,627,221,299,863
1984,Geoff Huston,PG,26,CLE,77,2041,348,699,2,11,346,688,110,154,808
1984,Marc Iavaroni,PF,27,PHI,78,1532,149,322,0,2,149,320,97,131,395
1984,Dan Issel*,C,35,DEN,76,2076,569,1153,4,19,565,1134,364,428,1506
1984,Tracy Jackson,SG,24,IND,2,10,1,4,0,0,1,4,4,4,6
1984,Clay Johnson,SG,27,SEA,25,176,20,50,1,1,19,49,14,22,55
1984,Clemon Johnson,C,27,PHI,80,1721,193,412,0,0,193,412,69,113,455
1984,Dennis Johnson*,SG,29,BOS,80,2665,384,878,4,32,380,846,281,330,1053
1984,Eddie Johnson,SG,28,ATL,67,1893,353,798,16,43,337,755,164,213,886
1984,Eddie Johnson,SF,24,KCK,82,2920,753,1552,20,64,733,1488,268,331,1794
1984,Frank Johnson,PG,25,WSB,82,2686,392,840,11,43,381,797,187,252,982
1984,George Johnson,SF,27,IND,81,2073,411,884,11,47,400,837,223,270,1056
1984,Magic Johnson*,PG,24,LAL,67,2567,441,780,6,29,435,751,290,358,1178
1984,Marques Johnson,SF,27,MIL,74,2715,646,1288,2,13,644,1275,241,340,1535
1984,Mickey Johnson,PF,31,GSW,78,2122,359,852,5,29,354,823,339,432,1062
1984,Reggie Johnson,PF,26,NJN,72,818,127,256,0,1,127,255,92,126,346
1984,Steve Johnson,C,26,TOT,81,1487,302,540,0,0,302,540,165,287,769
1984,Steve Johnson,C,26,KCK,50,893,189,342,0,0,189,342,101,177,479
1984,Steve Johnson,C,26,CHI,31,594,113,198,0,0,113,198,64,110,290
1984,Vinnie Johnson,SG,27,DET,82,1909,426,901,4,19,422,882,207,275,1063
1984,Bobby Jones,PF,32,PHI,75,1761,226,432,0,1,226,431,167,213,619
1984,Caldwell Jones,C,33,HOU,81,2506,318,633,1,3,317,630,164,196,801
1984,Charles Jones,PF,26,PHI,1,3,0,1,0,0,0,1,1,4,1
1984,Edgar Jones,PF,27,SAS,81,1770,322,644,6,19,316,625,176,242,826
1984,Hutch Jones,SF,24,SDC,4,18,0,3,0,0,0,3,1,4,1
1984,Major Jones,PF,30,HOU,57,473,70,130,0,0,70,130,30,49,170
1984,Mark Jones,PG,22,NJN,6,16,3,6,0,1,3,5,1,2,7
1984,Eddie Jordan,PG,29,TOT,16,210,17,49,0,3,17,46,8,12,42
1984,Eddie Jordan,PG,29,POR,13,183,13,41,0,3,13,38,7,10,33
1984,Eddie Jordan,PG,29,LAL,3,27,4,8,0,0,4,8,1,2,9
1984,Rich Kelley,C,30,UTA,75,1674,132,264,0,0,132,264,124,162,388
1984,Clark Kellogg,PF,22,IND,79,2676,619,1193,7,21,612,1172,261,340,1506
1984,Greg Kelser,SF,26,SDC,80,1783,313,603,2,6,311,597,250,356,878
1984,Albert King,SF,24,NJN,79,2103,465,946,3,22,462,924,232,295,1165
1984,Bernard King*,SF,27,NYK,77,2667,795,1391,0,4,795,1387,437,561,2027
1984,Reggie King,SF,26,SEA,77,2086,233,448,0,2,233,446,136,206,602
1984,Greg Kite,C,22,BOS,35,197,30,66,0,0,30,66,5,16,65
1984,Billy Knight,SF,31,KCK,75,1885,358,729,4,14,354,715,243,283,963
1984,Joe Kopicki,PF,23,WSB,59,678,64,132,1,7,63,125,91,112,220
1984,Bruce Kuczenski,PF,22,TOT,15,119,10,37,0,0,10,37,8,12,28
1984,Bruce Kuczenski,PF,22,NJN,7,28,4,12,0,0,4,12,3,6,11
1984,Bruce Kuczenski,PF,22,PHI,3,40,1,8,0,0,1,8,1,2,3
1984,Bruce Kuczenski,PF,22,IND,5,51,5,17,0,0,5,17,4,4,14
1984,Mitch Kupchak,PF,29,LAL,34,324,41,108,0,1,41,107,22,34,104
1984,Bill Laimbeer,C,26,DET,82,2864,553,1044,0,11,553,1033,316,365,1422
1984,Jeff Lamp,SF,24,POR,64,660,128,261,2,13,126,248,60,67,318
1984,Mark Landsberger,PF,28,ATL,35,335,19,51,0,0,19,51,15,26,53
1984,Bob Lanier*,C,35,MIL,72,2007,392,685,0,3,392,682,194,274,978
1984,Allen Leavell,PG,26,HOU,82,2009,349,731,11,71,338,660,238,286,947
1984,Ronnie Lester,PG,25,CHI,43,687,78,188,1,5,77,183,75,87,232
1984,Fat Lever,PG,23,POR,81,2010,313,701,3,15,310,686,159,214,788
1984,Cliff Levingston,PF,23,DET,80,1746,229,436,0,3,229,433,125,186,583
1984,Steve Lingenfelter,PF,25,SAS,3,14,1,1,0,0,1,1,0,2,2
1984,Alton Lister,PF,25,MIL,82,1955,256,512,0,0,256,512,114,182,626
1984,Lewis Lloyd,SG,24,HOU,82,2578,610,1182,3,13,607,1169,235,298,1458
1984,Darrell Lockhart,C,23,SAS,2,14,2,2,0,0,2,2,0,0,4
1984,Kevin Loder,SF,24,TOT,11,137,19,43,1,3,18,40,9,13,48
1984,Kevin Loder,SF,24,KCK,10,133,19,43,1,3,18,40,9,13,48
1984,Kevin Loder,SF,24,SDC,1,4,0,0,0,0,0,0,0,0,0
1984,John Long,SG,27,DET,82,2514,545,1155,1,5,544,1150,243,275,1334
1984,Sidney Lowe,PG,24,IND,78,1238,107,259,2,18,105,241,108,139,324
1984,John Lucas,PG,30,SAS,63,1807,275,595,19,69,256,526,120,157,689
1984,Maurice Lucas,PF,31,PHO,75,2309,451,908,0,5,451,903,293,383,1195
1984,Rudy Macklin,SF,25,NYK,8,65,12,30,0,0,12,30,11,13,35
1984,Kyle Macy,PG,26,PHO,82,2402,357,713,23,70,334,643,95,114,832
1984,Rick Mahorn,PF,25,WSB,82,2701,307,605,0,0,307,605,125,192,739
1984,Jeff Malone,SG,22,WSB,81,1976,408,918,24,74,384,844,142,172,982
1984,Moses Malone*,C,28,PHI,71,2613,532,1101,0,4,532,1097,545,727,1609
1984,Pace Mannion,SF,23,GSW,57,469,50,126,3,13,47,113,18,23,121
1984,Wes Matthews,PG,24,TOT,20,388,61,131,1,8,60,123,27,36,150
1984,Wes Matthews,PG,24,ATL,6,96,16,30,0,1,16,29,18,22,50
1984,Wes Matthews,PG,24,PHI,14,292,45,101,1,7,44,94,9,14,100
1984,Cedric Maxwell,SF,28,BOS,80,2502,317,596,1,6,316,590,320,425,955
1984,Bob McAdoo*,C,32,LAL,70,1456,352,748,0,5,352,743,212,264,916
1984,Rodney McCray,SF,22,HOU,79,2081,335,672,1,4,334,668,182,249,853
1984,Scooter McCray,PF,23,SEA,47,520,47,121,0,0,47,121,35,50,129
1984,Hank McDowell,PF,24,SDC,57,611,85,197,0,3,85,194,38,56,208
1984,Mike McGee,SF,24,LAL,77,1425,347,584,2,12,345,572,61,113,757
1984,Kevin McHale*,PF,26,BOS,82,2577,587,1055,1,3,586,1052,336,439,1511
1984,Kevin McKenna,SG,25,IND,61,923,152,371,3,17,149,354,80,98,387
1984,Billy McKinney,PG,28,SDC,80,843,136,305,0,2,136,303,39,46,311
1984,Tom McMillen,C,31,WSB,62,1294,222,447,1,6,221,441,127,156,572
1984,Mark McNamara,C,24,SAS,70,1037,157,253,0,0,157,253,74,157,388
1984,Joe Meriweather,C,30,KCK,73,1501,193,363,0,0,193,363,94,123,480
1984,Larry Micheaux,PF,23,KCK,39,332,49,90,0,0,49,90,21,39,119
1984,Bob Miller,PF,27,SAS,2,8,2,3,0,0,2,3,0,0,4
1984,Mike Mitchell,SF,28,SAS,79,2853,779,1597,6,14,773,1583,275,353,1839
1984,Paul Mokeski,C,27,MIL,68,838,102,213,1,3,101,210,50,72,255
1984,Sidney Moncrief,SG,26,MIL,79,3075,560,1125,5,18,555,1107,529,624,1654
1984,Johnny Moore,PG,25,SAS,59,1650,231,518,28,87,203,431,105,139,595
1984,Larry Nance,PF,24,PHO,82,2899,601,1044,0,7,601,1037,249,352,1451
1984,Swen Nater,C,34,LAL,69,829,124,253,0,1,124,252,63,91,311
1984,Calvin Natt,SF,27,POR,79,2638,500,857,2,17,498,840,275,345,1277
1984,Ed Nealy,PF,23,KCK,71,960,63,126,0,0,63,126,48,60,174
1984,Kurt Nimphius,C,25,DAL,82,2284,272,523,1,4,271,519,101,162,646
1984,Norm Nixon,PG,28,SDC,82,3053,587,1270,11,46,576,1224,206,271,1391
1984,Audie Norris,C,23,POR,79,1157,124,246,0,0,124,246,104,149,352
1984,Mike O'Koren,SF,25,NJN,73,1191,186,385,5,28,181,357,53,87,430
1984,Mark Olberding,PF,27,KCK,81,2160,249,504,0,1,249,503,261,318,759
1984,Jawann Oldham,C,26,CHI,64,870,110,218,0,0,110,218,39,66,259
1984,Louis Orr,SF,25,NYK,78,1640,262,572,0,0,262,572,173,211,697
1984,Robert Parish*,C,30,BOS,80,2867,623,1140,0,0,623,1140,274,368,1520
1984,Billy Paultz,C,35,ATL,40,486,36,88,0,0,36,88,17,33,89
1984,Jim Paxson,SG,26,POR,81,2686,680,1322,17,59,663,1263,345,410,1722
1984,John Paxson,PG,23,SAS,49,458,61,137,4,22,57,115,16,26,142
1984,Roger Phegley,SG,27,TOT,13,87,11,35,2,5,9,30,4,4,28
1984,Roger Phegley,SG,27,SAS,3,11,2,4,1,1,1,3,2,2,7
1984,Roger Phegley,SG,27,DAL,10,76,9,31,1,4,8,27,2,2,21
1984,Ricky Pierce,SG,24,SDC,69,1280,268,570,0,9,268,561,149,173,685
1984,John Pinone,SF,22,ATL,7,65,7,13,0,0,7,13,6,10,20
1984,Tom Piotrowski,C,23,POR,18,78,12,26,0,0,12,26,6,6,30
1984,Charles Pittman,PF,25,PHO,69,989,126,209,0,2,126,207,69,101,321
1984,Ben Poquette,PF,28,CLE,51,858,75,171,1,5,74,166,34,43,185
1984,Paul Pressey,SG,25,MIL,81,1730,276,528,2,9,274,519,120,200,674
1984,Kurt Rambis,PF,25,LAL,47,743,63,113,0,0,63,113,42,66,168
1984,Kelvin Ransey,PG,25,NJN,80,1937,304,700,7,32,297,668,145,183,760
1984,Leo Rautins,SF,23,PHI,28,196,21,58,0,0,21,58,6,10,48
1984,Robert Reid,SF,28,HOU,64,1936,406,857,2,8,404,849,81,123,895
1984,Clint Richardson,SG,27,PHI,69,1571,221,473,0,4,221,469,79,103,521
1984,Micheal Ray,PG,28,NJN,48,1285,243,528,14,58,229,470,76,108,576
1984,Doc Rivers,PG,22,ATL,81,1938,250,541,2,12,248,529,255,325,757
1984,Anthony Roberts,SF,28,DEN,19,197,34,91,0,0,34,91,13,18,81
1984,Fred Roberts,PF,23,SAS,79,1531,214,399,1,4,213,395,144,172,573
1984,Rick Robey,C,28,PHO,61,856,140,257,1,1,139,256,61,88,342
1984,Cliff Robinson,C,23,CLE,73,2402,533,1185,1,2,532,1183,234,334,1301
1984,Truck Robinson,PF,32,NYK,65,2135,284,581,0,0,284,581,133,206,701
1984,Dave Robisch,C,34,TOT,31,340,35,96,0,0,35,96,22,26,92
1984,Dave Robisch,C,34,DEN,19,141,13,40,0,0,13,40,11,13,37
1984,Dave Robisch,C,34,SAS,4,37,4,8,0,0,4,8,0,0,8
1984,Dave Robisch,C,34,KCK,8,162,18,48,0,0,18,48,11,13,47
1984,Tree Rollins,C,28,ATL,77,2351,274,529,0,0,274,529,118,190,666
1984,Lorenzo Romar,PG,25,TOT,68,1022,161,351,4,33,157,318,67,94,393
1984,Lorenzo Romar,PG,25,GSW,3,15,2,5,0,1,2,4,2,4,6
1984,Lorenzo Romar,PG,25,MIL,65,1007,159,346,4,32,155,314,65,90,387
1984,Dan Roundfield,PF,30,ATL,73,2610,503,1038,0,11,503,1027,374,486,1380
1984,Jeff Ruland,C,25,WSB,75,3082,599,1035,1,7,598,1028,466,636,1665
1984,Walker Russell,PG,23,DET,16,119,14,42,1,2,13,40,12,13,41
1984,Ralph Sampson*,C,23,HOU,82,2693,716,1369,1,4,715,1365,287,434,1720
1984,Mike Sanders,SF,23,PHO,50,586,97,203,0,0,97,203,29,42,223
1984,DeWayne Scales,PF,25,WSB,2,13,3,5,0,0,3,5,0,2,6
1984,Danny Schayes,C,24,DEN,82,1420,183,371,0,2,183,369,215,272,581
1984,Alvin Scott,SF,28,PHO,65,735,55,124,1,2,54,122,56,72,167
1984,Byron Scott,SG,22,LAL,74,1637,334,690,8,34,326,656,112,139,788
1984,Lonnie Shelton,PF,28,CLE,79,2101,371,779,1,5,370,774,107,140,850
1984,Purvis Short,SF,26,GSW,79,2945,714,1509,22,72,692,1437,353,445,1803
1984,Jerry Sichting,PG,27,IND,80,2497,397,746,6,20,391,726,117,135,917
1984,Jack Sikma,C,28,SEA,82,2993,576,1155,0,2,576,1153,411,480,1563
1984,Derek Smith,SG,22,SDC,61,1297,238,436,1,6,237,430,123,163,600
1984,Larry Smith,PF,26,GSW,75,2091,244,436,0,0,244,436,94,168,582
1984,Ricky Sobers,SG,31,WSB,81,2624,508,1115,29,111,479,1004,221,264,1266
1984,Jim Spanarkel,SG,26,DAL,7,54,7,16,1,2,6,14,9,13,24
1984,Rory Sparrow,PG,25,NYK,79,2436,350,738,10,39,340,699,108,131,818
1984,Larry Spriggs,SF,24,LAL,38,363,44,82,0,2,44,80,36,50,124
1984,Brook Steppe,SG,24,IND,61,857,148,314,0,3,148,311,134,161,430
1984,Steve Stipanovich,C,23,IND,81,2426,392,816,3,16,389,800,183,243,970
1984,Jon Sundvold,PG,22,SEA,73,1284,217,488,9,37,208,451,64,72,507
1984,Dane Suttle,SG,22,KCK,40,469,109,214,0,3,109,211,40,47,258
1984,Terry Teagle,SG,23,HOU,68,616,148,315,7,27,141,288,37,44,340
1984,Reggie Theus,PG,26,TOT,61,1498,262,625,7,42,255,583,214,281,745
1984,Reggie Theus,PG,26,CHI,31,601,92,237,3,15,89,222,84,108,271
1984,Reggie Theus,PG,26,KCK,30,897,170,388,4,27,166,361,130,173,474
1984,David Thirdkill,SF,23,DET,46,291,31,72,0,1,31,71,15,31,77
1984,Isiah Thomas*,PG,22,DET,82,3007,669,1448,22,65,647,1383,388,529,1748
1984,Jim Thomas,SG,23,IND,72,1219,187,403,1,11,186,392,80,110,455
1984,David Thompson*,SG,29,SEA,19,349,89,165,0,1,89,164,62,73,240
1984,LaSalle Thompson,C,22,KCK,80,1915,333,637,0,0,333,637,160,223,826
1984,Mychal Thompson,C,29,POR,79,2648,487,929,0,2,487,927,266,399,1240
1984,Paul Thompson,SF,22,CLE,82,1731,309,662,9,39,300,623,115,149,742
1984,Sedale Threatt,PG,22,PHI,45,464,62,148,1,8,61,140,23,28,148
1984,Darren Tillis,C,23,GSW,72,730,108,254,0,2,108,252,41,63,257
1984,Ray Tolbert,PF,25,DET,49,475,64,121,0,1,64,120,23,45,151
1984,Andrew Toney,SG,26,PHI,78,2556,593,1125,12,38,581,1087,390,465,1588
1984,Linton Townes,SF,24,TOT,4,19,4,8,0,0,4,8,0,0,8
1984,Linton Townes,SF,24,MIL,2,2,1,1,0,0,1,1,0,0,2
1984,Linton Townes,SF,24,SDC,2,17,3,7,0,0,3,7,0,0,6
1984,Kelly Tripucka,SF,24,DET,76,2493,595,1296,2,17,593,1279,426,523,1618
1984,Trent Tucker,SG,24,NYK,63,1228,225,450,6,16,219,434,25,33,481
1984,Elston Turner,SF,24,DAL,47,536,54,150,1,9,53,141,28,34,137
1984,Terry Tyler,SF,27,DET,82,1602,313,691,2,13,311,678,94,132,722
1984,Darnell Valentine,PG,24,POR,68,1893,251,561,0,3,251,558,194,246,696
1984,Kiki Vandeweghe,PF,25,DEN,78,2734,895,1603,11,30,884,1573,494,580,2295
1984,Pete Verhoeven,PF,24,POR,43,327,50,100,0,1,50,99,17,25,117
1984,Jay Vincent,SF,24,DAL,61,1421,252,579,0,1,252,578,168,215,672
1984,Danny Vranes,SF,25,SEA,80,2174,258,495,0,1,258,494,153,236,669
1984,Granville Waiters,C,23,IND,78,1040,123,238,0,1,123,237,31,51,277
1984,Darrell Walker,PG,22,NYK,82,1324,216,518,4,15,212,503,208,263,644
1984,Foots Walker,PG,32,NJN,34,378,32,90,2,5,30,85,24,27,90
1984,Wally Walker,SF,29,HOU,58,612,118,241,2,6,116,235,6,18,244
1984,Bill Walton*,C,31,SDC,55,1476,288,518,0,2,288,516,92,154,668
1984,Bryan Warrick,PG,24,WSB,32,254,27,66,1,3,26,63,8,16,63
1984,Marvin Webster,C,31,NYK,76,1290,112,239,0,0,112,239,66,117,290
1984,Scott Wedman,SF,31,BOS,68,916,148,333,2,13,146,320,29,35,327
1984,Brant Weidner,PF,23,SAS,8,38,2,9,0,0,2,9,4,4,8
1984,Mark West,C,23,DAL,34,202,15,42,0,0,15,42,7,22,37
1984,Paul Westphal,SG,33,PHO,59,865,144,313,7,26,137,287,117,142,412
1984,Ennis Whatley,PG,21,CHI,80,2159,261,556,0,2,261,554,146,200,668
1984,Rory White,SF,24,TOT,36,372,80,170,0,0,80,170,26,47,186
1984,Rory White,SF,24,PHO,22,308,69,144,0,0,69,144,24,42,162
1984,Rory White,SF,24,MIL,8,45,7,17,0,0,7,17,2,5,16
1984,Rory White,SF,24,SDC,6,19,4,9,0,0,4,9,0,0,8
1984,Jerome Whitehead,C,27,SDC,70,921,144,294,0,0,144,294,88,107,376
1984,Mitchell Wiggins,SG,24,CHI,82,2123,399,890,7,29,392,861,213,287,1018
1984,Jamaal Wilkes*,SF,30,LAL,75,2507,542,1055,2,8,540,1047,208,280,1294
1984,Dominique Wilkins*,SF,24,ATL,81,2961,684,1429,0,11,684,1418,382,496,1750
1984,Jeff Wilkins,C,28,UTA,81,1734,249,520,0,3,249,517,134,182,632
1984,Buck Williams,PF,23,NJN,81,3003,495,926,0,4,495,922,284,498,1274
1984,Gus Williams,PG,30,SEA,80,2818,598,1306,4,25,594,1281,297,396,1497
1984,Herb Williams,C,25,IND,69,2279,411,860,0,4,411,856,207,295,1029
1984,Kevin Williams,SG,22,SAS,19,200,25,58,0,1,25,57,25,32,75
1984,Ray Williams,SG,29,NYK,76,2230,418,939,25,81,393,858,263,318,1124
1984,Rob Williams,PG,22,DEN,79,1924,309,671,15,47,294,624,171,209,804
1984,Sam Williams,PF,24,TOT,77,1434,204,431,0,1,204,430,92,140,500
1984,Sam Williams,PF,24,GSW,7,59,11,26,0,0,11,26,6,7,28
1984,Sam Williams,PF,24,PHI,70,1375,193,405,0,1,193,404,86,133,472
1984,Sly Williams,SF,26,ATL,13,258,34,114,1,9,33,105,36,46,105
1984,Bill Willoughby,SF,26,NJN,67,936,124,258,0,7,124,251,55,63,303
1984,Michael Wilson,PG,24,WSB,6,26,0,2,0,1,0,1,1,2,1
1984,Randy Wittman,SG,24,ATL,78,1071,160,318,2,5,158,313,28,46,350
1984,Al Wood,SG,25,SEA,81,2236,467,945,3,21,464,924,223,271,1160
1984,Mike Woodson,SG,25,KCK,71,1838,389,816,2,8,387,808,247,302,1027
1984,Orlando Woolridge,SF,24,CHI,75,2544,570,1086,1,2,569,1084,303,424,1444
1984,James Worthy*,PF,22,LAL,82,2415,495,890,0,6,495,884,195,257,1185
,,,,,,,,,,,,,,,
1985,Kareem Abdul-Jabbar*,C,37,LAL,79,2630,723,1207,0,1,723,1206,289,395,1735
1985,Alvan Adams,PF,30,PHO,82,2136,476,915,0,0,476,915,250,283,1202
1985,Mark Aguirre,SF,25,DAL,80,2699,794,1569,27,85,767,1484,440,580,2055
1985,Danny Ainge,SG,25,BOS,75,2564,419,792,15,56,404,736,118,136,971
1985,Chuck Aleksinas,C,25,GSW,74,1114,161,337,0,1,161,336,55,75,377
1985,J.J. Anderson,SF,24,UTA,44,457,61,149,0,2,61,147,27,45,149
1985,Ron Anderson,SF,26,CLE,36,520,84,195,1,2,83,193,41,50,210
1985,John Bagley,PG,24,CLE,81,2401,338,693,3,26,335,667,125,167,804
1985,James Bailey,PF,27,NYK,74,1297,156,349,0,1,156,348,73,108,385
1985,Thurl Bailey,PF,23,UTA,80,2481,507,1034,1,1,506,1033,197,234,1212
1985,Greg Ballard,SF,30,WSB,82,2664,469,978,14,46,455,932,120,151,1072
1985,Gene Banks,SF,25,SAS,82,2091,289,493,1,3,288,490,199,257,778
1985,Ken Bannister,PF,24,NYK,75,1404,209,445,0,0,209,445,91,192,509
1985,Charles Barkley*,PF,21,PHI,82,2347,427,783,1,6,426,777,293,400,1148
1985,Kent Benson,C,30,DET,72,1401,201,397,0,3,201,394,76,94,478
1985,Larry Bird*,SF,28,BOS,80,3161,918,1760,56,131,862,1629,403,457,2295
1985,Otis Birdsong,SG,29,NJN,56,1842,495,968,4,21,491,947,161,259,1155
1985,Rolando Blackman,SG,25,DAL,81,2834,625,1230,6,20,619,1210,342,413,1598
1985,Cory Blackwell,SF,21,SEA,60,551,87,237,0,2,87,235,28,55,202
1985,Sam Bowie,C,23,POR,76,2216,299,557,0,0,299,557,160,225,758
1985,Dudley Bradley,SG,27,WSB,73,1232,142,299,20,64,122,235,54,79,358
1985,Mike Bratz,PG,29,GSW,56,746,106,250,6,26,100,224,69,82,287
1985,Randy Breuer,C,24,MIL,78,1083,162,317,0,0,162,317,89,127,413
1985,Ron Brewer,SG,29,TOT,20,326,62,118,0,2,62,116,23,25,147
1985,Ron Brewer,SG,29,SAS,9,81,13,34,0,0,13,34,7,7,33
1985,Ron Brewer,SG,29,NJN,11,245,49,84,0,2,49,82,16,18,114
1985,Frank Brickowski,C,25,SEA,78,1115,150,305,0,4,150,301,85,127,385
1985,Junior Bridgeman,SF,31,LAC,80,2042,460,990,14,39,446,951,181,206,1115
1985,Rickey Brown,C,26,ATL,69,814,78,192,0,0,78,192,39,68,195
1985,Tony Brown,SF,24,IND,82,1586,214,465,0,6,214,459,116,171,544
1985,Wallace Bryant,C,25,DAL,56,860,67,148,0,0,67,148,30,44,164
1985,Quinn Buckner,PG,30,BOS,75,858,74,193,0,1,74,192,32,50,180
1985,Steve Burtt,SG,22,GSW,47,418,72,188,0,1,72,187,53,77,197
1985,Don Buse,PG,34,KCK,65,939,82,203,31,87,51,116,23,30,218
1985,Michael Cage,PF,23,LAC,75,1610,216,398,0,0,216,398,101,137,533
1985,Tony Campbell,SF,22,DET,56,625,130,262,0,1,130,261,56,70,316
1985,Rick Carlisle,SG,25,BOS,38,179,26,67,0,2,26,65,15,17,67
1985,Antoine Carr,PF,23,ATL,62,1195,198,375,2,6,196,369,101,128,499
1985,Kenny Carr,PF,29,POR,48,1120,190,363,0,3,190,360,118,164,498
1985,M.L. Carr,SF,34,BOS,47,397,62,149,9,23,53,126,17,17,150
1985,Butch Carter,SG,26,NYK,69,1279,214,476,11,43,203,433,109,134,548
1985,Howard Carter,SG,23,DAL,11,66,4,23,0,3,4,20,1,1,9
1985,Harvey Catchings,C,33,LAC,70,1049,72,149,0,1,72,148,59,89,203
1985,Ron Cavenall,C,25,NYK,53,653,28,86,0,0,28,86,22,39,78
1985,Tom Chambers,PF,25,SEA,81,2923,629,1302,6,22,623,1280,475,571,1739
1985,Maurice Cheeks,PG,28,PHI,78,2616,422,741,6,26,416,715,175,199,1025
1985,Carlos Clark,SG,24,BOS,62,562,64,152,0,5,64,147,41,53,169
1985,Don Collins,SG,26,WSB,11,91,12,34,0,0,12,34,8,9,32
1985,Steve Colter,PG,22,POR,78,1462,216,477,26,74,190,403,98,130,556
1985,Lester Conner,PG,25,GSW,79,2258,246,546,4,20,242,526,144,192,640
1985,Darwin Cook,PG,26,NJN,58,1063,212,453,2,23,210,430,47,54,473
1985,Jeff Cook,PF,28,TOT,72,1288,138,279,0,1,138,278,47,64,323
1985,Jeff Cook,PF,28,CLE,18,440,46,105,0,1,46,104,17,27,109
1985,Jeff Cook,PF,28,SAS,54,848,92,174,0,0,92,174,30,37,214
1985,Joe Cooper,C,27,SEA,3,45,7,15,0,0,7,15,3,6,17
1985,Michael Cooper,SG,28,LAL,82,2189,276,593,35,123,241,470,115,133,702
1985,Wayne Cooper,C,28,DEN,80,2031,404,856,0,2,404,854,161,235,969
1985,Dave Corzine,C,28,CHI,82,2062,276,568,0,1,276,567,149,200,701
1985,Charlie Criss,PG,36,ATL,4,115,7,17,0,2,7,15,4,6,18
1985,Pat Cummings,C,28,NYK,63,2069,410,797,0,4,410,793,177,227,997
1985,Terry Cummings,PF,23,MIL,79,2722,759,1532,0,1,759,1531,343,463,1861
1985,Earl Cureton,C,27,DET,81,1642,207,428,0,3,207,425,82,144,496
1985,Quintin Dailey,SG,24,CHI,79,2101,525,1111,7,30,518,1081,205,251,1262
1985,Adrian Dantley*,SF,28,UTA,55,1971,512,964,0,0,512,964,438,545,1462
1985,Brad Davis,PG,29,DAL,82,2539,310,614,47,115,263,499,158,178,825
1985,Charles Davis,SF,26,TOT,61,774,153,356,1,10,152,346,51,62,358
1985,Charles Davis,SF,26,WSB,4,28,2,10,0,0,2,10,3,4,7
1985,Charles Davis,SF,26,MIL,57,746,151,346,1,10,150,336,48,58,351
1985,Johnny Davis,PG,29,CLE,76,1920,337,791,12,46,325,745,255,300,941
1985,Walter Davis,SG,30,PHO,23,570,139,309,3,10,136,299,64,73,345
1985,Darryl Dawkins,C,28,NJN,39,972,192,339,0,1,192,338,143,201,527
1985,Darren Daye,SF,24,WSB,80,1573,258,504,1,7,257,497,178,249,695
1985,James Donaldson,C,27,LAC,82,2392,351,551,0,0,351,551,227,303,929
1985,John Drew,SF,30,UTA,19,463,107,260,0,4,107,256,94,122,308
1985,Larry Drew,PG,26,KCK,72,2373,457,913,7,28,450,885,154,194,1075
1985,Clyde Drexler*,SG,22,POR,80,2555,573,1161,8,37,565,1124,223,294,1377
1985,Mike Dunleavy,PG,30,MIL,19,433,64,135,16,47,48,88,25,29,169
1985,T.R. Dunn,SG,29,DEN,81,2290,175,358,0,2,175,356,84,116,434
1985,Devin Durrant,SF,24,IND,59,756,114,274,0,3,114,271,72,102,300
1985,Mark Eaton,C,28,UTA,82,2813,302,673,0,0,302,673,190,267,794
1985,Jerry Eaves,PG,25,ATL,3,37,3,6,0,0,3,6,5,6,11
1985,Kenton Edelin,SF,22,IND,10,143,4,13,0,0,4,13,3,8,11
1985,Franklin Edwards,PG,25,LAC,16,198,36,66,0,0,36,66,19,24,91
1985,James Edwards,C,29,PHO,70,1787,384,766,0,3,384,763,276,370,1044
1985,Craig Ehlo,SG,23,HOU,45,189,34,69,0,3,34,66,19,30,87
1985,Dale Ellis,SF,24,DAL,72,1314,274,603,42,109,232,494,77,104,667
1985,Chris Engler,C,25,TOT,11,82,8,20,0,0,8,20,5,9,21
1985,Chris Engler,C,25,NJN,7,76,7,16,0,0,7,16,5,9,19
1985,Chris Engler,C,25,CHI,3,3,1,2,0,0,1,2,0,0,2
1985,Chris Engler,C,25,MIL,1,3,0,2,0,0,0,2,0,0,0
1985,Alex English*,SF,31,DEN,81,2924,939,1812,1,5,938,1807,383,462,2262
1985,Julius Erving*,SF,34,PHI,78,2535,610,1236,3,14,607,1222,338,442,1561
1985,Mike Evans,SG,29,DEN,81,1437,323,661,57,157,266,504,113,131,816
1985,Kenny Fields,SF,22,MIL,51,535,84,191,0,0,84,191,27,36,195
1985,Vern Fleming,PG,22,IND,80,2486,433,922,0,4,433,918,260,339,1126
1985,Sleepy Floyd,SG,24,GSW,82,2873,610,1372,42,143,568,1229,336,415,1598
1985,Phil Ford,PG,28,HOU,25,290,14,47,0,4,14,43,16,18,44
1985,Rod Foster,PG,24,PHO,79,1318,286,636,41,126,245,510,83,110,696
1985,World B.,SG,31,CLE,71,2249,609,1328,71,193,538,1135,308,411,1597
1985,Bill Garnett,PF,24,IND,65,1123,149,310,0,2,149,308,120,174,418
1985,George Gervin*,SG,32,SAS,72,2091,600,1182,0,10,600,1172,324,384,1524
1985,Artis Gilmore*,C,35,SAS,81,2756,532,854,0,2,532,852,484,646,1548
1985,Mike Glenn,SG,29,ATL,60,1126,228,388,0,2,228,386,62,76,518
1985,Mike Gminski,C,25,NJN,81,2418,380,818,0,1,380,817,276,328,1036
1985,Lancaster Gordon,SG,22,LAC,63,682,110,287,2,9,108,278,37,49,259
1985,Stewart Granger,PG,23,ATL,9,92,6,17,0,1,6,16,4,8,16
1985,Butch Graves,SG,23,CLE,4,11,2,6,0,1,2,5,1,5,5
1985,Stuart Gray,C,21,IND,52,391,35,92,0,0,35,92,32,47,102
1985,Rickey Green,PG,30,UTA,77,2431,381,798,6,20,375,778,232,267,1000
1985,Sidney Green,PF,24,CHI,48,740,108,250,0,4,108,246,79,98,295
1985,Dave Greenwood,PF,27,CHI,61,1523,152,332,0,1,152,331,67,94,371
1985,Kevin Grevey,SF,31,MIL,78,1182,190,424,8,33,182,391,88,107,476
1985,Darrell Griffith,SG,26,UTA,78,2776,728,1593,92,257,636,1336,216,298,1764
1985,Ernie Grunfeld,SF,29,NYK,69,1061,188,384,2,8,186,376,77,104,455
1985,Bob Hansen,SG,24,UTA,54,646,110,225,1,7,109,218,40,72,261
1985,Bill Hanzlik,SF,27,DEN,80,1673,220,522,1,15,219,507,180,238,621
1985,Derek Harper,PG,23,DAL,82,2218,329,633,21,61,308,572,111,154,790
1985,Scott Hastings,PF,24,ATL,64,825,89,188,0,0,89,188,63,81,241
1985,Steve Hayes,C,29,PHI,11,101,10,18,0,0,10,18,2,4,22
1985,Gerald Henderson,PG,29,SEA,79,2648,427,891,9,38,418,853,199,255,1062
1985,Rod Higgins,SF,25,CHI,68,942,119,270,10,37,109,233,60,90,308
1985,Roy Hinson,PF,23,CLE,76,2344,465,925,0,3,465,922,271,376,1201
1985,Craig Hodges,SG,24,MIL,82,2496,359,732,47,135,312,597,106,130,871
1985,Lionel Hollins,PG,31,HOU,80,1950,249,540,3,13,246,527,108,136,609
1985,Mike Holton,SG,23,PHO,74,1761,257,576,14,45,243,531,96,118,624
1985,Phil Hubbard,SF,28,CLE,76,2249,415,822,0,4,415,818,371,494,1201
1985,Jay Humphries,SG,22,PHO,80,2062,279,626,4,20,275,606,141,170,703
1985,Geoff Huston,PG,27,CLE,8,93,12,25,0,0,12,25,2,3,26
1985,Marc Iavaroni,PF,28,TOT,69,1334,162,354,0,4,162,350,87,128,411
1985,Marc Iavaroni,PF,28,PHI,12,156,12,31,0,0,12,31,6,6,30
1985,Marc Iavaroni,PF,28,SAS,57,1178,150,323,0,4,150,319,81,122,381
1985,Dan Issel*,C,36,DEN,77,1684,363,791,1,7,362,784,257,319,984
1985,Ralph Jackson,PG,22,IND,1,12,1,3,0,0,1,3,0,0,2
1985,Clemon Johnson,C,28,PHI,58,875,117,235,0,1,117,234,36,49,270
1985,Dennis Johnson*,PG,30,BOS,80,2976,493,1066,7,26,486,1040,261,306,1254
1985,Eddie Johnson,SG,29,ATL,73,2367,453,946,22,72,431,874,265,332,1193
1985,Eddie Johnson,SF,25,KCK,82,3029,769,1565,13,54,756,1511,325,373,1876
1985,Frank Johnson,PG,26,WSB,46,925,175,358,6,17,169,341,72,96,428
1985,George Johnson,C,36,NJN,65,800,42,79,1,1,41,78,22,27,107
1985,George Johnson,SF,28,PHI,55,756,107,263,1,10,106,253,49,56,264
1985,Magic Johnson*,PG,25,LAL,77,2781,504,899,7,37,497,862,391,464,1406
1985,Marques Johnson,SF,28,LAC,72,2448,494,1094,3,13,491,1081,190,260,1181
1985,Mickey Johnson,PF,32,GSW,66,1565,304,714,7,30,297,684,260,316,875
1985,Steve Johnson,C,27,CHI,74,1659,281,516,0,3,281,513,181,252,743
1985,Vinnie Johnson,SG,28,DET,82,2093,428,942,5,27,423,915,190,247,1051
1985,Bobby Jones,PF,33,PHI,80,1633,207,385,0,4,207,381,186,216,600
1985,Caldwell Jones,C,34,CHI,42,885,53,115,0,2,53,113,36,47,142
1985,Charles Jones,C,23,PHO,78,1565,236,454,0,4,236,450,182,281,654
1985,Charles Jones,C-PF,27,TOT,31,667,67,127,0,0,67,127,40,58,174
1985,Charles Jones,PF,27,CHI,3,29,2,4,0,0,2,4,4,6,8
1985,Charles Jones,C,27,WSB,28,638,65,123,0,0,65,123,36,52,166
1985,Earl Jones,C,24,LAL,2,7,0,1,0,0,0,1,0,0,0
1985,Edgar Jones,PF,28,TOT,44,769,130,275,0,4,130,271,82,111,342
1985,Edgar Jones,PF,28,SAS,18,322,44,91,0,1,44,90,41,51,129
1985,Edgar Jones,PF,28,CLE,26,447,86,184,0,3,86,181,41,60,213
1985,Major Jones,PF,31,DET,47,418,48,87,0,0,48,87,33,51,129
1985,Ozell Jones,C,24,SAS,67,888,106,180,0,1,106,179,33,83,245
1985,Michael Jordan*,SG,21,CHI,82,3144,837,1625,9,52,828,1573,630,746,2313
1985,Rich Kelley,C,31,UTA,77,1276,103,216,0,2,103,214,84,112,290
1985,Clark Kellogg,PF,23,IND,77,2449,562,1112,7,14,555,1098,301,396,1432
1985,Greg Kelser,SF,27,IND,10,114,21,53,0,1,21,52,20,28,62
1985,Jerome Kersey,SF,22,POR,77,958,178,372,0,3,178,369,117,181,473
1985,Albert King,SF,25,NJN,42,860,226,460,0,8,226,452,85,104,537
1985,Bernard King*,SF,28,NYK,55,2063,691,1303,1,10,690,1293,426,552,1809
1985,Reggie King,SF,27,SEA,60,860,63,149,0,0,63,149,41,59,167
1985,Greg Kite,C,23,BOS,55,424,33,88,0,0,33,88,22,32,88
1985,Billy Knight,SF-SG,32,TOT,68,800,156,354,11,25,145,329,64,73,387
1985,Billy Knight,SG,32,KCK,16,189,31,69,1,1,30,68,13,16,76
1985,Billy Knight,SF,32,SAS,52,611,125,285,10,24,115,261,51,57,311
1985,Joe Kopicki,PF,24,DEN,42,308,50,95,2,3,48,92,43,54,145
1985,Mitch Kupchak,PF,30,LAL,58,716,123,244,0,0,123,244,60,91,306
1985,Tom LaGarde,C,29,NJN,1,8,0,1,0,0,0,1,1,2,1
1985,Bill Laimbeer,C,27,DET,82,2892,595,1177,4,18,591,1159,244,306,1438
1985,Allen Leavell,PG,27,HOU,42,536,88,209,8,37,80,172,44,57,228
1985,Ronnie Lester,PG,26,LAL,32,278,34,82,0,1,34,81,21,31,89
1985,Fat Lever,PG,24,DEN,82,2559,424,985,6,24,418,961,197,256,1051
1985,Cliff Levingston,PF,24,ATL,74,2017,291,552,0,2,291,550,145,222,727
1985,Alton Lister,C,26,MIL,81,2091,322,598,0,1,322,597,154,262,798
1985,Lewis Lloyd,SG,25,HOU,82,2128,457,869,2,8,455,861,161,220,1077
1985,John Long,SG,28,DET,66,1820,431,885,5,15,426,870,106,123,973
1985,Sidney Lowe,PG,25,TOT,21,190,10,27,0,1,10,26,8,8,28
1985,Sidney Lowe,PG,25,DET,6,31,2,7,0,0,2,7,0,0,4
1985,Sidney Lowe,PG,25,ATL,15,159,8,20,0,1,8,19,8,8,24
1985,John Lucas,PG,31,HOU,47,1158,206,446,21,66,185,380,103,129,536
1985,Maurice Lucas,PF,32,PHO,63,1670,346,727,0,4,346,723,150,200,842
1985,Kyle Macy,PG,27,PHO,65,2018,282,582,23,85,259,497,127,140,714
1985,Rick Mahorn,PF,26,WSB,77,2072,206,413,0,0,206,413,71,104,483
1985,Jeff Malone,SG,23,WSB,76,2613,605,1213,15,72,590,1141,211,250,1436
1985,Moses Malone*,C,29,PHI,79,2957,602,1284,0,2,602,1282,737,904,1941
1985,Pace Mannion,SF,24,UTA,34,190,27,63,0,1,27,62,16,23,70
1985,Wes Matthews,PG,25,CHI,78,1523,191,386,2,16,189,370,59,85,443
1985,Cedric Maxwell,SF,29,BOS,57,1495,201,377,0,2,201,375,231,278,633
1985,Bob McAdoo*,C,33,LAL,66,1254,284,546,0,1,284,545,122,162,690
1985,Tim McCormick,C,22,SEA,78,1584,269,483,0,1,269,482,188,263,726
1985,Rodney McCray,SF,23,HOU,82,3001,476,890,0,6,476,884,231,313,1183
1985,Scooter McCray,PF,24,SEA,6,93,6,10,0,0,6,10,3,4,15
1985,Hank McDowell,PF,25,HOU,34,132,20,42,0,1,20,41,7,10,47
1985,Mike McGee,SF,25,LAL,76,1170,329,612,22,61,307,551,94,160,774
1985,Kevin McHale*,PF,27,BOS,79,2653,605,1062,0,6,605,1056,355,467,1565
1985,Kevin McKenna,SG,26,NJN,29,535,61,134,5,13,56,121,38,43,165
1985,Tom McMillen,C,32,WSB,69,1547,252,534,0,5,252,529,112,135,616
1985,Mark McNamara,C,25,TOT,45,273,40,76,0,0,40,76,32,62,112
1985,Mark McNamara,C,25,SAS,12,63,12,18,0,0,12,18,9,18,33
1985,Mark McNamara,C,25,KCK,33,210,28,58,0,0,28,58,23,44,79
1985,Joe Meriweather,C,31,KCK,76,1061,121,243,1,2,120,241,96,124,339
1985,Larry Micheaux,PF,24,TOT,57,565,91,157,0,3,91,154,29,43,211
1985,Larry Micheaux,PF,24,MIL,18,171,17,35,0,0,17,35,12,17,46
1985,Larry Micheaux,PF,24,HOU,39,394,74,122,0,3,74,119,17,26,165
1985,Mike Mitchell,SF,29,SAS,82,2853,775,1558,5,23,770,1535,269,346,1824
1985,Paul Mokeski,C,28,MIL,79,1586,205,429,0,2,205,427,81,116,491
1985,Sidney Moncrief,PG,27,MIL,73,2734,561,1162,9,33,552,1129,454,548,1585
1985,Johnny Moore,PG,26,SAS,82,2689,416,910,25,89,391,821,189,248,1046
1985,Jay Murphy,PF,22,LAC,23,149,8,50,0,1,8,49,12,21,28
1985,Larry Nance,PF,25,PHO,61,2202,515,877,1,2,514,875,180,254,1211
1985,Calvin Natt,PF,28,DEN,78,2657,685,1255,0,3,685,1252,447,564,1817
1985,Kenny Natt,SG,26,TOT,8,29,2,6,0,0,2,6,2,4,6
1985,Kenny Natt,SG,26,UTA,4,13,2,5,0,0,2,5,2,4,6
1985,Kenny Natt,SG,26,KCK,4,16,0,1,0,0,0,1,0,0,0
1985,Ed Nealy,PF,24,KCK,22,225,26,44,0,0,26,44,10,19,62
1985,Chuck Nevitt,C,25,LAL,11,59,5,17,0,0,5,17,2,8,12
1985,Kurt Nimphius,C,26,DAL,82,2010,196,434,0,6,196,428,108,140,500
1985,Norm Nixon,PG,29,LAC,81,2894,596,1281,33,99,563,1182,170,218,1395
1985,Audie Norris,C,24,POR,78,1117,133,245,0,3,133,242,135,203,401
1985,Mike O'Koren,SF,26,NJN,43,1119,194,393,8,21,186,372,42,67,438
1985,Hakeem Olajuwon*,C,22,HOU,82,2914,677,1258,0,0,677,1258,338,551,1692
1985,Mark Olberding,PF,28,KCK,81,2277,265,528,0,3,265,525,293,352,823
1985,Jawann Oldham,C,27,CHI,63,993,89,192,0,1,89,191,34,50,212
1985,Louis Orr,PF,26,NYK,79,2452,372,766,1,10,371,756,262,334,1007
1985,Robert Parish*,C,31,BOS,79,2850,551,1016,0,0,551,1016,292,393,1394
1985,Billy Paultz,C,36,UTA,62,370,32,87,0,0,32,87,18,28,82
1985,Jim Paxson,SG,27,POR,68,2253,508,988,6,39,502,949,196,248,1218
1985,John Paxson,PG,24,SAS,78,1259,196,385,10,34,186,351,84,100,486
1985,Sam Perkins,PF,23,DAL,82,2317,347,736,9,36,338,700,200,244,903
1985,Jim Petersen,PF,22,HOU,60,714,70,144,0,0,70,144,50,66,190
1985,Ricky Pierce,SG,25,MIL,44,882,165,307,1,4,164,303,102,124,433
1985,Charles Pittman,SF,26,PHO,68,1001,107,227,0,2,107,225,109,146,323
1985,Gary Plummer,PF,22,GSW,66,702,92,232,1,4,91,228,65,92,250
1985,David Pope,SF,22,KCK,22,129,17,53,0,1,17,52,7,13,41
1985,Ben Poquette,PF,29,CLE,79,1656,210,457,3,17,207,440,109,137,532
1985,Paul Pressey,SF,26,MIL,80,2876,480,928,7,20,473,908,317,418,1284
1985,Kurt Rambis,PF,26,LAL,82,1617,181,327,0,0,181,327,68,103,430
1985,Kelvin Ransey,PG,26,NJN,81,1689,300,654,2,11,298,643,122,142,724
1985,Leo Rautins,SF,24,ATL,4,12,0,2,0,0,0,2,0,0,0
1985,Robert Reid,SF,29,HOU,82,1763,312,648,1,16,311,632,88,126,713
1985,Clint Richardson,SG,28,PHI,74,1531,183,404,1,3,182,401,76,89,443
1985,Micheal Ray,PG,29,NJN,82,3127,690,1470,29,115,661,1355,240,313,1649
1985,Doc Rivers,PG,23,ATL,69,2126,334,701,15,36,319,665,291,378,974
1985,Fred Roberts,PF,24,TOT,74,1178,208,418,1,1,207,417,150,182,567
1985,Fred Roberts,PF,24,SAS,22,305,44,98,0,0,44,98,29,38,117
1985,Fred Roberts,PF,24,UTA,52,873,164,320,1,1,163,319,121,144,450
1985,Alvin Robertson,SG,22,SAS,79,1685,299,600,4,11,295,589,124,169,726
1985,Rick Robey,C,29,PHO,4,48,2,9,0,0,2,9,1,2,5
1985,Cliff Robinson,PF,24,WSB,60,1870,422,896,1,3,421,893,158,213,1003
1985,Truck Robinson,PF,33,NYK,2,35,2,5,0,0,2,5,0,2,4
1985,Tree Rollins,C,29,ATL,70,1750,186,339,0,0,186,339,67,93,439
1985,Lorenzo Romar,PG,26,TOT,9,51,3,16,0,3,3,13,5,5,11
1985,Lorenzo Romar,PG,26,MIL,4,16,1,8,0,1,1,7,0,0,2
1985,Lorenzo Romar,PG,26,DET,5,35,2,8,0,2,2,6,5,5,9
1985,Dan Roundfield,PF,31,DET,56,1492,236,505,0,2,236,503,139,178,611
1985,Jeff Ruland,C,26,WSB,37,1436,250,439,0,2,250,437,200,292,700
1985,Campy Russell,SF,33,CLE,3,24,2,7,0,1,2,6,2,3,6
1985,Walker Russell,PG,24,ATL,21,377,34,63,1,1,33,62,14,17,83
1985,Ralph Sampson*,PF,24,HOU,82,3086,753,1499,0,6,753,1493,303,448,1809
1985,Mike Sanders,SF,24,PHO,21,418,85,175,0,0,85,175,45,59,215
1985,Wayne Sappleton,PF,24,NJN,33,298,41,87,0,0,41,87,14,34,96
1985,Danny Schayes,C,25,DEN,56,542,60,129,0,0,60,129,79,97,199
1985,Tom Scheffler,C,30,POR,39,268,21,51,0,0,21,51,10,20,52
1985,John Schweitz,SG,24,SEA,19,110,25,74,0,4,25,70,7,10,57
1985,Alvin Scott,SF,29,PHO,77,1238,111,259,1,5,110,254,53,74,276
1985,Byron Scott,SG,23,LAL,81,2305,541,1003,26,60,515,943,187,228,1295
1985,Tom Sewell,SG,22,WSB,21,87,9,36,0,2,9,34,2,4,20
1985,Lonnie Shelton,PF,29,CLE,57,1244,158,363,0,5,158,358,51,77,367
1985,Purvis Short,SF,27,GSW,78,3081,819,1780,47,150,772,1630,501,613,2186
1985,Jerry Sichting,PG,28,IND,70,1808,325,624,9,37,316,587,112,128,771
1985,Jack Sikma,C,29,SEA,68,2402,461,943,2,10,459,933,335,393,1259
1985,Charlie Sitton,SF,22,DAL,43,304,39,94,0,2,39,92,13,25,91
1985,Tom Sluby,SG,22,DAL,31,151,30,58,0,2,30,56,13,21,73
1985,Derek Smith,SG,23,LAC,80,2762,682,1271,3,19,679,1252,400,504,1767
1985,Larry Smith,PF,27,GSW,80,2497,366,690,0,0,366,690,155,256,887
1985,Robert Smith,PG,29,CLE,7,48,4,17,0,4,4,13,8,10,16
1985,Ricky Sobers,SG,32,SEA,71,1490,280,628,8,28,272,600,132,162,700
1985,Rory Sparrow,PG,26,NYK,79,2292,326,662,7,31,319,631,122,141,781
1985,Larry Spriggs,PF,25,LAL,75,1292,194,354,0,3,194,351,112,146,500
1985,Terence Stansbury,SG,23,IND,74,1278,210,458,4,25,206,433,102,126,526
1985,Brook Steppe,SG,25,DET,54,486,83,178,0,1,83,177,87,104,253
1985,Steve Stipanovich,C,24,IND,82,2315,414,871,1,11,413,860,297,372,1126
1985,John Stockton*,PG,22,UTA,82,1490,157,333,2,11,155,322,142,193,458
1985,Jon Sundvold,PG,23,SEA,73,1150,170,400,12,38,158,362,48,59,400
1985,Dane Suttle,SG,23,KCK,6,24,6,13,0,1,6,12,2,2,14
1985,Terry Teagle,SG,24,TOT,21,349,74,137,2,4,72,133,25,35,175
1985,Terry Teagle,SG,24,DET,2,5,1,2,0,0,1,2,0,0,2
1985,Terry Teagle,SG,24,GSW,19,344,73,135,2,4,71,131,25,35,173
1985,Reggie Theus,SG,27,KCK,82,2543,501,1029,5,38,496,991,334,387,1341
1985,Peter Thibeaux,SF,23,GSW,51,461,94,195,0,2,94,193,43,67,231
1985,David Thirdkill,SF,24,TOT,18,183,20,38,0,1,20,37,11,19,51
1985,David Thirdkill,SF,24,DET,10,115,12,23,0,1,12,22,5,11,29
1985,David Thirdkill,SF,24,MIL,6,16,3,4,0,0,3,4,1,2,7
1985,David Thirdkill,SF,24,SAS,2,52,5,11,0,0,5,11,5,6,15
1985,Isiah Thomas*,PG,23,DET,81,3089,646,1410,29,113,617,1297,399,493,1720
1985,Jim Thomas,SG,24,IND,80,2059,347,726,8,42,339,684,183,234,885
1985,Bernard Thompson,SF,22,POR,59,535,79,212,0,8,79,204,39,51,197
1985,LaSalle Thompson,C,23,KCK,82,2458,369,695,0,0,369,695,227,315,965
1985,Mychal Thompson,PF,30,POR,79,2616,572,1111,0,0,572,1111,307,449,1451
1985,Paul Thompson,SF,23,TOT,49,942,189,459,6,30,183,429,69,87,453
1985,Paul Thompson,SF,23,CLE,33,715,148,354,6,23,142,331,45,53,347
1985,Paul Thompson,SF,23,MIL,16,227,41,105,0,7,41,98,24,34,106
1985,Otis Thorpe,PF,22,KCK,82,1918,411,685,0,2,411,683,230,371,1052
1985,Sedale Threatt,PG,23,PHI,82,1304,188,416,4,22,184,394,66,90,446
1985,Andrew Toney,SG,27,PHI,70,2237,450,914,39,105,411,809,306,355,1245
1985,Linton Townes,SF,25,SAS,1,8,0,6,0,0,0,6,2,2,2
1985,Kelly Tripucka,SF,25,DET,55,1675,396,831,2,5,394,826,255,288,1049
1985,Trent Tucker,SG,25,NYK,77,1819,293,606,29,72,264,534,38,48,653
1985,Elston Turner,SF,25,DEN,81,1491,181,388,1,6,180,382,51,65,414
1985,Jeff Turner,PF,22,NJN,72,1429,171,377,0,3,171,374,79,92,421
1985,Melvin Turpin,C,24,CLE,79,1949,363,711,0,0,363,711,109,139,835
1985,Terry Tyler,SF,28,DET,82,2004,422,855,0,8,422,847,106,148,950
1985,Darnell Valentine,PG,25,POR,75,2278,321,679,0,2,321,677,230,290,872
1985,Kiki Vandeweghe,SF,26,POR,72,2502,618,1158,11,33,607,1125,369,412,1616
1985,Pete Verhoeven,PF,25,KCK,54,366,51,108,0,0,51,108,21,25,123
1985,Jay Vincent,PF,25,DAL,79,2543,545,1138,0,4,545,1134,351,420,1441
1985,Danny Vranes,SF,26,SEA,76,2163,186,402,1,4,185,398,67,127,440
1985,Granville Waiters,C,24,IND,62,703,85,190,0,1,85,189,29,50,199
1985,Darrell Walker,PG,23,NYK,82,2489,430,989,0,17,430,972,243,347,1103
1985,Bill Walton*,C,32,LAC,67,1647,269,516,0,2,269,514,138,203,676
1985,Bryan Warrick,PG,25,LAC,58,713,85,173,1,4,84,169,44,57,215
1985,Scott Wedman,SF,32,BOS,78,1127,220,460,17,34,203,426,42,55,499
1985,Mark West,C,24,TOT,66,888,106,194,0,1,106,193,43,87,255
1985,Mark West,C,24,MIL,1,6,0,1,0,0,0,1,2,2,2
1985,Mark West,C,24,CLE,65,882,106,193,0,1,106,192,41,85,253
1985,Ennis Whatley,PG,22,CHI,70,1385,140,313,1,9,139,304,68,86,349
1985,Rory White,PF,25,LAC,80,1106,144,279,0,0,144,279,90,130,378
1985,Willie White,SG,22,DEN,39,234,52,124,4,11,48,113,21,31,129
1985,Jerome Whitehead,C,28,GSW,79,2536,421,825,0,0,421,825,184,235,1026
1985,Mitchell Wiggins,SG,25,HOU,82,1575,318,657,6,23,312,634,96,131,738
1985,Jamaal Wilkes*,SF,31,LAL,42,761,148,303,0,1,148,302,51,66,347
1985,Dominique Wilkins*,SF,25,ATL,81,3023,853,1891,25,81,828,1810,486,603,2217
1985,Eddie Lee,C,22,NYK,54,917,116,233,0,2,116,231,66,122,298
1985,Jeff Wilkins,C,29,UTA,79,1505,285,582,0,1,285,581,61,80,631
1985,Dale Wilkinson,SF-PF,24,TOT,12,45,4,16,0,1,4,15,6,7,14
1985,Dale Wilkinson,PF,24,DET,2,7,0,2,0,0,0,2,0,0,0
1985,Dale Wilkinson,SF,24,LAC,10,38,4,14,0,1,4,13,6,7,14
1985,Buck Williams,PF,24,NJN,82,3182,577,1089,1,4,576,1085,336,538,1491
1985,Gus Williams,PG,31,WSB,79,2960,638,1483,51,176,587,1307,251,346,1578
1985,Guy Williams,SF,24,WSB,21,119,29,63,1,4,28,59,2,5,61
1985,Herb Williams,C,26,IND,75,2557,575,1211,1,9,574,1202,224,341,1375
1985,Kevin Williams,SG,23,CLE,46,413,58,134,0,5,58,129,47,64,163
1985,Ray Williams,PG,30,BOS,23,459,55,143,6,23,49,120,31,46,147
1985,Sam Williams,PF,25,PHI,46,488,58,148,0,1,58,147,28,47,144
1985,Sly Williams,SF,27,ATL,34,867,167,380,4,15,163,365,79,123,417
1985,Kevin Willis,PF,22,ATL,82,1785,322,690,2,9,320,681,119,181,765
1985,Michael Wilson,SG,25,TOT,19,267,36,77,0,0,36,77,27,36,99
1985,Michael Wilson,SG,25,CLE,11,175,27,54,0,0,27,54,23,30,77
1985,Michael Wilson,SG,25,NJN,8,92,9,23,0,0,9,23,4,6,22
1985,Othell Wilson,PG,23,GSW,74,1260,134,291,3,16,131,275,54,76,325
1985,Randy Wittman,SG,25,ATL,41,1168,187,352,2,7,185,345,30,41,406
1985,Al Wood,SG,26,SEA,80,2545,515,1061,7,33,508,1028,166,214,1203
1985,Leon Wood,PG,22,PHI,38,269,50,134,4,30,46,104,18,26,122
1985,Mike Woodson,SG,26,KCK,78,1998,530,1068,5,21,525,1047,264,330,1329
1985,Orlando Woolridge,SF,25,CHI,77,2816,679,1225,0,5,679,1220,409,521,1767
1985,James Worthy*,SF,23,LAL,80,2696,610,1066,0,7,610,1059,190,245,1410
1985,Danny Young,PG,22,SEA,3,26,2,10,0,1,2,9,0,0,4
1985,Michael Young,SF,24,PHO,2,11,2,6,0,1,2,5,0,0,4
,,,,,,,,,,,,,,,
1986,Kareem Abdul-Jabbar*,C,38,LAL,79,2629,755,1338,0,2,755,1336,336,439,1846
1986,Alvan Adams,C,31,PHO,78,2005,341,679,0,2,341,677,159,203,841
1986,Michael Adams,PG,23,SAC,18,139,16,44,0,3,16,41,8,12,40
1986,Mark Aguirre,SF,26,DAL,74,2501,668,1327,16,56,652,1271,318,451,1670
1986,Danny Ainge,SG,26,BOS,80,2407,353,701,26,73,327,628,123,136,855
1986,Ron Anderson,SF,27,TOT,77,1676,310,628,2,9,308,619,85,127,707
1986,Ron Anderson,SF,27,CLE,17,207,37,74,0,1,37,73,12,16,86
1986,Ron Anderson,SF,27,IND,60,1469,273,554,2,8,271,546,73,111,621
1986,John Bagley,PG,25,CLE,78,2472,366,865,9,37,357,828,170,215,911
1986,James Bailey,PF,28,NYK,48,1245,202,443,0,4,202,439,129,167,533
1986,Thurl Bailey,PF,24,UTA,82,2358,483,1077,0,7,483,1070,230,277,1196
1986,Greg Ballard,SF,31,GSW,75,1792,272,570,17,35,255,535,101,126,662
1986,Gene Banks,SF,26,CHI,82,2139,356,688,0,19,356,669,183,255,895
1986,Ken Bannister,PF,25,NYK,70,1405,235,479,0,1,235,478,131,249,601
1986,Charles Barkley*,PF,22,PHI,80,2952,595,1041,17,75,578,966,396,578,1603
1986,John Battle,SG,23,ATL,64,639,101,222,0,7,101,215,75,103,277
1986,Benoit Benjamin,C,21,LAC,79,2088,324,661,1,3,323,658,229,307,878
1986,Kent Benson,C,31,DET,72,1344,201,415,1,2,200,413,66,83,469
1986,Larry Bird*,SF,29,BOS,82,3113,796,1606,82,194,714,1412,441,492,2115
1986,Otis Birdsong,SG,30,NJN,77,2395,542,1056,8,22,534,1034,122,210,1214
1986,Uwe Blab,C,23,DAL,48,409,44,94,0,0,44,94,36,67,124
1986,Rolando Blackman,SG,26,DAL,82,2787,677,1318,4,29,673,1289,404,483,1762
1986,Manute Bol,C,23,WSB,80,2090,128,278,0,1,128,277,42,86,298
1986,Sam Bowie,C,24,POR,38,1132,167,345,0,0,167,345,114,161,448
1986,Dudley Bradley,SG,28,WSB,70,842,73,209,17,68,56,141,32,56,195
1986,Mike Bratz,PG,30,SAC,33,269,26,70,4,14,22,56,14,18,70
1986,Randy Breuer,C,25,MIL,82,1792,272,570,0,1,272,569,141,198,685
1986,Ron Brewer,SG,30,TOT,44,570,86,224,5,17,81,207,34,38,211
1986,Ron Brewer,SG,30,CHI,4,18,3,9,0,0,3,9,1,1,7
1986,Ron Brewer,SG,30,CLE,40,552,83,215,5,17,78,198,33,37,204
1986,Frank Brickowski,C,26,SEA,40,311,30,58,0,0,30,58,18,27,78
1986,Junior Bridgeman,SF,32,LAC,58,1161,199,451,6,18,193,433,106,119,510
1986,Mike Brittain,C,22,SAS,32,219,22,43,0,0,22,43,10,19,54
1986,Tony Brown,SG,25,CHI,10,132,18,41,0,2,18,39,9,13,45
1986,Wallace Bryant,C,26,TOT,17,218,15,48,0,0,15,48,11,19,41
1986,Wallace Bryant,C,26,DAL,9,154,11,30,0,0,11,30,6,11,28
1986,Wallace Bryant,C,26,LAC,8,64,4,18,0,0,4,18,5,8,13
1986,Quinn Buckner,PG,31,IND,32,419,49,104,0,1,49,103,19,27,117
1986,Michael Cage,PF,24,LAC,78,1566,204,426,0,3,204,423,113,174,521
1986,Tony Campbell,SF,23,DET,82,1292,294,608,2,9,292,599,58,73,648
1986,Rick Carlisle,SG,26,BOS,77,760,92,189,0,10,92,179,15,23,199
1986,Antoine Carr,PF,24,ATL,17,258,49,93,0,0,49,93,18,27,116
1986,Kenny Carr,PF,30,POR,55,1557,232,466,0,4,232,462,149,217,613
1986,Joe Barry,C,27,GSW,79,2801,650,1404,0,2,650,1402,377,501,1677
1986,Butch Carter,SG,27,TOT,9,67,7,24,0,1,7,23,6,7,20
1986,Butch Carter,SG,27,NYK,5,31,2,8,0,1,2,7,1,1,5
1986,Butch Carter,SG,27,PHI,4,36,5,16,0,0,5,16,5,6,15
1986,Bill Cartwright,C,28,NYK,2,36,3,7,0,0,3,7,6,10,12
1986,Terry Catledge,PF,22,PHI,64,1092,202,431,0,4,202,427,90,139,494
1986,Bobby Cattage,PF,27,NJN,29,185,28,83,1,5,27,78,35,44,92
1986,Tom Chambers,PF,26,SEA,66,2019,432,928,13,48,419,880,346,414,1223
1986,Lorenzo Charles,SF,22,ATL,36,273,49,88,0,0,49,88,24,36,122
1986,Maurice Cheeks,PG,29,PHI,82,3270,490,913,4,17,486,896,282,335,1266
1986,Fred Cofield,PG,24,NYK,45,469,75,184,3,15,72,169,12,20,165
1986,Steve Colter,PG,23,POR,81,1868,272,597,27,83,245,514,135,164,706
1986,Lester Conner,PG,26,GSW,36,413,51,136,2,7,49,129,40,54,144
1986,Darwin Cook,PG,27,NJN,79,1965,267,627,11,53,256,574,84,111,629
1986,Jeff Cook,PF,29,TOT,36,373,31,73,0,1,31,72,27,42,89
1986,Jeff Cook,PF,29,SAS,34,356,28,67,0,1,28,66,26,41,82
1986,Jeff Cook,PF,29,UTA,2,17,3,6,0,0,3,6,1,1,7
1986,David Cooke,PF,22,SAC,6,38,2,11,0,0,2,11,5,10,9
1986,Michael Cooper,SG,29,LAL,82,2269,274,606,63,163,211,443,147,170,758
1986,Wayne Cooper,C,29,DEN,78,2112,422,906,3,7,419,899,174,219,1021
1986,Tyrone Corbin,SF,23,SAS,16,174,27,64,0,1,27,63,10,14,64
1986,Dave Corzine,C,29,CHI,67,1709,255,519,3,12,252,507,127,171,640
1986,Ron Crevier,C,27,TOT,3,4,0,3,0,0,0,3,0,2,0
1986,Ron Crevier,C,27,GSW,1,1,0,1,0,0,0,1,0,0,0
1986,Ron Crevier,C,27,DET,2,3,0,2,0,0,0,2,0,2,0
1986,Jeff Cross,PF,24,LAC,21,128,6,24,0,0,6,24,14,25,26
1986,Pat Cummings,C,29,NYK,31,1007,195,408,0,2,195,406,97,139,487
1986,Terry Cummings,PF,24,MIL,82,2669,681,1438,0,2,681,1436,265,404,1627
1986,Earl Cureton,PF,28,DET,80,2017,285,564,0,2,285,562,117,211,687
1986,Quintin Dailey,SG,25,CHI,35,723,203,470,0,8,203,462,163,198,569
1986,Adrian Dantley*,SF,29,UTA,76,2744,818,1453,1,11,817,1442,630,796,2267
1986,Brad Davis,PG,30,DAL,82,1971,267,502,32,89,235,413,198,228,764
1986,Charles Davis,SF,27,MIL,57,873,188,397,3,24,185,373,61,75,440
1986,Johnny Davis,SG,30,TOT,66,1014,148,344,3,13,145,331,118,138,417
1986,Johnny Davis,SG,30,CLE,39,612,102,237,2,11,100,226,67,79,273
1986,Johnny Davis,SG,30,ATL,27,402,46,107,1,2,45,105,51,59,144
1986,Walter Davis,SG,31,PHO,70,2239,624,1287,18,76,606,1211,257,305,1523
1986,Darryl Dawkins,C,29,NJN,51,1207,284,441,0,1,284,440,210,297,778
1986,Darren Daye,SF,25,WSB,64,1075,198,399,1,3,197,396,159,237,556
1986,James Donaldson,C,28,TOT,83,2682,256,459,0,0,256,459,204,254,716
1986,James Donaldson,C,28,LAC,14,441,43,84,0,0,43,84,57,70,143
1986,James Donaldson,C,28,DAL,69,2241,213,375,0,0,213,375,147,184,573
1986,Larry Drew,PG,27,SAC,75,1971,376,776,10,31,366,745,128,161,890
1986,Clyde Drexler*,SG,23,POR,75,2576,542,1142,12,60,530,1082,293,381,1389
1986,Joe Dumars*,SG,22,DET,82,1957,287,597,5,16,282,581,190,238,769
1986,T.R. Dunn,SG,30,DEN,82,2401,172,379,0,1,172,378,68,88,412
1986,Devin Durrant,SF,25,PHO,4,51,8,21,0,0,8,21,1,4,17
1986,Mark Eaton,C,29,UTA,80,2551,277,589,0,0,277,589,122,202,676
1986,Franklin Edwards,PG,26,LAC,73,1491,262,577,1,9,261,568,132,151,657
1986,James Edwards,C,30,PHO,52,1314,318,587,0,0,318,587,212,302,848
1986,Craig Ehlo,SG,24,HOU,36,199,36,84,3,9,33,75,23,29,98
1986,Dale Ellis,SF,25,DAL,72,1086,193,470,63,173,130,297,59,82,508
1986,Alex English*,SF,32,DEN,81,3024,951,1888,1,5,950,1883,511,593,2414
1986,Julius Erving*,SF,35,PHI,74,2474,521,1085,9,32,512,1053,289,368,1340
1986,Mike Evans,PG,30,DEN,81,1389,304,715,39,176,265,539,126,149,773
1986,Patrick Ewing*,C,23,NYK,50,1771,386,814,0,5,386,809,226,306,998
1986,Kenny Fields,SF,23,MIL,78,1120,204,398,0,4,204,394,91,132,499
1986,Vern Fleming,PG,23,IND,80,2870,436,862,1,6,435,856,263,353,1136
1986,Sleepy Floyd,PG,25,GSW,82,2764,510,1007,39,119,471,888,351,441,1410
1986,Rod Foster,PG,25,PHO,48,704,85,218,9,32,76,186,23,32,202
1986,World B.,SG,32,CLE,75,2535,652,1433,71,169,581,1264,379,486,1754
1986,Bill Garnett,PF,25,IND,80,1197,112,239,0,2,112,237,116,162,340
1986,George Gervin*,SG,33,CHI,82,2065,519,1100,4,19,515,1081,283,322,1325
1986,Mike Gibson,PF,25,DET,32,161,20,51,0,0,20,51,8,11,48
1986,Artis Gilmore*,C,36,SAS,71,2395,423,684,0,1,423,683,338,482,1184
1986,Mike Glenn,SG,30,MIL,38,573,94,190,0,0,94,190,47,49,235
1986,Georgi Glouchkov,PF,26,PHO,49,772,84,209,1,1,83,208,70,122,239
1986,Mike Gminski,C,26,NJN,81,2525,491,949,0,1,491,948,351,393,1333
1986,Lancaster Gordon,SG,23,LAC,60,704,130,345,7,28,123,317,45,56,312
1986,Stuart Gray,C,22,IND,67,423,54,108,0,0,54,108,47,74,155
1986,A.C. Green,PF,22,LAL,82,1542,209,388,1,6,208,382,102,167,521
1986,Ken Green,PF,26,NYK,7,72,13,27,0,0,13,27,5,9,31
1986,Kenny Green,SF,21,TOT,41,453,83,192,0,1,83,191,35,49,201
1986,Kenny Green,SF,21,WSB,20,221,44,101,0,1,44,100,21,26,109
1986,Kenny Green,SF,21,PHI,21,232,39,91,0,0,39,91,14,23,92
1986,Rickey Green,PG,31,UTA,80,2012,357,758,5,29,352,729,213,250,932
1986,Sidney Green,PF,25,CHI,80,2307,407,875,0,8,407,867,262,335,1076
1986,Dave Greenwood,PF,28,SAS,68,1910,198,388,0,1,198,387,142,184,538
1986,Claude Gregory,PF,27,WSB,2,2,1,2,0,0,1,2,0,0,2
1986,Ernie Grunfeld,SF,30,NYK,76,1402,148,355,26,61,122,294,90,108,412
1986,Petur Gudmundsson,C,27,LAL,8,128,20,37,0,0,20,37,18,27,58
1986,Bob Hansen,SG,25,UTA,82,2032,299,628,17,50,282,578,95,132,710
1986,Bill Hanzlik,SF,28,DEN,79,1982,331,741,8,41,323,700,318,405,988
1986,Derek Harper,PG,24,DAL,79,2150,390,730,12,51,378,679,171,229,963
1986,Steve Harris,SG,22,HOU,57,482,103,233,1,5,102,228,50,54,257
1986,Scott Hastings,PF,25,ATL,62,650,65,159,3,4,62,155,60,70,193
1986,Steve Hayes,C,30,UTA,58,397,39,87,0,0,39,87,11,36,89
1986,Gerald Henderson,PG,30,SEA,82,2568,434,900,18,52,416,848,185,223,1071
1986,Jerome Henderson,C,26,LAL,1,3,2,3,0,0,2,3,0,0,4
1986,Carl Henry,SG,25,SAC,28,149,31,67,4,10,27,57,12,17,78
1986,Rod Higgins,SF,26,TOT,30,332,39,106,1,9,38,97,19,27,98
1986,Rod Higgins,SF,26,SEA,12,94,9,27,1,4,8,23,3,5,22
1986,Rod Higgins,SF,26,SAS,11,128,18,40,0,2,18,38,11,16,47
1986,Rod Higgins,SF,26,NJN,2,29,3,16,0,2,3,14,0,0,6
1986,Rod Higgins,SF,26,CHI,5,81,9,23,0,1,9,22,5,6,23
1986,Roy Hinson,SF,24,CLE,82,2834,621,1167,0,4,621,1163,364,506,1606
1986,Craig Hodges,SG,25,MIL,66,1739,284,568,73,162,211,406,75,86,716
1986,Mike Holton,PG-SG,24,TOT,28,512,77,175,1,12,76,163,28,44,183
1986,Mike Holton,SG,24,PHO,4,65,4,20,0,2,4,18,4,6,12
1986,Mike Holton,PG,24,CHI,24,447,73,155,1,10,72,145,24,38,171
1986,Phil Hubbard,SF,29,CLE,23,640,93,198,0,1,93,197,76,112,262
1986,Alfredrick Hughes,SG,23,SAS,68,866,152,372,3,17,149,355,49,84,356
1986,Jay Humphries,PG,23,PHO,82,2733,352,735,4,29,348,706,197,257,905
1986,Geoff Huston,PG,28,GSW,82,1208,140,273,2,6,138,267,63,92,345
1986,Marc Iavaroni,PF,29,TOT,68,1014,110,244,0,2,110,242,76,115,296
1986,Marc Iavaroni,PF,29,SAS,42,669,74,163,0,2,74,161,43,67,191
1986,Marc Iavaroni,PF,29,UTA,26,345,36,81,0,0,36,81,33,48,105
1986,Clemon Johnson,C,29,PHI,75,1069,105,223,0,0,105,223,51,81,261
1986,Dennis Johnson*,PG,31,BOS,78,2732,482,1060,6,42,476,1018,243,297,1213
1986,Eddie Johnson,SF,26,SAC,82,2514,623,1311,4,20,619,1291,280,343,1530
1986,Eddie Johnson,SG,30,TOT,71,1477,284,621,29,85,255,536,112,155,709
1986,Eddie Johnson,SG,30,ATL,39,862,155,328,5,20,150,308,79,110,394
1986,Eddie Johnson,SG,30,CLE,32,615,129,293,24,65,105,228,33,45,315
1986,Frank Johnson,PG,27,WSB,14,402,69,154,0,3,69,151,38,54,176
1986,George Johnson,C,37,SEA,41,264,12,23,0,0,12,23,11,16,35
1986,George Johnson,PF,29,WSB,2,7,1,3,0,0,1,3,2,2,4
1986,Ken Johnson,PF,23,POR,64,815,113,214,0,0,113,214,37,85,263
1986,Magic Johnson*,PG,26,LAL,72,2578,483,918,10,43,473,875,378,434,1354
1986,Marques Johnson,SG,29,LAC,75,2605,613,1201,1,15,612,1186,298,392,1525
1986,Mickey Johnson,PF,33,NJN,79,1574,214,507,5,24,209,483,183,233,616
1986,Steve Johnson,C,28,SAS,71,1828,362,573,0,0,362,573,259,373,983
1986,Vinnie Johnson,SG,29,DET,79,1978,465,996,2,13,463,983,165,214,1097
1986,Bobby Jones,PF,34,PHI,70,1519,189,338,0,1,189,337,114,145,492
1986,Caldwell Jones,C,35,POR,80,1437,126,254,0,7,126,247,124,150,376
1986,Charles Jones,C,28,WSB,81,1609,129,254,0,1,129,253,54,86,312
1986,Charles Jones,PF,24,PHO,43,742,75,164,0,1,75,163,50,98,200
1986,Earl Jones,C,25,MIL,12,43,5,12,0,0,5,12,3,4,13
1986,Edgar Jones,PF,29,CLE,53,1011,187,370,7,23,180,347,132,178,513
1986,Ozell Jones,C,25,LAC,3,18,0,2,0,0,0,2,0,0,0
1986,Michael Jordan*,SG,22,CHI,18,451,150,328,3,18,147,310,105,125,408
1986,Yvon Joseph,C,28,NJN,1,5,0,0,0,0,0,0,2,2,2
1986,Harold Keeling,SG,22,DAL,20,75,17,39,0,0,17,39,10,14,44
1986,Rich Kelley,C,32,SAC,37,324,28,49,0,2,28,47,18,22,74
1986,Clark Kellogg,PF,24,IND,19,568,139,294,4,13,135,281,53,69,335
1986,Jerome Kersey,SF,23,POR,79,1217,258,470,0,6,258,464,156,229,672
1986,Albert King,SF,26,NJN,73,1998,438,961,4,23,434,938,167,203,1047
1986,Greg Kite,C,24,BOS,64,464,34,91,0,1,34,90,15,39,83
1986,Joe Kleine,C,24,SAC,80,1180,160,344,0,0,160,344,94,130,414
1986,Jon Koncak,C,22,ATL,82,1695,263,519,0,1,263,518,156,257,682
1986,Mitch Kupchak,PF,31,LAL,55,783,124,257,0,1,124,256,84,112,332
1986,Bill Laimbeer,C,28,DET,82,2891,545,1107,4,14,541,1093,266,319,1360
1986,Jeff Lamp,SF,26,TOT,74,1321,245,514,7,30,238,484,111,133,608
1986,Jeff Lamp,SF,26,MIL,44,701,109,243,3,13,106,230,55,64,276
1986,Jeff Lamp,SF,26,SAS,30,620,136,271,4,17,132,254,56,69,332
1986,Allen Leavell,PG,28,HOU,74,1190,212,458,24,67,188,391,135,158,583
1986,Keith Lee,PF,23,CLE,58,1197,177,380,2,9,175,371,75,96,431
1986,Ronnie Lester,PG,27,LAL,27,222,26,52,0,3,26,49,15,19,67
1986,Fat Lever,PG,25,DEN,78,2616,468,1061,12,38,456,1023,132,182,1080
1986,Cliff Levingston,PF,25,ATL,81,1945,294,551,0,1,294,550,164,242,752
1986,Alton Lister,C,27,MIL,81,1812,318,577,0,2,318,575,160,266,796
1986,Lewis Lloyd,SG,26,HOU,82,2444,592,1119,3,15,589,1104,199,236,1386
1986,John Long,SG,29,DET,62,1176,264,548,3,16,261,532,89,104,620
1986,John Lucas,PG,32,HOU,65,2120,365,818,45,146,320,672,231,298,1006
1986,Maurice Lucas,PF,33,LAL,77,1750,302,653,1,2,301,651,180,230,785
1986,Kyle Macy,PG,28,CHI,82,2426,286,592,58,141,228,451,73,90,703
1986,Rick Mahorn,PF,27,DET,80,1442,157,345,0,1,157,344,81,119,395
1986,Jeff Malone,SG,24,WSB,80,2992,735,1522,3,17,732,1505,322,371,1795
1986,Karl Malone*,PF,22,UTA,81,2475,504,1016,0,2,504,1014,195,405,1203
1986,Moses Malone*,C,30,PHI,74,2706,571,1246,0,1,571,1245,617,784,1759
1986,Pace Mannion,SF,25,UTA,57,673,97,214,8,42,89,172,53,82,255
1986,Bill Martin,SF,23,IND,66,691,143,298,0,8,143,290,46,54,332
1986,Brian Martin,SF-PF,23,TOT,8,21,3,7,0,0,3,7,0,2,6
1986,Brian Martin,PF,23,SEA,3,7,1,2,0,0,1,2,0,0,2
1986,Brian Martin,SF,23,POR,5,14,2,5,0,0,2,5,0,2,4
1986,Wes Matthews,PG,26,SAS,75,1853,320,603,4,25,316,578,173,211,817
1986,Cedric Maxwell,SF,30,LAC,76,2458,314,661,0,3,314,658,447,562,1075
1986,Bob McAdoo*,C,34,PHI,29,609,116,251,0,0,116,251,62,81,294
1986,Dwayne McClain,SF,22,IND,45,461,69,180,1,9,68,171,18,35,157
1986,Tim McCormick,C,23,SEA,77,1705,253,444,1,2,252,442,174,244,681
1986,Rodney McCray,SF,24,HOU,82,2610,338,629,0,3,338,626,171,222,847
1986,Xavier McDaniel,SF,22,SEA,82,2706,576,1176,2,10,574,1166,250,364,1404
1986,Ben McDonald,SF,23,CLE,21,266,28,58,0,1,28,57,5,8,61
1986,Hank McDowell,PF,26,HOU,22,204,24,42,0,1,24,41,17,25,65
1986,Mike McGee,SF,26,LAL,71,1213,252,544,41,114,211,430,42,64,587
1986,Kevin McHale*,PF,28,BOS,68,2397,561,978,0,0,561,978,326,420,1448
1986,Kevin McKenna,SG,27,WSB,30,430,61,166,27,75,34,91,25,30,174
1986,Billy McKinney,PG,30,CHI,9,83,10,23,0,0,10,23,2,2,22
1986,Tom McMillen,C,33,WSB,56,863,131,285,0,3,131,282,64,79,326
1986,Chris McNealy,PF,24,NYK,30,627,70,144,0,0,70,144,31,47,171
1986,Dirk Minniefield,PG,25,CLE,76,1131,167,347,10,37,157,310,73,93,417
1986,Mike Mitchell,SF,30,SAS,82,2970,802,1697,0,12,802,1685,317,392,1921
1986,Paul Mokeski,C,29,MIL,45,521,59,139,0,0,59,139,25,34,143
1986,Sidney Moncrief,PG,28,MIL,73,2567,470,962,33,103,437,859,498,580,1471
1986,Johnny Moore,PG,27,SAS,28,856,150,303,4,22,146,281,59,86,363
1986,Perry Moss,PG,27,TOT,72,1012,116,292,7,32,109,260,65,89,304
1986,Perry Moss,PG,27,WSB,12,160,21,53,2,7,19,46,11,15,55
1986,Perry Moss,PG,27,PHI,60,852,95,239,5,25,90,214,54,74,249
1986,Chris Mullin*,SG,22,GSW,55,1391,287,620,5,27,282,593,189,211,768
1986,Jay Murphy,SF,23,LAC,14,100,16,45,0,2,16,43,9,14,41
1986,Larry Nance,PF,26,PHO,73,2484,582,1001,0,8,582,993,310,444,1474
1986,Calvin Natt,PF,29,DEN,69,2007,469,930,2,6,467,924,278,347,1218
1986,Chuck Nevitt,C,26,TOT,29,126,15,43,0,0,15,43,19,26,49
1986,Chuck Nevitt,C,26,LAL,4,25,3,11,0,0,3,11,4,6,10
1986,Chuck Nevitt,C,26,DET,25,101,12,32,0,0,12,32,15,20,39
1986,Kurt Nimphius,PF,27,TOT,80,2226,351,694,0,3,351,691,194,262,896
1986,Kurt Nimphius,PF,27,DAL,13,280,37,72,0,1,37,71,17,29,91
1986,Kurt Nimphius,PF,27,LAC,67,1946,314,622,0,2,314,620,177,233,805
1986,Norm Nixon,PG,30,LAC,67,2138,403,921,42,121,361,800,131,162,979
1986,Mike O'Koren,SF,27,NJN,67,1031,160,336,7,27,153,309,23,39,350
1986,Charles Oakley,PF,22,CHI,77,1772,281,541,0,3,281,538,178,269,740
1986,Hakeem Olajuwon*,C,23,HOU,68,2467,625,1188,0,0,625,1188,347,538,1597
1986,Mark Olberding,PF,29,SAC,81,2157,225,403,0,2,225,401,162,210,612
1986,Jawann Oldham,C,28,CHI,52,1276,167,323,0,1,167,322,53,91,387
1986,Louis Orr,SF,27,NYK,74,2237,330,741,0,4,330,737,218,278,878
1986,Robert Parish*,C,32,BOS,81,2567,530,966,0,0,530,966,245,335,1305
1986,Jim Paxson,SG,28,POR,75,1931,372,792,20,62,352,730,217,244,981
1986,John Paxson,PG,25,CHI,75,1570,153,328,15,50,138,278,74,92,395
1986,Sam Perkins,PF,24,DAL,80,2626,458,910,11,33,447,877,307,377,1234
1986,Jim Petersen,PF,23,HOU,82,1664,196,411,0,3,196,408,113,160,505
1986,Michael Phelps,SG,24,SEA,70,880,117,286,1,12,116,274,44,74,279
1986,Ricky Pierce,SG,26,MIL,81,2147,429,798,3,23,426,775,266,310,1127
1986,Ed Pinckney,SF,22,PHO,80,1602,255,457,0,2,255,455,171,254,681
1986,Charles Pittman,PF,27,PHO,69,1132,127,218,0,0,127,218,99,141,353
1986,David Pope,SF,23,SEA,11,74,9,20,1,1,8,19,2,4,21
1986,Ben Poquette,PF,30,CLE,81,1496,166,348,2,10,164,338,72,100,406
1986,Terry Porter,PG,22,POR,79,1214,212,447,13,42,199,405,125,155,562
1986,Paul Pressey,SF,27,MIL,80,2704,411,843,8,44,403,799,316,392,1146
1986,Kurt Rambis,PF,27,LAL,74,1573,160,269,0,0,160,269,88,122,408
1986,Kelvin Ransey,PG,27,NJN,79,1504,231,505,3,24,228,481,121,148,586
1986,Blair Rasmussen,C,23,DEN,48,330,61,150,0,0,61,150,31,39,153
1986,Robert Reid,SF,30,HOU,82,2157,409,881,6,33,403,848,162,214,986
1986,Jerry Reynolds,SF,23,MIL,55,508,72,162,1,2,71,160,58,104,203
1986,Clint Richardson,SG,29,IND,82,2224,335,736,1,9,334,727,123,147,794
1986,Micheal Ray,PG,30,NJN,47,1604,296,661,4,27,292,634,141,179,737
1986,Doc Rivers,PG,24,ATL,53,1571,220,464,0,16,220,448,172,283,612
1986,Fred Roberts,PF,25,UTA,58,469,74,167,1,2,73,165,67,87,216
1986,Alvin Robertson,SG,23,SAS,82,2878,562,1093,8,29,554,1064,260,327,1392
1986,Rick Robey,C,30,PHO,46,629,72,191,0,3,72,188,33,48,177
1986,Cliff Robinson,SF,25,WSB,78,2563,595,1255,1,4,594,1251,269,353,1460
1986,Tree Rollins,C,30,ATL,74,1781,173,347,0,1,173,346,69,90,415
1986,Dan Roundfield,PF,32,WSB,79,2321,322,660,0,6,322,654,273,362,917
1986,Derrick Rowland,SG,26,MIL,2,9,1,3,0,0,1,3,1,2,3
1986,Jeff Ruland,PF,27,WSB,30,1114,212,383,0,4,212,379,145,200,569
1986,Walker Russell,PG,25,DET,1,2,0,1,0,0,0,1,0,0,0
1986,Ralph Sampson*,PF,25,HOU,79,2864,624,1280,2,15,622,1265,241,376,1491
1986,Mike Sanders,SF,25,PHO,82,1644,347,676,3,15,344,661,208,257,905
1986,Danny Schayes,C,26,DEN,80,1654,221,440,0,1,221,439,216,278,658
1986,Detlef Schrempf,SF,23,DAL,64,969,142,315,3,7,139,308,110,152,397
1986,Byron Scott,SG,24,LAL,76,2190,507,989,22,61,485,928,138,176,1174
1986,Carey Scurry,SF,23,UTA,78,1168,142,301,1,11,141,290,78,126,363
1986,Lonnie Shelton,PF,30,CLE,44,682,92,188,0,2,92,186,14,16,198
1986,Purvis Short,SF,28,GSW,64,2427,633,1313,15,49,618,1264,351,406,1632
1986,Jerry Sichting,PG,29,BOS,82,1596,235,412,6,16,229,396,61,66,537
1986,Jack Sikma,C,30,SEA,80,2790,508,1100,0,13,508,1087,355,411,1371
1986,Derek Smith,SG,24,LAC,11,339,100,181,1,2,99,179,58,84,259
1986,Larry Smith,PF,28,GSW,77,2441,314,586,0,1,314,585,112,227,740
1986,Mike Smrek,C,23,CHI,38,408,46,122,0,2,46,120,16,29,108
1986,Ricky Sobers,SG,33,SEA,78,1279,240,541,13,43,227,498,110,125,603
1986,Rory Sparrow,PG,27,NYK,74,2344,345,723,5,20,340,703,101,127,796
1986,Larry Spriggs,SF,26,LAL,43,471,88,192,0,1,88,191,38,49,214
1986,Terence Stansbury,SG,24,IND,74,1331,191,441,9,53,182,388,107,132,498
1986,Steve Stipanovich,C,25,IND,79,2397,416,885,2,10,414,875,242,315,1076
1986,Alex Stivrins,SF,23,SEA,3,14,1,4,0,0,1,4,1,4,3
1986,John Stockton*,PG,23,UTA,82,1935,228,466,2,15,226,451,172,205,630
1986,Greg Stokes,PF,22,PHI,31,350,56,119,0,1,56,118,14,21,126
1986,Jon Sundvold,PG,24,SAS,70,1150,220,476,21,60,199,416,39,48,500
1986,Terry Teagle,SG,25,GSW,82,2158,475,958,4,25,471,933,211,265,1165
1986,Reggie Theus,SG,28,SAC,82,2919,546,1137,6,35,540,1102,405,490,1503
1986,Peter Thibeaux,SF,24,GSW,42,531,100,233,2,5,98,228,29,48,231
1986,David Thirdkill,PF,25,BOS,49,385,54,110,0,1,54,109,55,88,163
1986,Isiah Thomas*,PG,24,DET,77,2790,609,1248,26,84,583,1164,365,462,1609
1986,Jim Thomas,SG,25,LAC,6,69,6,15,0,0,6,15,1,2,13
1986,Bernard Thompson,SG,23,PHO,61,1281,195,399,0,2,195,397,127,157,517
1986,LaSalle Thompson,C,24,SAC,80,2377,411,794,0,1,411,793,202,276,1024
1986,Mychal Thompson,C,31,POR,82,2569,503,1011,0,0,503,1011,198,309,1204
1986,Paul Thompson,SF,24,PHI,23,432,70,194,2,12,68,182,37,43,179
1986,Bob Thornton,PF,23,NYK,71,1323,125,274,0,0,125,274,86,162,336
1986,Otis Thorpe,PF,23,SAC,75,1675,289,492,0,0,289,492,164,248,742
1986,Sedale Threatt,SG,24,PHI,70,1754,310,684,1,24,309,660,75,90,696
1986,Wayman Tisdale,PF,21,IND,81,2277,516,1002,0,2,516,1000,160,234,1192
1986,Andrew Toney,SG,28,PHI,6,84,11,36,0,2,11,34,3,8,25
1986,Sedric Toney,PG,23,TOT,13,230,28,66,3,10,25,56,21,31,80
1986,Sedric Toney,PG,23,ATL,3,24,2,7,0,0,2,7,1,1,5
1986,Sedric Toney,PG,23,PHO,10,206,26,59,3,10,23,49,20,30,75
1986,Kelly Tripucka,SF,26,DET,81,2626,615,1236,12,25,603,1211,380,444,1622
1986,Trent Tucker,SG,26,NYK,77,1788,349,740,41,91,308,649,79,100,818
1986,Elston Turner,SG,26,DEN,73,1324,165,379,0,9,165,370,39,53,369
1986,Jeff Turner,PF,23,NJN,53,650,84,171,0,1,84,170,58,78,226
1986,Melvin Turpin,C,25,CLE,80,2292,456,838,0,4,456,834,185,228,1097
1986,Terry Tyler,SF,29,SAC,71,1651,295,649,0,3,295,646,84,112,674
1986,Darnell Valentine,PG,26,TOT,62,1217,161,388,4,14,157,374,130,175,456
1986,Darnell Valentine,PG,26,POR,28,734,92,206,1,3,91,203,71,100,256
1986,Darnell Valentine,PG,26,LAC,34,483,69,182,3,11,66,171,59,75,200
1986,Kiki Vandeweghe,SF,27,POR,79,2791,719,1332,1,8,718,1324,523,602,1962
1986,Nick Vanos,C,22,PHO,11,202,23,72,0,0,23,72,8,23,54
1986,Pete Verhoeven,PF,26,GSW,61,749,90,167,1,2,89,165,25,43,206
1986,Jay Vincent,PF,26,DAL,80,1994,442,919,0,3,442,916,222,274,1106
1986,Sam Vincent,SG,22,BOS,57,432,59,162,1,4,58,158,65,70,184
1986,Danny Vranes,SF,27,SEA,80,1569,131,284,0,4,131,280,39,75,301
1986,Granville Waiters,C,25,HOU,43,156,13,39,0,1,13,38,1,6,27
1986,Darrell Walker,PG,24,NYK,81,2023,324,753,0,10,324,743,190,277,838
1986,Bill Walton*,C,33,BOS,80,1546,231,411,0,0,231,411,144,202,606
1986,Bryan Warrick,PG,26,TOT,36,685,85,182,3,12,82,170,54,68,227
1986,Bryan Warrick,PG,26,MIL,5,27,4,10,1,2,3,8,1,1,10
1986,Bryan Warrick,PG,26,IND,31,658,81,172,2,10,79,162,53,67,217
1986,Spud Webb,PG,22,ATL,79,1229,199,412,2,11,197,401,216,275,616
1986,Scott Wedman,SF,33,BOS,79,1402,286,605,17,48,269,557,45,68,634
1986,Bill Wennington,C,22,DAL,56,562,72,153,0,4,72,149,45,62,189
1986,Mark West,C,25,CLE,67,1172,113,209,0,0,113,209,54,103,280
1986,Ennis Whatley,PG,23,TOT,14,107,15,35,0,0,15,35,5,10,35
1986,Ennis Whatley,PG,23,CLE,8,66,9,19,0,0,9,19,4,7,22
1986,Ennis Whatley,PG,23,WSB,4,27,5,14,0,0,5,14,1,3,11
1986,Ennis Whatley,PG,23,SAS,2,14,1,2,0,0,1,2,0,0,2
1986,Rory White,SF,26,LAC,75,1761,355,684,1,9,354,675,164,222,875
1986,Willie White,SG,23,DEN,43,343,74,168,6,21,68,147,19,23,173
1986,Jerome Whitehead,C,29,GSW,81,1079,126,294,0,0,126,294,60,97,312
1986,Mitchell Wiggins,SG,26,HOU,78,1198,222,489,1,12,221,477,86,118,531
1986,Jamaal Wilkes*,SF,32,LAC,13,195,26,65,1,3,25,62,22,27,75
1986,Dominique Wilkins*,SF,26,ATL,78,3049,888,1897,13,70,875,1827,577,705,2366
1986,Gerald Wilkins,SG,22,NYK,81,2025,437,934,7,25,430,909,132,237,1013
1986,Jeff Wilkins,C,30,TOT,75,1126,147,374,0,0,147,374,58,93,352
1986,Jeff Wilkins,C,30,UTA,48,604,96,240,0,0,96,240,30,47,222
1986,Jeff Wilkins,C,30,SAS,27,522,51,134,0,0,51,134,28,46,130
1986,Buck Williams,PF,25,NJN,82,3070,500,956,0,2,500,954,301,445,1301
1986,Freeman Williams,SG,29,WSB,9,110,25,67,7,14,18,53,12,17,69
1986,Gus Williams,PG,32,WSB,77,2284,434,1013,30,116,404,897,138,188,1036
1986,Guy Williams,PF,25,GSW,5,25,2,5,0,0,2,5,3,6,7
1986,Herb Williams,C,27,IND,78,2770,627,1275,1,12,626,1263,294,403,1549
1986,Pete Williams,PF,20,DEN,53,573,67,111,0,0,67,111,17,40,151
1986,Ray Williams,PG,31,TOT,47,827,117,306,6,19,111,287,115,126,355
1986,Ray Williams,PG,31,ATL,19,367,57,143,4,11,53,132,41,48,159
1986,Ray Williams,PG,31,SAS,23,397,50,131,2,6,48,125,62,64,164
1986,Ray Williams,PG,31,NJN,5,63,10,32,0,2,10,30,12,14,32
1986,Sly Williams,SF,28,BOS,6,54,5,21,0,4,5,17,7,12,17
1986,Kevin Willis,PF,23,ATL,82,2300,419,811,0,6,419,805,172,263,1010
1986,Voise Winters,SF,23,PHI,4,17,3,13,0,1,3,12,0,0,6
1986,Randy Wittman,SG,26,ATL,81,2760,467,881,5,16,462,865,104,135,1043
1986,Al Wood,SG,27,SEA,78,1749,355,817,5,37,350,780,187,239,902
1986,Leon Wood,PG,23,TOT,68,1198,184,466,41,114,143,352,123,155,532
1986,Leon Wood,PG,23,PHI,29,455,57,136,13,29,44,107,27,34,154
1986,Leon Wood,PG,23,WSB,39,743,127,330,28,85,99,245,96,121,378
1986,Mike Woodson,SG,27,SAC,81,2417,510,1073,2,13,508,1060,242,289,1264
1986,Orlando Woolridge,SF,26,CHI,70,2248,540,1090,4,23,536,1067,364,462,1448
1986,James Worthy*,SF,24,LAL,75,2454,629,1086,0,13,629,1073,242,314,1500
1986,Danny Young,PG,23,SEA,82,1901,227,449,24,74,203,375,90,106,568
1986,Michael Young,SF,25,PHI,2,2,0,2,0,0,0,2,0,0,0
,,,,,,,,,,,,,,,
1987,Kareem Abdul-Jabbar*,C,39,LAL,78,2441,560,993,1,3,559,990,245,343,1366
1987,Alvan Adams,C,32,PHO,68,1690,311,618,0,1,311,617,134,170,756
1987,Michael Adams,PG,24,WSB,63,1303,160,393,28,102,132,291,105,124,453
1987,Rafael Addison,SF,22,PHO,62,711,146,331,16,50,130,281,51,64,359
1987,Mark Aguirre,SF,27,DAL,80,2663,787,1590,53,150,734,1440,429,557,2056
1987,Danny Ainge,SG,27,BOS,71,2499,410,844,85,192,325,652,148,165,1053
1987,Mark Alarie,PF,23,DEN,64,1110,217,443,2,9,215,434,67,101,503
1987,Richard Anderson,PF,26,HOU,51,312,59,139,4,16,55,123,22,29,144
1987,Ron Anderson,SF,28,IND,63,721,139,294,0,5,139,289,85,108,363
1987,John Bagley,PG,26,CLE,72,2182,312,732,31,103,281,629,113,136,768
1987,James Bailey,PF,29,NJN,34,542,112,239,0,0,112,239,58,80,282
1987,Thurl Bailey,PF,25,UTA,81,2155,463,1036,0,2,463,1034,190,236,1116
1987,Greg Ballard,SF,32,GSW,82,1579,248,564,15,40,233,524,68,91,579
1987,Gene Banks,SF,27,CHI,63,1822,249,462,0,5,249,457,112,146,610
1987,Charles Barkley*,PF,23,PHI,68,2740,557,937,21,104,536,833,429,564,1564
1987,John Battle,SG,24,ATL,64,804,144,315,0,10,144,305,93,126,381
1987,William Bedford,C,23,PHO,50,979,142,358,0,1,142,357,50,86,334
1987,Benoit Benjamin,C,22,LAC,72,2230,320,713,0,2,320,711,188,263,828
1987,Kent Benson,C,32,UTA,73,895,140,316,2,7,138,309,47,58,329
1987,Walter Berry,SF-PF,22,TOT,63,1586,407,766,0,3,407,763,187,288,1001
1987,Walter Berry,PF,22,POR,7,19,6,8,0,0,6,8,1,1,13
1987,Walter Berry,SF,22,SAS,56,1567,401,758,0,3,401,755,186,287,988
1987,Joe Binion,PF,25,POR,11,51,4,10,0,0,4,10,6,10,14
1987,Larry Bird*,SF,30,BOS,74,3005,786,1497,90,225,696,1272,414,455,2076
1987,Otis Birdsong,SG,31,NJN,7,127,19,42,0,1,19,41,6,9,44
1987,Uwe Blab,C,24,DAL,30,160,20,51,0,0,20,51,13,28,53
1987,Rolando Blackman,SG,27,DAL,80,2758,626,1264,5,15,621,1249,419,474,1676
1987,Manute Bol,C,24,WSB,82,1552,103,231,0,1,103,230,45,67,251
1987,Sam Bowie,C,25,POR,5,163,30,66,0,0,30,66,20,30,80
1987,Dudley Bradley,SG,29,MIL,68,900,76,213,13,50,63,163,47,58,212
1987,Adrian Branch,SF,23,LAL,32,219,48,96,0,2,48,94,42,54,138
1987,Randy Breuer,C,26,MIL,76,1467,241,497,0,0,241,497,118,202,600
1987,Frank Brickowski,PF-C,27,TOT,44,487,63,124,0,4,63,120,50,70,176
1987,Frank Brickowski,PF,27,LAL,37,404,53,94,0,0,53,94,40,59,146
1987,Frank Brickowski,C,27,SAS,7,83,10,30,0,4,10,26,10,11,30
1987,Junior Bridgeman,SF,33,MIL,34,418,79,171,1,6,78,165,16,20,175
1987,Mike Brittain,C,23,SAS,6,29,4,9,0,0,4,9,1,2,9
1987,Michael Brooks,SF,28,IND,10,148,13,37,0,0,13,37,7,10,33
1987,Mike Brown,C,23,CHI,62,818,106,201,0,0,106,201,46,72,258
1987,Tony Brown,SG,26,NJN,77,2339,358,810,5,20,353,790,152,206,873
1987,Michael Cage,PF,25,LAC,80,2922,457,878,0,3,457,875,341,467,1255
1987,Tony Campbell,SF,24,DET,40,332,57,145,0,3,57,142,24,39,138
1987,Rick Carlisle,SG,27,BOS,42,297,30,92,5,16,25,76,15,20,80
1987,Antoine Carr,PF,25,ATL,65,695,134,265,1,3,133,262,73,103,342
1987,Kenny Carr,PF,31,POR,49,1443,201,399,0,2,201,397,126,169,528
1987,Joe Barry,C,28,GSW,81,2724,690,1461,0,0,690,1461,340,432,1720
1987,Bill Cartwright,C,29,NYK,58,1989,335,631,0,0,335,631,346,438,1016
1987,Terry Catledge,PF,23,WSB,78,2149,413,835,0,4,413,831,199,335,1025
1987,Tom Chambers,PF,27,SEA,82,3018,660,1446,54,145,606,1301,535,630,1909
1987,Maurice Cheeks,PG,30,PHI,68,2624,415,788,4,17,411,771,227,292,1061
1987,Fred Cofield,PG,25,CHI,5,27,2,11,0,1,2,10,0,0,4
1987,Ben Coleman,C,25,NJN,68,1029,182,313,0,1,182,312,88,121,452
1987,Don Collins,SF,28,MIL,6,57,10,28,0,0,10,28,5,7,25
1987,Steve Colter,PG,24,TOT,70,1322,169,397,4,17,165,380,82,107,424
1987,Steve Colter,PG,24,CHI,27,473,49,142,0,9,49,133,33,39,131
1987,Steve Colter,PG,24,PHI,43,849,120,255,4,8,116,247,49,68,293
1987,Darwin Cook,SG,28,WSB,82,1420,265,622,2,23,263,599,82,103,614
1987,Michael Cooper,SG,30,LAL,82,2253,322,736,89,231,233,505,126,148,859
1987,Wayne Cooper,C,30,DEN,69,1561,235,524,0,3,235,521,79,109,549
1987,Tyrone Corbin,SF,24,TOT,63,1170,156,381,1,4,155,377,91,124,404
1987,Tyrone Corbin,SF,24,SAS,31,732,113,264,0,0,113,264,49,67,275
1987,Tyrone Corbin,SF,24,CLE,32,438,43,117,1,4,42,113,42,57,129
1987,Dave Corzine,C,30,CHI,82,2287,294,619,0,5,294,614,95,129,683
1987,Pat Cummings,PF,30,NYK,49,1056,172,382,0,0,172,382,79,110,423
1987,Terry Cummings,PF,25,MIL,82,2770,729,1426,0,3,729,1423,249,376,1707
1987,Earl Cureton,C,29,TOT,78,1973,243,510,0,2,243,508,82,152,568
1987,Earl Cureton,C,29,CHI,43,1105,129,276,0,1,129,275,39,73,297
1987,Earl Cureton,C,29,LAC,35,868,114,234,0,1,114,233,43,79,271
1987,Dell Curry,SG,22,UTA,67,636,139,326,17,60,122,266,30,38,325
1987,Quintin Dailey,SG,26,LAC,49,924,200,491,1,10,199,481,119,155,520
1987,Adrian Dantley*,SF,30,DET,81,2736,601,1126,1,6,600,1120,539,664,1742
1987,Brad Daugherty,C,21,CLE,80,2695,487,905,0,0,487,905,279,401,1253
1987,Brad Davis,PG,31,DAL,82,1582,199,436,32,106,167,330,147,171,577
1987,Walter Davis,SG,32,PHO,79,2646,779,1515,21,81,758,1434,288,334,1867
1987,Darryl Dawkins,C,30,NJN,6,106,20,32,0,0,20,32,17,24,57
1987,Johnny Dawkins,PG,23,SAS,81,1682,334,764,14,47,320,717,153,191,835
1987,Darren Daye,SF,26,TOT,62,731,101,202,0,0,101,202,34,65,236
1987,Darren Daye,SF,26,CHI,1,7,0,0,0,0,0,0,0,0,0
1987,Darren Daye,SF,26,BOS,61,724,101,202,0,0,101,202,34,65,236
1987,James Donaldson,C,29,DAL,82,3028,311,531,0,0,311,531,267,329,889
1987,Bruce Douglas,SG,22,SAC,8,98,7,24,0,1,7,23,0,4,14
1987,Greg Dreiling,C,24,IND,24,128,16,37,0,0,16,37,10,12,42
1987,Larry Drew,PG,28,LAC,60,1566,295,683,12,72,283,611,139,166,741
1987,Clyde Drexler*,SG,24,POR,82,3114,707,1408,11,47,696,1361,357,470,1782
1987,Kevin Duckworth,C,22,TOT,65,875,130,273,0,1,130,272,92,134,352
1987,Kevin Duckworth,C,22,SAS,14,122,18,45,0,0,18,45,9,14,45
1987,Kevin Duckworth,C,22,POR,51,753,112,228,0,1,112,227,83,120,307
1987,Joe Dumars*,SG,23,DET,79,2439,369,749,9,22,360,727,184,246,931
1987,T.R. Dunn,SG,31,DEN,81,1932,118,276,0,2,118,274,36,55,272
1987,Mark Eaton,C,30,UTA,79,2505,234,585,0,0,234,585,140,213,608
1987,Jerry Eaves,PG,27,SAC,3,26,1,8,0,0,1,8,2,2,4
1987,Franklin Edwards,PG,27,SAC,8,122,9,32,0,4,9,28,10,14,28
1987,James Edwards,C,31,PHO,14,304,57,110,0,0,57,110,54,70,168
1987,Craig Ehlo,SG,25,CLE,44,890,99,239,5,29,94,210,70,99,273
1987,Dale Ellis,SG,26,SEA,82,3073,785,1520,86,240,699,1280,385,489,2041
1987,Chris Engler,C,27,TOT,30,195,23,51,0,0,23,51,12,16,58
1987,Chris Engler,C,27,POR,7,17,4,8,0,0,4,8,3,3,11
1987,Chris Engler,C,27,MIL,5,48,3,12,0,0,3,12,1,1,7
1987,Chris Engler,C,27,NJN,18,130,16,31,0,0,16,31,8,12,40
1987,Alex English*,SF,33,DEN,82,3085,965,1920,4,15,961,1905,411,487,2345
1987,Julius Erving*,SF,36,PHI,60,1918,400,850,14,53,386,797,191,235,1005
1987,Mike Evans,SG,31,DEN,81,1567,334,729,53,169,281,560,96,123,817
1987,Patrick Ewing*,PF,24,NYK,63,2206,530,1053,0,7,530,1046,296,415,1356
1987,Dave Feitl,C,24,HOU,62,498,88,202,0,1,88,201,53,71,229
1987,Kenny Fields,SF,24,TOT,48,883,159,352,3,12,156,340,73,94,394
1987,Kenny Fields,SF,24,MIL,4,22,6,8,0,0,6,8,1,5,13
1987,Kenny Fields,SF,24,LAC,44,861,153,344,3,12,150,332,72,89,381
1987,Vern Fleming,PG,24,IND,82,2549,370,727,2,10,368,717,238,302,980
1987,Sleepy Floyd,PG,26,GSW,82,3064,503,1030,73,190,430,840,462,537,1541
1987,World B.,SG,33,PHI,20,285,39,123,2,9,37,114,36,47,116
1987,Kenny Gattison,PF,22,PHO,77,1104,148,311,0,3,148,308,108,171,404
1987,Artis Gilmore*,C,37,SAS,82,2405,346,580,0,0,346,580,242,356,934
1987,Mike Glenn,SG,31,MIL,4,34,5,13,0,0,5,13,5,7,15
1987,Mike Gminski,C,27,NJN,72,2272,433,947,0,0,433,947,313,370,1179
1987,Grant Gondrezick,SG,24,PHO,64,836,135,300,4,17,131,283,75,107,349
1987,Lancaster Gordon,SG,24,LAC,70,1130,221,545,14,48,207,497,70,95,526
1987,Stewart Granger,PG,25,NYK,15,166,20,54,0,3,20,51,9,11,49
1987,Stuart Gray,C,23,IND,55,456,41,101,0,0,41,101,28,39,110
1987,A.C. Green,PF,23,LAL,79,2240,316,587,0,5,316,582,220,282,852
1987,Kenny Green,SF,22,PHI,19,172,25,70,0,0,25,70,14,19,64
1987,Rickey Green,PG,32,UTA,81,2090,301,644,7,19,294,625,172,208,781
1987,Sidney Green,PF,26,DET,80,1792,256,542,0,2,256,540,119,177,631
1987,Dave Greenwood,PF,29,SAS,79,2587,336,655,3,6,333,649,241,307,916
1987,Darrell Griffith,SG,28,UTA,76,1843,463,1038,67,200,396,838,149,212,1142
1987,Bob Hansen,SG,26,UTA,72,1453,272,601,16,45,256,556,136,179,696
1987,Bill Hanzlik,PF,29,DEN,73,1990,307,746,22,80,285,666,316,402,952
1987,Derek Harper,PG,25,DAL,77,2556,497,993,76,212,421,781,160,234,1230
1987,Ron Harper,SG,23,CLE,82,3064,734,1614,20,94,714,1520,386,564,1874
1987,Steve Harris,SG,23,HOU,74,1174,251,599,0,8,251,591,111,130,613
1987,Scott Hastings,PF,26,ATL,40,256,23,68,2,12,21,56,23,29,71
1987,Cedric Henderson,PF,21,TOT,8,16,4,8,0,0,4,8,3,3,11
1987,Cedric Henderson,PF,21,ATL,6,10,2,5,0,0,2,5,1,1,5
1987,Cedric Henderson,PF,21,MIL,2,6,2,3,0,0,2,3,2,2,6
1987,Gerald Henderson,PG,31,TOT,74,2045,298,674,19,77,279,597,190,230,805
1987,Gerald Henderson,PG,31,SEA,6,155,25,50,0,3,25,47,17,18,67
1987,Gerald Henderson,PG,31,NYK,68,1890,273,624,19,74,254,550,173,212,738
1987,Jerome Henderson,PF,27,MIL,6,36,4,13,0,0,4,13,4,4,12
1987,Kevin Henderson,PG,22,GSW,5,45,3,8,0,0,3,8,2,2,8
1987,Conner Henry,SG,23,TOT,54,323,46,136,13,42,33,94,17,27,122
1987,Conner Henry,SG,23,HOU,18,92,8,33,1,11,7,22,7,10,24
1987,Conner Henry,SG,23,BOS,36,231,38,103,12,31,26,72,10,17,98
1987,Rod Higgins,SF,27,GSW,73,1497,214,412,3,17,211,395,200,240,631
1987,Roy Hinson,SF,25,PHI,76,2489,393,823,0,1,393,822,273,360,1059
1987,Craig Hodges,PG,26,MIL,78,2147,315,682,85,228,230,454,131,147,846
1987,Mike Holton,PG,25,POR,58,479,70,171,7,23,63,148,44,55,191
1987,Jeff Hornacek,SG,23,PHO,80,1561,159,350,12,43,147,307,94,121,424
1987,Phil Hubbard,SF,30,CLE,68,2083,321,605,0,4,321,601,162,272,804
1987,Jay Humphries,PG,24,PHO,82,2579,359,753,5,27,354,726,200,260,923
1987,Geoff Huston,PG,29,LAC,19,428,55,121,1,2,54,119,18,34,129
1987,Marc Iavaroni,PF,30,UTA,78,845,100,215,0,4,100,211,78,116,278
1987,Myron Jackson,PG,22,DAL,8,22,2,9,0,0,2,9,7,8,11
1987,Buck Johnson,SF,23,HOU,60,520,94,201,0,1,94,200,40,58,228
1987,Clemon Johnson,C,30,SEA,78,1051,88,178,0,2,88,176,70,110,246
1987,Dennis Johnson*,PG,32,BOS,79,2933,423,953,7,62,416,891,209,251,1062
1987,Eddie Johnson,SG,31,SEA,24,508,85,186,5,15,80,171,42,55,217
1987,Eddie Johnson,SF,27,SAC,81,2457,606,1309,37,118,569,1191,267,322,1516
1987,Frank Johnson,PG,28,WSB,18,399,59,128,0,1,59,127,35,49,153
1987,Magic Johnson*,PG,27,LAL,80,2904,683,1308,8,39,675,1269,535,631,1909
1987,Marques Johnson,SF,30,LAC,10,302,68,155,0,6,68,149,30,42,166
1987,Steffond Johnson,PF,24,LAC,29,234,27,64,0,3,27,61,20,38,74
1987,Steve Johnson,C,29,POR,79,2345,494,889,0,0,494,889,342,490,1330
1987,Vinnie Johnson,SG,30,DET,78,2166,533,1154,4,14,529,1140,158,201,1228
1987,Anthony Jones,SF-SG,24,TOT,65,858,133,322,7,20,126,302,50,65,323
1987,Anthony Jones,SG,24,WSB,16,114,14,33,0,1,14,32,9,13,37
1987,Anthony Jones,SF,24,SAS,49,744,119,289,7,19,112,270,41,52,286
1987,Caldwell Jones,PF,36,POR,78,1578,111,224,0,2,111,222,97,124,319
1987,Charles Jones,PF,29,WSB,79,1609,118,249,0,1,118,248,48,76,284
1987,Michael Jordan*,SG,23,CHI,82,3281,1098,2279,12,66,1086,2213,833,972,3041
1987,Clark Kellogg,PF,25,IND,4,60,8,22,1,2,7,20,3,4,20
1987,Tim Kempton,PF,23,LAC,66,936,97,206,0,1,97,205,95,137,289
1987,Jerome Kersey,SF,24,POR,82,2088,373,733,1,23,372,710,262,364,1009
1987,Albert King,SF,27,NJN,61,1291,244,573,13,32,231,541,81,100,582
1987,Bernard King*,SF,30,NYK,6,214,52,105,0,0,52,105,32,43,136
1987,Curtis Kitchen,PF,23,SEA,6,31,3,6,0,1,3,5,3,4,9
1987,Greg Kite,C,25,BOS,74,745,47,110,0,1,47,109,29,76,123
1987,Joe Kleine,C,25,SAC,79,1658,256,543,0,1,256,542,110,140,622
1987,Jon Koncak,C,23,ATL,82,1684,169,352,0,1,169,351,125,191,463
1987,Larry Krystkowiak,PF,22,SAS,68,1004,170,373,1,12,169,361,110,148,451
1987,Bill Laimbeer,C,29,DET,82,2854,506,1010,6,21,500,989,245,274,1263
1987,Jim Lampley,C,26,PHI,1,16,1,3,0,0,1,3,1,2,3
1987,Allen Leavell,PG,29,HOU,53,1175,147,358,18,57,129,301,100,119,412
1987,Keith Lee,PF,24,CLE,67,870,170,374,0,1,170,373,72,101,412
1987,Fat Lever,PG,26,DEN,82,3054,643,1370,22,92,621,1278,244,312,1552
1987,Cliff Levingston,PF,26,ATL,82,1848,251,496,0,3,251,493,155,212,657
1987,Alton Lister,C,28,SEA,75,2288,346,687,0,1,346,686,179,265,871
1987,Lewis Lloyd,SG,27,HOU,32,688,165,310,1,7,164,303,65,86,396
1987,John Long,SG,30,IND,80,2265,490,1170,19,67,471,1103,219,246,1218
1987,John Lucas,PG,33,MIL,43,1358,285,624,46,126,239,498,137,174,753
1987,Maurice Lucas,PF,34,SEA,63,1120,175,388,0,5,175,383,150,187,500
1987,Kyle Macy,PG,29,IND,76,1250,164,341,14,46,150,295,34,41,376
1987,Rick Mahorn,PF,28,DET,63,1278,144,322,0,0,144,322,96,117,384
1987,Jeff Malone,SG,25,WSB,80,2763,689,1509,4,26,685,1483,376,425,1758
1987,Karl Malone*,PF,23,UTA,82,2857,728,1422,0,7,728,1415,323,540,1779
1987,Moses Malone*,C,31,WSB,73,2488,595,1311,0,11,595,1300,570,692,1760
1987,Pace Mannion,SF,26,NJN,23,284,31,94,3,9,28,85,18,31,83
1987,Bill Martin,SF,24,NYK,8,68,9,25,0,0,9,25,7,8,25
1987,Fernando Martin,C,24,POR,24,146,9,31,0,1,9,30,4,11,22
1987,Maurice Martin,SF,22,DEN,43,286,51,135,3,15,48,120,42,66,147
1987,Wes Matthews,PG,27,LAL,50,532,89,187,1,3,88,184,29,36,208
1987,Cedric Maxwell,SF,31,TOT,81,1968,253,477,0,1,253,476,303,391,809
1987,Cedric Maxwell,SF,31,LAC,35,1132,150,289,0,0,150,289,177,228,477
1987,Cedric Maxwell,SF,31,HOU,46,836,103,188,0,1,103,187,126,163,332
1987,Tim McCormick,C,24,PHI,81,2817,391,718,0,4,391,714,251,349,1033
1987,Rodney McCray,SF,25,HOU,81,3136,432,783,0,9,432,774,306,393,1170
1987,Scooter McCray,PF,26,CLE,24,279,30,65,0,0,30,65,20,41,80
1987,Xavier McDaniel,SF,23,SEA,82,3031,806,1583,3,14,803,1569,275,395,1890
1987,Ben McDonald,PF,24,GSW,63,1284,164,360,1,8,163,352,24,38,353
1987,Hank McDowell,PF,27,MIL,7,70,8,17,0,0,8,17,6,7,22
1987,Mike McGee,SF,27,ATL,76,1420,311,677,86,229,225,448,80,137,788
1987,Kevin McHale*,PF,29,BOS,77,3060,790,1307,0,4,790,1303,428,512,2008
1987,Kevin McKenna,SG,28,NJN,56,942,153,337,52,124,101,213,43,57,401
1987,Forrest McKenzie,SF,23,SAS,6,42,7,28,1,2,6,26,2,2,17
1987,Nate McMillan,PG,22,SEA,71,1972,143,301,0,7,143,294,87,141,373
1987,Mark McNamara,C,27,PHI,11,113,14,30,0,0,14,30,7,19,35
1987,Chris McNealy,PF,25,NYK,59,972,88,179,0,0,88,179,52,80,228
1987,Cozell McQueen,PF,25,DET,3,7,3,3,0,0,3,3,0,0,6
1987,Dirk Minniefield,PG,26,TOT,74,1600,218,482,11,39,207,443,62,90,509
1987,Dirk Minniefield,PG,26,CLE,11,122,13,42,0,5,13,37,1,4,27
1987,Dirk Minniefield,PG,26,HOU,63,1478,205,440,11,34,194,406,61,86,482
1987,Mike Mitchell,SF,31,SAS,40,922,208,478,1,2,207,476,92,112,509
1987,Paul Mokeski,C,30,MIL,62,626,52,129,0,1,52,128,46,64,150
1987,Sidney Moncrief,SG,29,MIL,39,992,158,324,8,31,150,293,136,162,460
1987,Johnny Moore,PG,28,SAS,55,1234,198,448,22,79,176,369,56,70,474
1987,Perry Moss,PG,28,GSW,64,698,91,207,1,14,90,193,49,69,232
1987,Chris Mullin*,SG,23,GSW,82,2377,477,928,19,63,458,865,269,326,1242
1987,Jay Murphy,PF,24,WSB,21,141,31,72,0,0,31,72,9,16,71
1987,Pete Myers,SG,23,CHI,29,155,19,52,0,6,19,46,28,43,66
1987,Larry Nance,PF,27,PHO,69,2569,585,1062,1,5,584,1057,381,493,1552
1987,Calvin Natt,PF,30,DEN,1,20,4,10,0,0,4,10,2,2,10
1987,Ed Nealy,PF,26,SAS,60,980,84,192,4,31,80,161,51,69,223
1987,Chuck Nevitt,C,27,DET,41,267,31,63,0,0,31,63,14,24,76
1987,Johnny Newman,SF,23,CLE,59,630,113,275,1,22,112,253,66,76,293
1987,Kurt Nimphius,PF,28,TOT,66,1088,155,330,0,4,155,326,81,120,391
1987,Kurt Nimphius,PF,28,LAC,38,811,119,252,0,3,119,249,57,88,295
1987,Kurt Nimphius,PF,28,DET,28,277,36,78,0,1,36,77,24,32,96
1987,Dennis Nutt,PG,23,DAL,25,91,16,40,5,17,11,23,20,22,57
1987,Mike O'Koren,SF,28,WSB,15,123,16,42,0,2,16,40,0,2,32
1987,Charles Oakley,PF,23,CHI,82,2980,468,1052,11,30,457,1022,245,357,1192
1987,Hakeem Olajuwon*,C,24,HOU,75,2760,677,1332,1,5,676,1327,400,570,1755
1987,Mark Olberding,PF,30,SAC,76,1002,69,165,0,1,69,164,116,131,254
1987,Jawann Oldham,C,29,NYK,44,776,71,174,0,1,71,173,31,57,173
1987,Louis Orr,SF,28,NYK,65,1440,166,389,1,5,165,384,125,172,458
1987,Robert Parish*,C,33,BOS,80,2995,588,1057,0,1,588,1056,227,309,1403
1987,Jim Paxson,SG,29,POR,72,1798,337,733,26,98,311,635,174,216,874
1987,John Paxson,PG,26,CHI,82,2689,386,793,52,140,334,653,106,131,930
1987,Sam Perkins,PF,25,DAL,80,2687,461,957,19,54,442,903,245,296,1186
1987,Chuck Person,SF,22,IND,82,2956,635,1358,49,138,586,1220,222,297,1541
1987,Jim Petersen,PF,24,HOU,82,2403,386,755,0,4,386,751,152,209,924
1987,Michael Phelps,SG,25,SEA,60,469,75,176,1,10,74,166,31,44,182
1987,Ricky Pierce,SG,27,MIL,79,2505,575,1077,3,28,572,1049,387,440,1540
1987,Ed Pinckney,SF,23,PHO,80,2250,290,497,0,2,290,495,257,348,837
1987,Dwayne Polee,SG,23,LAC,1,6,1,4,0,3,1,1,0,0,2
1987,Ben Poquette,PF,31,TOT,58,604,62,122,0,4,62,118,40,50,164
1987,Ben Poquette,PF,31,CLE,37,437,41,82,0,3,41,79,31,39,113
1987,Ben Poquette,PF,31,CHI,21,167,21,40,0,1,21,39,9,11,51
1987,Terry Porter,PG,23,POR,80,2714,376,770,13,60,363,710,280,334,1045
1987,Paul Pressey,SF,28,MIL,61,2057,294,616,16,55,278,561,242,328,846
1987,Harold Pressley,SF,23,SAC,67,913,134,317,7,28,127,289,35,48,310
1987,Mark Price,PG,22,CLE,67,1217,173,424,23,70,150,354,95,114,464
1987,Kurt Rambis,PF,28,LAL,78,1514,163,313,0,0,163,313,120,157,446
1987,Blair Rasmussen,C,24,DEN,74,1421,268,570,0,0,268,570,169,231,705
1987,Robert Reid,SG,31,HOU,75,2594,420,1006,53,162,367,844,136,177,1029
1987,Jerry Reynolds,SF,24,MIL,58,963,140,356,6,18,134,338,118,184,404
1987,Clint Richardson,SG,30,IND,78,1396,218,467,6,17,212,450,59,74,501
1987,Doc Rivers,PG,25,ATL,82,2590,342,758,4,21,338,737,365,441,1053
1987,Fred Roberts,PF,26,BOS,73,1079,139,270,0,3,139,267,124,153,402
1987,Alvin Robertson,SG,24,SAS,81,2697,589,1264,13,48,576,1216,244,324,1435
1987,Cliff Robinson,PF,26,PHI,55,1586,338,729,0,4,338,725,139,184,815
1987,Dennis Rodman*,SF,25,DET,77,1155,213,391,0,1,213,390,74,126,500
1987,Johnny Rogers,PF,23,SAC,45,468,90,185,0,5,90,180,9,15,189
1987,Tree Rollins,C,31,ATL,75,1764,171,313,0,0,171,313,63,87,405
1987,Dan Roundfield,PF,33,WSB,36,669,90,220,1,5,89,215,57,72,238
1987,Ron Rowan,SG,24,POR,7,16,4,9,1,1,3,8,3,4,12
1987,Jeff Ruland,PF,28,PHI,5,116,19,28,0,0,19,28,9,12,47
1987,Walker Russell,PG,26,IND,48,511,64,165,2,16,62,149,27,37,157
1987,John Salley,C,22,DET,82,1463,163,290,0,1,163,289,105,171,431
1987,Ralph Sampson*,PF,26,HOU,43,1326,277,566,0,3,277,563,118,189,672
1987,Mike Sanders,SF,26,PHO,82,1655,357,722,2,17,355,705,143,183,859
1987,Danny Schayes,C,27,DEN,76,1556,210,405,0,0,210,405,229,294,649
1987,Russ Schoene,PF,26,SEA,63,579,71,190,2,13,69,177,29,46,173
1987,Detlef Schrempf,SF,24,DAL,81,1711,265,561,33,69,232,492,193,260,756
1987,John Schweitz,SG,26,DET,3,7,0,1,0,0,0,1,0,0,0
1987,Byron Scott,SG,25,LAL,82,2729,554,1134,65,149,489,985,224,251,1397
1987,Carey Scurry,SF,24,UTA,69,753,123,247,4,13,119,234,94,134,344
1987,Brad Sellers,PF,24,CHI,80,1751,276,606,2,10,274,596,126,173,680
1987,Purvis Short,SF,29,GSW,34,950,240,501,4,17,236,484,137,160,621
1987,Jerry Sichting,PG,30,BOS,78,1566,202,398,7,26,195,372,37,42,448
1987,Jack Sikma,C,31,MIL,82,2536,390,842,0,2,390,840,265,313,1045
1987,McKinley Singleton,PG,25,NYK,2,10,2,3,0,1,2,2,0,0,4
1987,Scott Skiles,PG,22,MIL,13,205,18,62,3,14,15,48,10,12,49
1987,Clinton Smith,SG,23,GSW,41,341,50,117,0,2,50,115,27,36,127
1987,Derek Smith,SG,25,SAC,52,1658,338,757,9,33,329,724,178,228,863
1987,Keith Smith,SG,22,MIL,42,461,57,150,3,9,54,141,21,28,138
1987,Larry Smith,PF,29,GSW,80,2374,297,544,0,1,297,543,113,197,707
1987,Otis Smith,SG,23,DEN,28,168,33,79,0,2,33,77,12,21,78
1987,Mike Smrek,C,24,LAL,35,233,30,60,0,0,30,60,16,25,76
1987,Rory Sparrow,PG,28,NYK,80,1951,263,590,11,42,252,548,71,89,608
1987,Terence Stansbury,SG,25,SEA,44,375,67,156,11,29,56,127,31,50,176
1987,Brook Steppe,SG,27,SAC,34,665,95,199,3,9,92,190,73,88,266
1987,Steve Stipanovich,C,26,IND,81,2761,382,760,1,4,381,756,307,367,1072
1987,John Stockton*,PG,24,UTA,82,1858,231,463,7,39,224,424,179,229,648
1987,Jon Sundvold,PG,25,SAS,76,1765,365,751,50,149,315,602,70,84,850
1987,Roy Tarpley,PF,22,DAL,75,1405,233,499,1,3,232,496,94,139,561
1987,Jeff Taylor,SG,27,DET,12,44,6,10,0,0,6,10,9,10,21
1987,Terry Teagle,SG,26,GSW,82,1650,370,808,0,10,370,798,182,234,922
1987,Reggie Theus,PG,29,SAC,79,2872,577,1223,17,78,560,1145,429,495,1600
1987,David Thirdkill,SF,26,BOS,17,89,10,24,0,1,10,23,5,16,25
1987,Isiah Thomas*,PG,25,DET,81,3013,626,1353,19,98,607,1255,400,521,1671
1987,Bernard Thompson,SF,24,PHO,24,331,42,105,0,3,42,102,27,33,111
1987,Billy Thompson,SF,23,LAL,59,762,142,261,0,1,142,260,48,74,332
1987,LaSalle Thompson,C,25,SAC,82,2166,362,752,0,5,362,747,188,255,912
1987,Mychal Thompson,PF,32,TOT,82,1890,359,797,1,2,358,795,219,297,938
1987,Mychal Thompson,PF,32,SAS,49,1210,230,528,1,1,229,527,144,196,605
1987,Mychal Thompson,PF,32,LAL,33,680,129,269,0,1,129,268,75,101,333
1987,Bob Thornton,PF,24,NYK,33,282,29,67,0,1,29,66,13,20,71
1987,Otis Thorpe,PF,24,SAC,82,2956,567,1050,0,3,567,1047,413,543,1547
1987,Sedale Threatt,PG,25,TOT,68,1446,239,534,7,32,232,502,95,119,580
1987,Sedale Threatt,PG,25,PHI,28,668,108,261,7,16,101,245,42,53,265
1987,Sedale Threatt,PG,25,CHI,40,778,131,273,0,16,131,257,53,66,315
1987,Wayman Tisdale,PF,22,IND,81,2159,458,892,0,2,458,890,258,364,1174
1987,Andrew Toney,SG,29,PHI,52,1058,197,437,22,67,175,370,133,167,549
1987,Kelly Tripucka,SF,27,UTA,79,1865,291,621,19,52,272,569,197,226,798
1987,Trent Tucker,SG,27,NYK,70,1691,325,691,68,161,257,530,77,101,795
1987,Andre Turner,PG,22,BOS,3,18,2,5,0,1,2,4,0,0,4
1987,Elston Turner,SF,27,CHI,70,936,112,252,1,8,111,244,23,31,248
1987,Jeff Turner,PF,24,NJN,76,1003,151,325,0,1,151,324,76,104,378
1987,Melvin Turpin,C,26,CLE,64,801,169,366,0,0,169,366,55,77,393
1987,Terry Tyler,SF,30,SAC,82,1930,329,664,1,3,328,661,101,140,760
1987,Darnell Valentine,PG,27,LAC,65,1759,275,671,13,56,262,615,163,200,726
1987,Kiki Vandeweghe,SF,28,POR,79,3029,808,1545,39,81,769,1464,467,527,2122
1987,Nick Vanos,C,23,PHO,57,640,65,158,0,2,65,156,38,59,168
1987,Pete Verhoeven,PF,27,IND,5,44,5,14,0,0,5,14,0,0,10
1987,Jay Vincent,SF,27,WSB,51,1386,274,613,0,3,274,610,130,169,678
1987,Sam Vincent,PG,23,BOS,46,374,60,136,0,0,60,136,51,55,171
1987,Danny Vranes,SF,28,PHI,58,817,59,138,1,5,58,133,21,45,140
1987,Granville Waiters,C,26,CHI,44,534,40,93,0,1,40,92,5,9,85
1987,Darrell Walker,PG,25,DEN,81,2020,358,742,0,4,358,738,272,365,988
1987,Kenny Walker,SF,22,NYK,68,1719,285,581,0,4,285,577,140,185,710
1987,Bill Walton*,C,34,BOS,10,112,10,26,0,0,10,26,8,15,28
1987,Chris Washburn,C,21,GSW,35,385,57,145,0,1,57,144,18,51,132
1987,Pearl Washington,PG,23,NJN,72,1600,257,538,4,24,253,514,98,125,616
1987,Spud Webb,PG,23,ATL,33,532,71,162,1,6,70,156,80,105,223
1987,Marvin Webster,C,34,MIL,15,102,10,19,1,1,9,18,6,8,27
1987,Scott Wedman,SF,34,BOS,6,78,9,27,1,2,8,25,1,2,20
1987,Bill Wennington,C,23,DAL,58,560,56,132,0,2,56,130,45,60,157
1987,Mark West,C,26,CLE,78,1333,209,385,0,2,209,383,89,173,507
1987,Ennis Whatley,PG,24,WSB,73,1816,246,515,0,2,246,513,126,165,618
1987,Rory White,SF,27,LAC,68,1545,265,552,0,3,265,549,94,144,624
1987,Jerome Whitehead,C,30,GSW,73,937,147,327,0,1,147,326,79,113,373
1987,Mitchell Wiggins,SG,27,HOU,32,788,153,350,0,5,153,345,49,65,355
1987,Dominique Wilkins*,SF,27,ATL,79,2969,828,1787,31,106,797,1681,607,742,2294
1987,Eddie Lee,PF,24,NYK,24,454,56,127,0,1,56,126,27,58,139
1987,Gerald Wilkins,SG,23,NYK,80,2758,633,1302,26,74,607,1228,235,335,1527
1987,Buck Williams,PF,26,NJN,82,2976,521,936,0,1,521,935,430,588,1472
1987,Gus Williams,SG,33,ATL,33,481,53,146,5,18,48,128,27,40,138
1987,Herb Williams,PF,28,IND,74,2526,451,939,0,9,451,930,199,269,1101
1987,Hot Rod,PF,24,CLE,80,2714,435,897,0,1,435,896,298,400,1168
1987,John Williams,SF,20,WSB,78,1773,283,624,8,36,275,588,144,223,718
1987,Kevin Williams,SG,25,SEA,65,703,132,296,0,7,132,289,55,66,319
1987,Pete Williams,PF,21,DEN,5,10,1,2,0,0,1,2,0,0,2
1987,Ray Williams,PG,32,NJN,32,800,131,290,7,28,124,262,49,60,318
1987,Kevin Willis,PF,24,ATL,81,2626,538,1003,1,4,537,999,227,320,1304
1987,Michael Wilson,SG-PG,27,TOT,7,45,3,10,0,0,3,10,2,2,8
1987,Michael Wilson,SG,27,NJN,5,43,3,8,0,0,3,8,2,2,8
1987,Michael Wilson,PG,27,ATL,2,2,0,2,0,0,0,2,0,0,0
1987,Othell Wilson,PG,25,SAC,53,789,82,185,3,18,79,167,43,54,210
1987,David Wingate,SG,23,PHI,77,1612,259,602,13,52,246,550,149,201,680
1987,Randy Wittman,SG,27,ATL,71,2049,398,792,4,12,394,780,100,127,900
1987,Al Wood,SG,28,DAL,54,657,121,310,7,25,114,285,109,139,358
1987,Leon Wood,PG,24,NJN,76,1733,187,501,60,200,127,301,123,154,557
1987,Mike Woodson,SG,28,LAC,74,2126,494,1130,34,123,460,1007,240,290,1262
1987,Orlando Woolridge,SF,27,NJN,75,2638,556,1067,1,8,555,1059,438,564,1551
1987,James Worthy*,SF,25,LAL,82,2819,651,1207,0,13,651,1194,292,389,1594
1987,Brad Wright,PF,24,NYK,14,138,20,46,0,1,20,45,12,28,52
1987,Danny Young,PG,24,SEA,73,1482,132,288,29,79,103,209,59,71,352
1987,Perry Young,SG,23,TOT,9,72,6,21,0,0,6,21,1,2,13
1987,Perry Young,SG,23,CHI,5,20,2,4,0,0,2,4,1,2,5
1987,Perry Young,SG,23,POR,4,52,4,17,0,0,4,17,0,0,8
,,,,,,,,,,,,,,,
1988,Kareem Abdul-Jabbar*,C,40,LAL,80,2308,480,903,0,1,480,902,205,269,1165
1988,Mark Acres,C,25,BOS,79,1151,108,203,0,0,108,203,71,111,287
1988,Alvan Adams,C,33,PHO,82,1646,251,506,1,2,250,504,108,128,611
1988,Michael Adams,PG,25,DEN,82,2778,416,927,139,379,277,548,166,199,1137
1988,Mark Aguirre,SF,28,DAL,77,2610,746,1571,52,172,694,1399,388,504,1932
1988,Danny Ainge,SG,28,BOS,81,3018,482,982,148,357,334,625,158,180,1270
1988,Mark Alarie,PF,24,WSB,63,769,144,300,4,18,140,282,35,49,327
1988,Steve Alford,PG,23,DAL,28,197,21,55,1,8,20,47,16,17,59
1988,Greg Anderson,PF,23,SAS,82,1984,379,756,1,5,378,751,198,328,957
1988,Richard Anderson,PF,27,TOT,74,1350,171,439,48,150,123,289,58,77,448
1988,Richard Anderson,PF,27,HOU,12,53,11,26,6,15,5,11,4,5,32
1988,Richard Anderson,PF,27,POR,62,1297,160,413,42,135,118,278,54,72,416
1988,Ron Anderson,SF,29,IND,74,1097,217,436,0,2,217,434,108,141,542
1988,Joe Arlauckas,SF,22,SAC,9,85,14,43,0,0,14,43,6,8,34
1988,Vincent Askew,SG,21,PHI,14,234,22,74,0,0,22,74,8,11,52
1988,John Bagley,PG,27,NJN,82,2774,393,896,47,161,346,735,148,180,981
1988,James Bailey,PF,30,PHO,65,869,109,241,0,4,109,237,70,89,288
1988,Thurl Bailey,SF,26,UTA,82,2804,633,1286,1,3,632,1283,337,408,1604
1988,Charles Barkley*,PF,24,PHI,80,3170,753,1283,44,157,709,1126,714,951,2264
1988,John Battle,SG,25,ATL,67,1227,278,613,16,41,262,572,141,188,713
1988,William Bedford,C,24,DET,38,298,44,101,0,0,44,101,13,23,101
1988,Benoit Benjamin,C,23,LAC,66,2171,340,693,0,8,340,685,180,255,860
1988,Kent Benson,C,33,CLE,2,12,2,2,0,0,2,2,1,2,5
1988,Walter Berry,SF,23,SAS,73,1922,540,960,0,0,540,960,192,320,1272
1988,Larry Bird*,SF,31,BOS,76,2965,881,1672,98,237,783,1435,415,453,2275
1988,Otis Birdsong,SG,32,NJN,67,1882,337,736,9,25,328,711,47,92,730
1988,Uwe Blab,C,25,DAL,73,658,58,132,0,0,58,132,46,65,162
1988,Rolando Blackman,SG,28,DAL,71,2580,497,1050,0,5,497,1045,331,379,1325
1988,Nate Blackwell,PG,22,SAS,10,112,15,41,2,11,13,30,5,6,37
1988,Muggsy Bogues,PG,23,WSB,79,1628,166,426,3,16,163,410,58,74,393
1988,Manute Bol,C,25,WSB,77,1136,75,165,0,1,75,164,26,49,176
1988,Dudley Bradley,SG,30,TOT,65,1437,156,365,37,102,119,263,74,97,423
1988,Dudley Bradley,SG,30,MIL,2,5,0,1,0,1,0,0,0,0,0
1988,Dudley Bradley,SG,30,NJN,63,1432,156,364,37,101,119,263,74,97,423
1988,Adrian Branch,SF,24,NJN,20,308,56,134,1,5,55,129,20,23,133
1988,Randy Breuer,C,27,MIL,81,2258,390,788,0,0,390,788,188,286,968
1988,Frank Brickowski,C,28,SAS,70,2227,425,805,1,5,424,800,268,349,1119
1988,Michael Brooks,SF,29,DEN,16,133,20,49,0,0,20,49,3,4,43
1988,Mike Brown,C,24,CHI,46,591,78,174,0,1,78,173,41,71,197
1988,Steve Burtt,SG,25,LAC,19,312,62,138,0,4,62,134,47,69,171
1988,Michael Cage,PF,26,LAC,72,2660,360,766,0,1,360,765,326,474,1046
1988,Tony Campbell,SF,25,LAL,13,242,57,101,1,3,56,98,28,39,143
1988,Rick Carlisle,SG,28,NYK,26,204,29,67,6,17,23,50,10,11,74
1988,Antoine Carr,PF,26,ATL,80,1483,281,517,1,4,280,513,142,182,705
1988,Joe Barry,C,29,TOT,77,2004,402,924,0,2,402,922,172,225,976
1988,Joe Barry,C,29,GSW,14,408,79,209,0,1,79,208,59,74,217
1988,Joe Barry,C,29,HOU,63,1596,323,715,0,1,323,714,113,151,759
1988,Bill Cartwright,C,30,NYK,82,1676,287,528,0,0,287,528,340,426,914
1988,Terry Catledge,PF,24,WSB,70,1610,296,585,0,2,296,583,154,235,746
1988,Tom Chambers,PF,28,SEA,82,2680,611,1364,33,109,578,1255,419,519,1674
1988,Maurice Cheeks,PG,31,PHI,79,2871,428,865,3,22,425,843,227,275,1086
1988,Ben Coleman,PF,26,TOT,70,1498,226,453,0,3,226,450,141,185,593
1988,Ben Coleman,PF,26,NJN,27,657,116,240,0,2,116,238,65,84,297
1988,Ben Coleman,PF,26,PHI,43,841,110,213,0,1,110,212,76,101,296
1988,Norris Coleman,SF,26,LAC,29,431,66,191,1,2,65,189,20,36,153
1988,Steve Colter,PG,25,TOT,68,1513,203,441,3,10,200,431,75,95,484
1988,Steve Colter,PG,25,PHI,12,152,15,40,0,0,15,40,7,9,37
1988,Steve Colter,PG,25,WSB,56,1361,188,401,3,10,185,391,68,86,447
1988,Dallas Comegys,PF,23,NJN,75,1122,156,363,0,1,156,362,106,150,418
1988,Lester Conner,PG,28,HOU,52,399,50,108,0,7,50,101,32,41,132
1988,Jeff Cook,PF,31,PHO,33,359,14,59,0,1,14,58,23,28,51
1988,Michael Cooper,SG,31,LAL,61,1793,189,482,57,178,132,304,97,113,532
1988,Wayne Cooper,C,31,DEN,45,865,118,270,0,1,118,269,50,67,286
1988,Tyrone Corbin,SF,25,TOT,84,1739,257,525,1,6,256,519,110,138,625
1988,Tyrone Corbin,SF,25,CLE,54,1148,158,322,0,3,158,319,77,98,393
1988,Tyrone Corbin,SF,25,PHO,30,591,99,203,1,3,98,200,33,40,232
1988,Dave Corzine,C,31,CHI,80,2328,344,715,1,9,343,706,115,153,804
1988,Winston Crite,SF,22,PHO,29,258,34,68,0,0,34,68,19,25,87
1988,Pat Cummings,PF,31,NYK,62,946,140,307,0,1,140,306,59,80,339
1988,Terry Cummings,PF,26,MIL,76,2629,675,1392,1,3,674,1389,270,406,1621
1988,Earl Cureton,PF,30,LAC,69,1128,133,310,0,3,133,307,33,63,299
1988,Dell Curry,SG,23,CLE,79,1499,340,742,28,81,312,661,79,101,787
1988,Quintin Dailey,SG,27,LAC,67,1282,328,755,2,12,326,743,243,313,901
1988,Adrian Dantley*,SF,31,DET,69,2144,444,863,0,2,444,861,492,572,1380
1988,Brad Daugherty,C,22,CLE,79,2957,551,1081,0,2,551,1079,378,528,1480
1988,Brad Davis,PG,32,DAL,75,1480,208,415,30,74,178,341,91,108,537
1988,Charles Davis,SF,29,TOT,21,226,48,115,1,17,47,98,7,10,104
1988,Charles Davis,SF,29,MIL,5,39,6,18,0,2,6,16,0,0,12
1988,Charles Davis,SF,29,SAS,16,187,42,97,1,15,41,82,7,10,92
1988,Walter Davis,SF,33,PHO,68,1951,488,1031,36,96,452,935,205,231,1217
1988,Darryl Dawkins,C,31,TOT,6,33,2,9,0,0,2,9,6,15,10
1988,Darryl Dawkins,C,31,UTA,4,26,1,7,0,0,1,7,4,12,6
1988,Darryl Dawkins,C,31,DET,2,7,1,2,0,0,1,2,2,3,4
1988,Johnny Dawkins,PG,24,SAS,65,2179,405,835,19,61,386,774,198,221,1027
1988,Darren Daye,SF,27,BOS,47,655,112,217,0,1,112,216,59,87,283
1988,James Donaldson,C,30,DAL,81,2523,212,380,0,0,212,380,147,189,571
1988,Billy Donovan,PG,22,NYK,44,364,44,109,0,7,44,102,17,21,105
1988,Greg Dreiling,C,25,IND,20,74,8,17,0,0,8,17,18,26,34
1988,Larry Drew,PG,29,LAC,74,2024,328,720,26,90,302,630,83,108,765
1988,Clyde Drexler*,SG,25,POR,81,3060,849,1679,11,52,838,1627,476,587,2185
1988,Kevin Duckworth,C,23,POR,78,2223,450,907,0,0,450,907,331,430,1231
1988,Chris Dudley,C,22,CLE,55,513,65,137,0,0,65,137,40,71,170
1988,Joe Dumars*,SG,24,DET,82,2732,453,960,4,19,449,941,251,308,1161
1988,T.R. Dunn,SG,32,DEN,82,1534,70,156,0,1,70,155,40,52,180
1988,Mark Eaton,C,31,UTA,82,2731,226,541,0,0,226,541,119,191,571
1988,Franklin Edwards,PG,28,SAC,16,414,54,115,0,2,54,113,24,32,132
1988,James Edwards,C,32,TOT,69,1705,302,643,0,1,302,642,210,321,814
1988,James Edwards,C,32,PHO,43,1377,254,542,0,1,254,541,165,260,673
1988,James Edwards,C,32,DET,26,328,48,101,0,0,48,101,45,61,141
1988,Craig Ehlo,SG,26,CLE,79,1709,226,485,22,64,204,421,89,132,563
1988,Dale Ellis,SG,27,SEA,75,2790,764,1519,107,259,657,1260,303,395,1938
1988,Chris Engler,C,28,NJN,54,399,36,88,0,0,36,88,31,35,103
1988,Alex English*,SF,34,DEN,80,2818,843,1704,0,6,843,1698,314,379,2000
1988,Mike Evans,PG,32,DEN,56,656,139,307,36,91,103,216,30,37,344
1988,Patrick Ewing*,C,25,NYK,82,2546,656,1183,0,3,656,1180,341,476,1653
1988,Jim Farmer,SG,23,DAL,30,157,26,69,0,6,26,63,9,10,61
1988,Dave Feitl,C,25,GSW,70,1128,182,404,0,4,182,400,94,134,458
1988,Kenny Fields,SF,25,LAC,7,154,16,36,0,0,16,36,20,26,52
1988,Vern Fleming,PG,25,IND,80,2733,442,845,0,13,442,832,227,283,1111
1988,Sleepy Floyd,PG,27,TOT,77,2514,420,969,14,72,406,897,301,354,1155
1988,Sleepy Floyd,PG,27,GSW,18,680,132,301,1,20,131,281,116,139,381
1988,Sleepy Floyd,PG,27,HOU,59,1834,288,668,13,52,275,616,185,215,774
1988,Tellis Frank,PF,22,GSW,78,1597,242,565,0,1,242,564,150,207,634
1988,World B.,SG,34,HOU,58,682,143,350,8,35,135,315,80,100,374
1988,Kevin Gamble,SF,22,POR,9,19,0,3,0,1,0,2,0,0,0
1988,Winston Garland,PG,23,GSW,67,2122,340,775,13,39,327,736,138,157,831
1988,Armen Gilliam,PF,23,PHO,55,1807,342,720,0,0,342,720,131,193,815
1988,Artis Gilmore*,C,38,TOT,71,893,99,181,0,0,99,181,67,128,265
1988,Artis Gilmore*,C,38,CHI,24,372,41,80,0,0,41,80,19,37,101
1988,Artis Gilmore*,C,38,BOS,47,521,58,101,0,0,58,101,48,91,164
1988,Mike Gminski,C,28,TOT,81,2961,505,1126,0,2,505,1124,355,392,1365
1988,Mike Gminski,C,28,NJN,34,1194,215,474,0,2,215,472,143,166,573
1988,Mike Gminski,C,28,PHI,47,1767,290,652,0,0,290,652,212,226,792
1988,Lancaster Gordon,SG,25,LAC,8,65,11,31,0,0,11,31,6,6,28
1988,Horace Grant,PF,22,CHI,81,1827,254,507,0,2,254,505,114,182,622
1988,Stuart Gray,C,24,IND,74,807,90,193,0,1,90,192,44,73,224
1988,A.C. Green,PF,24,LAL,82,2636,322,640,0,2,322,638,293,379,937
1988,Rickey Green,PG,33,UTA,81,1116,157,370,4,19,153,351,75,83,393
1988,Sidney Green,PF,27,NYK,82,2049,258,585,0,2,258,583,126,190,642
1988,Dave Greenwood,PF,30,SAS,45,1236,151,328,0,2,151,326,83,111,385
1988,Claude Gregory,PF,29,LAC,23,313,61,134,0,1,61,133,12,36,134
1988,Darrell Griffith,SG,29,UTA,52,1052,251,585,28,102,223,483,59,92,589
1988,Petur Gudmundsson,C,29,SAS,69,1017,139,280,0,1,139,279,117,145,395
1988,Bob Hansen,SG,27,UTA,81,1796,316,611,32,97,284,514,113,152,777
1988,Bill Hanzlik,SF,30,DEN,77,1334,109,287,3,16,106,271,129,163,350
1988,Derek Harper,PG,26,DAL,82,3032,536,1167,60,192,476,975,261,344,1393
1988,Ron Harper,SG,24,CLE,57,1830,340,732,3,20,337,712,196,278,879
1988,Steve Harris,SG,24,TOT,58,1084,223,487,0,7,223,480,89,113,535
1988,Steve Harris,SG,24,HOU,14,199,34,86,0,1,34,85,15,16,83
1988,Steve Harris,SG,24,GSW,44,885,189,401,0,6,189,395,74,97,452
1988,Scott Hastings,PF,27,ATL,55,403,40,82,5,12,35,70,25,27,110
1988,Dave Henderson,SG,23,PHI,22,351,47,116,0,1,47,115,32,47,126
1988,Gerald Henderson,PG,32,TOT,75,1505,194,453,69,163,125,290,138,170,595
1988,Gerald Henderson,PG,32,NYK,6,69,5,14,2,4,3,10,2,2,14
1988,Gerald Henderson,PG,32,PHI,69,1436,189,439,67,159,122,280,136,168,581
1988,Kevin Henderson,SG,23,TOT,17,190,21,53,0,1,21,52,15,26,57
1988,Kevin Henderson,SG,23,GSW,12,170,19,48,0,1,19,47,10,14,48
1988,Kevin Henderson,SG,23,CLE,5,20,2,5,0,0,2,5,5,12,9
1988,Conner Henry,SG,24,TOT,39,433,62,150,20,45,42,105,39,47,183
1988,Conner Henry,SG,24,BOS,10,81,11,28,3,8,8,20,9,10,34
1988,Conner Henry,SG,24,MIL,14,145,13,41,2,6,11,35,4,7,32
1988,Conner Henry,SG,24,SAC,15,207,38,81,15,31,23,50,26,30,117
1988,Rod Higgins,SF,28,GSW,68,2188,381,725,19,39,362,686,273,322,1054
1988,Roy Hinson,SF,26,TOT,77,2592,453,930,0,2,453,928,272,351,1178
1988,Roy Hinson,SF,26,PHI,29,845,123,272,0,1,123,271,89,124,335
1988,Roy Hinson,SF,26,NJN,48,1747,330,658,0,1,330,657,183,227,843
1988,Craig Hodges,SG,27,TOT,66,1445,242,523,86,175,156,348,59,71,629
1988,Craig Hodges,SG,27,MIL,43,983,155,345,55,118,100,227,32,39,397
1988,Craig Hodges,SG,27,PHO,23,462,87,178,31,57,56,121,27,32,232
1988,Mike Holton,PG,26,POR,82,1279,163,353,3,15,160,338,107,129,436
1988,Dave Hoppen,C,23,TOT,39,642,84,183,0,1,84,182,54,62,222
1988,Dave Hoppen,C,23,MIL,3,35,4,11,0,0,4,11,3,3,11
1988,Dave Hoppen,C,23,GSW,36,607,80,172,0,1,80,171,51,59,211
1988,Dennis Hopson,SG,22,NJN,61,1365,222,549,12,45,210,504,131,177,587
1988,Jeff Hornacek,SG,24,PHO,82,2243,306,605,17,58,289,547,152,185,781
1988,Phil Hubbard,SF,31,CLE,78,1631,237,485,0,5,237,480,182,243,656
1988,Eddie Hughes,PG,27,UTA,11,42,5,13,1,6,4,7,6,6,17
1988,Jay Humphries,PG,25,TOT,68,1809,284,538,3,18,281,520,112,153,683
1988,Jay Humphries,PG,25,PHO,50,1557,264,484,3,16,261,468,103,139,634
1988,Jay Humphries,PG,25,MIL,18,252,20,54,0,2,20,52,9,14,49
1988,Marc Iavaroni,PF,31,UTA,81,1238,143,308,0,2,143,306,78,99,364
1988,Mark Jackson,PG,22,NYK,82,3249,438,1013,32,126,406,887,206,266,1114
1988,Michael Jackson,PG,23,SAC,58,760,64,171,6,25,58,146,23,32,157
1988,Buck Johnson,SF,24,HOU,70,879,155,298,1,8,154,290,67,91,378
1988,Clemon Johnson,C,31,SEA,74,723,49,105,0,0,49,105,22,32,120
1988,Dennis Johnson*,PG,33,BOS,77,2670,352,803,12,46,340,757,255,298,971
1988,Eddie Johnson,SF,28,PHO,73,2177,533,1110,24,94,509,1016,204,240,1294
1988,Frank Johnson,PG,29,WSB,75,1258,216,498,1,9,215,489,121,149,554
1988,Kannard Johnson,SF,22,CLE,4,12,1,3,0,0,1,3,0,0,2
1988,Kevin Johnson,PG,21,TOT,80,1917,275,596,5,24,270,572,177,211,732
1988,Kevin Johnson,PG,21,CLE,52,1043,143,311,2,9,141,302,92,112,380
1988,Kevin Johnson,PG,21,PHO,28,874,132,285,3,15,129,270,85,99,352
1988,Magic Johnson*,PG,28,LAL,72,2637,490,996,11,56,479,940,417,489,1408
1988,Steve Johnson,C,30,POR,43,1050,258,488,0,1,258,487,146,249,662
1988,Vinnie Johnson,SG,31,DET,82,1935,425,959,5,24,420,935,147,217,1002
1988,Caldwell Jones,C,37,POR,79,1778,128,263,0,4,128,259,78,106,334
1988,Charles Jones,PF,30,WSB,69,1313,72,177,0,1,72,176,53,75,197
1988,Charles Jones,PF,26,POR,37,186,16,40,0,1,16,39,19,33,51
1988,Michael Jordan*,SG,24,CHI,82,3311,1069,1998,7,53,1062,1945,723,860,2868
1988,Jerome Kersey,SF,25,POR,79,2888,611,1225,3,15,608,1210,291,396,1516
1988,Albert King,SF,28,PHI,72,1593,211,540,17,49,194,491,78,103,517
1988,Bernard King*,SF,31,WSB,69,2044,470,938,1,6,469,932,247,324,1188
1988,Greg Kite,C,26,TOT,53,1063,92,205,0,1,92,204,40,79,224
1988,Greg Kite,C,26,BOS,13,86,9,23,0,0,9,23,1,6,19
1988,Greg Kite,C,26,LAC,40,977,83,182,0,1,83,181,39,73,205
1988,Joe Kleine,C,26,SAC,82,1999,324,686,0,0,324,686,153,188,801
1988,Bart Kofoed,SG,23,UTA,36,225,18,48,2,7,16,41,8,13,46
1988,Jon Koncak,C,24,ATL,49,1073,98,203,0,2,98,201,83,136,279
1988,Larry Krystkowiak,PF,23,MIL,50,1050,128,266,0,3,128,263,103,127,359
1988,Bill Laimbeer,C,30,DET,82,2897,455,923,13,39,442,884,187,214,1110
1988,Jeff Lamp,SF,28,LAL,3,7,0,0,0,0,0,0,2,2,2
1988,Allen Leavell,SG,30,HOU,80,2150,291,666,19,88,272,578,218,251,819
1988,Fat Lever,SG,27,DEN,82,3061,643,1360,12,57,631,1303,248,316,1546
1988,Cliff Levingston,PF,27,ATL,82,2135,314,564,1,2,313,562,190,246,819
1988,Ralph Lewis,SG,24,DET,50,310,27,87,0,1,27,86,29,48,83
1988,Reggie Lewis,SG,22,BOS,49,405,90,193,0,4,90,189,40,57,220
1988,Alton Lister,C,29,SEA,82,1812,173,343,1,2,172,341,114,188,461
1988,Brad Lohaus,PF,23,BOS,70,718,122,246,3,13,119,233,50,62,297
1988,John Long,SG,31,IND,81,2022,417,879,34,77,383,802,166,183,1034
1988,John Lucas,PG,34,MIL,81,1766,281,631,51,151,230,480,130,162,743
1988,Maurice Lucas,PF,35,POR,73,1191,168,373,0,3,168,370,109,148,445
1988,Rick Mahorn,PF,29,DET,67,1963,276,481,1,2,275,479,164,217,717
1988,Jeff Malone,SG,26,WSB,80,2655,648,1360,10,24,638,1336,335,380,1641
1988,Karl Malone*,PF,24,UTA,82,3198,858,1650,0,5,858,1645,552,789,2268
1988,Moses Malone*,C,32,WSB,79,2692,531,1090,2,7,529,1083,543,689,1607
1988,Pace Mannion,SF,27,MIL,35,477,48,118,2,12,46,106,25,37,123
1988,Bill Martin,SF,25,PHO,10,101,16,51,0,1,16,50,8,13,40
1988,Maurice Martin,SF,23,DEN,26,136,23,61,1,4,22,57,10,21,57
1988,Wes Matthews,PG,28,LAL,51,706,114,248,7,30,107,218,54,65,289
1988,Cedric Maxwell,SF,32,HOU,71,848,80,171,0,2,80,169,110,143,270
1988,Tim McCormick,C,25,TOT,70,2114,348,648,0,2,348,646,145,215,841
1988,Tim McCormick,C,25,PHI,23,601,71,138,0,0,71,138,37,53,179
1988,Tim McCormick,C,25,NJN,47,1513,277,510,0,2,277,508,108,162,662
1988,Rodney McCray,SF,26,HOU,81,2689,359,746,0,4,359,742,288,367,1006
1988,Xavier McDaniel,SF,24,SEA,78,2703,687,1407,14,50,673,1357,281,393,1669
1988,Ben McDonald,PF,25,GSW,81,2039,258,552,9,35,249,517,87,111,612
1988,Mike McGee,SF-SG,28,TOT,48,1003,223,530,53,160,170,370,76,102,575
1988,Mike McGee,SG,28,ATL,11,117,22,52,5,19,17,33,2,6,51
1988,Mike McGee,SF,28,SAC,37,886,201,478,48,141,153,337,74,96,524
1988,Kevin McHale*,PF,30,BOS,64,2390,550,911,0,0,550,911,346,434,1446
1988,Kevin McKenna,SG,29,NJN,31,393,43,109,16,50,27,59,24,25,126
1988,Derrick McKey,SF,21,SEA,82,1706,255,519,11,30,244,489,173,224,694
1988,Nate McMillan,PG,23,SEA,82,2453,235,496,9,24,226,472,145,205,624
1988,Mark McNamara,C,28,PHI,42,581,52,133,0,0,52,133,48,66,152
1988,Chris McNealy,PF,26,NYK,19,265,23,74,0,0,23,74,21,31,67
1988,Reggie Miller*,SG,22,IND,82,1840,306,627,61,172,245,455,149,186,822
1988,Dirk Minniefield,PG,27,TOT,72,1070,108,221,4,16,104,205,41,55,261
1988,Dirk Minniefield,PG,27,GSW,11,202,25,48,1,5,24,43,14,23,65
1988,Dirk Minniefield,PG,27,BOS,61,868,83,173,3,11,80,162,27,32,196
1988,Mike Mitchell,SF,32,SAS,68,1501,378,784,3,12,375,772,160,194,919
1988,Paul Mokeski,C,31,MIL,60,848,100,210,0,4,100,206,51,72,251
1988,Sidney Moncrief,SG,30,MIL,56,1428,217,444,5,31,212,413,164,196,603
1988,Andre Moore,PF-SF,23,TOT,10,50,9,27,0,0,9,27,6,8,24
1988,Andre Moore,PF,23,DEN,7,34,7,24,0,0,7,24,6,6,20
1988,Andre Moore,SF,23,MIL,3,16,2,3,0,0,2,3,0,2,4
1988,Johnny Moore,PG,29,TOT,5,61,4,10,0,1,4,9,0,0,8
1988,Johnny Moore,PG,29,SAS,4,51,4,9,0,1,4,8,0,0,8
1988,Johnny Moore,PG,29,NJN,1,10,0,1,0,0,0,1,0,0,0
1988,Ron Moore,C,26,TOT,14,59,9,29,0,0,9,29,6,8,24
1988,Ron Moore,C,26,DET,9,25,4,13,0,0,4,13,2,4,10
1988,Ron Moore,C,26,PHO,5,34,5,16,0,0,5,16,4,4,14
1988,Chris Mullin*,SF,24,GSW,60,2033,470,926,34,97,436,829,239,270,1213
1988,Jay Murphy,PF,25,WSB,9,46,8,23,0,0,8,23,4,5,20
1988,Ronnie Murphy,SF,23,POR,18,89,14,49,1,4,13,45,7,11,36
1988,Tod Murphy,PF,24,LAC,1,19,1,1,0,0,1,1,3,4,5
1988,Pete Myers,SG,24,SAS,22,328,43,95,0,4,43,91,26,39,112
1988,Larry Nance,PF,28,TOT,67,2383,487,920,2,6,485,914,304,390,1280
1988,Larry Nance,PF,28,PHO,40,1477,327,616,2,5,325,611,187,249,843
1988,Larry Nance,PF,28,CLE,27,906,160,304,0,1,160,303,117,141,437
1988,Calvin Natt,PF,31,DEN,27,533,102,208,0,1,102,207,54,73,258
1988,Ed Nealy,PF,27,SAS,68,837,50,109,1,2,49,107,41,63,142
1988,Martin Nessley,C,22,TOT,44,336,20,52,0,0,20,52,8,18,48
1988,Martin Nessley,C,22,LAC,35,295,18,49,0,0,18,49,7,14,43
1988,Martin Nessley,C,22,SAC,9,41,2,3,0,0,2,3,1,4,5
1988,Chuck Nevitt,C,28,DET,17,63,7,21,0,0,7,21,3,6,17
1988,Johnny Newman,SF,24,NYK,77,1589,270,620,26,93,244,527,207,246,773
1988,Kurt Nimphius,C,29,SAS,72,919,128,257,0,1,128,256,60,83,316
1988,Ken Norman,SF,23,LAC,66,1435,241,500,0,10,241,490,87,170,569
1988,Mike O'Koren,SF,29,NJN,4,52,9,16,0,1,9,15,0,4,18
1988,Charles Oakley,PF,24,CHI,82,2816,375,776,3,12,372,764,261,359,1014
1988,Hakeem Olajuwon*,C,25,HOU,79,2825,712,1385,0,4,712,1381,381,548,1805
1988,Jawann Oldham,C,30,SAC,54,946,119,250,0,0,119,250,59,87,297
1988,Louis Orr,SF,29,NYK,29,180,16,50,0,1,16,49,8,16,40
1988,Robert Parish*,C,34,BOS,74,2312,442,750,0,1,442,749,177,241,1061
1988,Jim Paxson,SG,30,TOT,45,801,137,298,5,21,132,277,68,79,347
1988,Jim Paxson,SG,30,POR,17,263,43,107,3,8,40,99,14,18,103
1988,Jim Paxson,SG,30,BOS,28,538,94,191,2,13,92,178,54,61,244
1988,John Paxson,PG,27,CHI,81,1888,287,582,33,95,254,487,33,45,640
1988,Sam Perkins,PF,26,DAL,75,2499,394,876,5,30,389,846,273,332,1066
1988,Chuck Person,SF,23,IND,79,2807,575,1252,59,177,516,1075,132,197,1341
1988,Jim Petersen,PF,25,HOU,69,1793,249,488,1,6,248,482,114,153,613
1988,Michael Phelps,SG,26,LAC,2,23,3,7,0,0,3,7,3,4,9
1988,Ricky Pierce,SG,28,MIL,37,965,248,486,3,14,245,472,107,122,606
1988,Ed Pinckney,PF,24,SAC,79,1177,179,343,0,2,179,341,133,178,491
1988,Scottie Pippen*,SF,22,CHI,79,1650,261,564,4,23,257,541,99,172,625
1988,Olden Polynice,C,23,SEA,82,1080,118,254,0,2,118,252,101,158,337
1988,Terry Porter,PG,24,POR,82,2991,462,890,24,69,438,821,274,324,1222
1988,Paul Pressey,SG,29,MIL,75,2484,345,702,8,39,337,663,285,357,983
1988,Harold Pressley,SF,24,SAC,80,2029,318,702,36,110,282,592,103,130,775
1988,Mark Price,PG,23,CLE,80,2626,493,974,72,148,421,826,221,252,1279
1988,Kurt Rambis,PF,29,LAL,70,845,102,186,0,0,102,186,73,93,277
1988,Blair Rasmussen,C,25,DEN,79,1779,435,884,0,0,435,884,132,170,1002
1988,Robert Reid,SG,32,HOU,62,980,165,356,13,34,152,322,50,63,393
1988,Richard Rellford,SF,23,SAS,4,42,5,8,0,0,5,8,6,8,16
1988,Jerry Reynolds,SF,25,MIL,62,1161,188,419,3,7,185,412,119,154,498
1988,Doc Rivers,PG,26,ATL,80,2502,403,890,9,33,394,857,319,421,1134
1988,Fred Roberts,PF,27,BOS,74,1032,161,330,0,6,161,324,128,165,450
1988,Alvin Robertson,SG,25,SAS,82,2978,655,1408,27,95,628,1313,273,365,1610
1988,Cliff Robinson,SF,27,PHI,62,2110,483,1041,2,9,481,1032,210,293,1178
1988,Dennis Rodman*,SF,26,DET,82,2147,398,709,5,17,393,692,152,284,953
1988,Johnny Rogers,PF,24,CLE,24,168,26,61,0,2,26,59,10,13,62
1988,Tree Rollins,C,32,ATL,76,1765,133,260,0,0,133,260,70,80,336
1988,Scott Roth,SF,24,UTA,26,201,30,74,2,11,28,63,22,30,84
1988,Brian Rowsom,PF,22,IND,4,16,0,6,0,0,0,6,6,6,6
1988,Walker Russell,PG,27,DET,1,1,0,1,0,1,0,0,0,0,0
1988,John Salley,C,23,DET,82,2003,258,456,0,0,258,456,185,261,701
1988,Ralph Sampson*,C-PF,27,TOT,48,1663,299,682,2,11,297,671,149,196,749
1988,Ralph Sampson*,PF,27,HOU,19,705,119,271,2,6,117,265,63,85,303
1988,Ralph Sampson*,C,27,GSW,29,958,180,411,0,5,180,406,86,111,446
1988,Mike Sanders,SF,27,TOT,59,883,153,303,0,1,153,302,59,76,365
1988,Mike Sanders,SF,27,PHO,35,466,82,171,0,1,82,170,39,53,203
1988,Mike Sanders,SF,27,CLE,24,417,71,132,0,0,71,132,20,23,162
1988,Danny Schayes,PF,28,DEN,81,2166,361,668,0,2,361,666,407,487,1129
1988,Russ Schoene,PF,27,SEA,81,973,208,454,17,58,191,396,51,63,484
1988,Detlef Schrempf,SF,25,DAL,82,1587,246,539,5,32,241,507,201,266,698
1988,Byron Scott,SG,26,LAL,81,3048,710,1348,62,179,648,1169,272,317,1754
1988,Carey Scurry,SF,25,TOT,33,455,55,118,3,8,52,110,27,39,140
1988,Carey Scurry,SF,25,UTA,29,447,54,116,3,8,51,108,27,39,138
1988,Carey Scurry,SF,25,NYK,4,8,1,2,0,0,1,2,0,0,2
1988,Brad Sellers,SF,25,CHI,82,2212,326,714,1,7,325,707,124,157,777
1988,Purvis Short,SG,30,HOU,81,1949,474,986,5,21,469,965,206,240,1159
1988,Jerry Sichting,PG,31,TOT,52,694,93,172,10,22,83,150,17,23,213
1988,Jerry Sichting,PG,31,BOS,24,370,44,82,2,8,42,74,8,12,98
1988,Jerry Sichting,PG,31,POR,28,324,49,90,8,14,41,76,9,11,115
1988,Jack Sikma,C,32,MIL,82,2923,514,1058,3,14,511,1044,321,348,1352
1988,Scott Skiles,PG,23,IND,51,760,86,209,6,20,80,189,45,54,223
1988,Derek Smith,SG,26,SAC,35,899,174,364,8,23,166,341,87,113,443
1988,Kenny Smith,PG,22,SAC,61,2170,331,694,12,39,319,655,167,204,841
1988,Larry Smith,PF,30,GSW,20,499,58,123,0,1,58,122,11,27,127
1988,Otis Smith,SG,24,TOT,72,1549,325,662,13,41,312,621,178,229,841
1988,Otis Smith,SG,24,DEN,15,191,37,93,0,0,37,93,21,28,95
1988,Otis Smith,SG,24,GSW,57,1358,288,569,13,41,275,528,157,201,746
1988,Mike Smrek,C,25,LAL,48,421,44,103,0,0,44,103,44,66,132
1988,Rory Sparrow,PG,29,TOT,58,1044,117,293,2,13,115,280,24,33,260
1988,Rory Sparrow,PG,29,NYK,3,52,5,19,0,1,5,18,0,0,10
1988,Rory Sparrow,PG,29,CHI,55,992,112,274,2,12,110,262,24,33,250
1988,Steve Stipanovich,C,27,IND,80,2692,411,828,3,15,408,813,254,314,1079
1988,John Stockton*,PG,25,UTA,82,2842,454,791,24,67,430,724,272,324,1204
1988,John Stroeder,PF,29,MIL,41,271,29,79,0,2,29,77,20,30,78
1988,Jon Sundvold,PG,26,SAS,52,1024,176,379,26,64,150,315,43,48,421
1988,Roy Tarpley,PF,23,DAL,81,2307,444,888,0,5,444,883,205,277,1093
1988,Terry Teagle,SG,27,GSW,47,958,248,546,1,9,247,537,97,121,594
1988,Reggie Theus,SG,30,SAC,73,2653,619,1318,16,59,603,1259,320,385,1574
1988,Isiah Thomas*,PG,26,DET,81,2927,621,1341,30,97,591,1244,305,394,1577
1988,Bernard Thompson,SF,25,PHO,37,566,74,159,0,2,74,157,43,60,191
1988,Billy Thompson,SF,24,LAL,9,38,3,13,0,0,3,13,8,10,14
1988,LaSalle Thompson,C,26,SAC,69,1257,215,456,2,5,213,451,118,164,550
1988,Mychal Thompson,C,33,LAL,80,2007,370,722,0,3,370,719,185,292,925
1988,Bob Thornton,PF,25,TOT,48,593,65,130,0,2,65,128,34,55,164
1988,Bob Thornton,PF,25,NYK,7,85,6,19,0,0,6,19,5,8,17
1988,Bob Thornton,PF,25,PHI,41,508,59,111,0,2,59,109,29,47,147
1988,Otis Thorpe,PF,25,SAC,82,3072,622,1226,0,6,622,1220,460,609,1704
1988,Sedale Threatt,PG,26,TOT,71,1055,216,425,3,27,213,398,57,71,492
1988,Sedale Threatt,PG,26,CHI,45,701,132,263,2,20,130,243,32,41,298
1988,Sedale Threatt,PG,26,SEA,26,354,84,162,1,7,83,155,25,30,194
1988,Wayman Tisdale,PF,23,IND,79,2378,511,998,0,2,511,996,246,314,1268
1988,Ray Tolbert,PF,29,TOT,25,259,35,69,0,0,35,69,19,30,89
1988,Ray Tolbert,PF,29,NYK,11,177,19,41,0,0,19,41,9,17,47
1988,Ray Tolbert,PF,29,LAL,14,82,16,28,0,0,16,28,10,13,42
1988,Andrew Toney,SG,30,PHI,29,522,72,171,9,27,63,144,58,72,211
1988,Sedric Toney,PG,25,NYK,21,139,21,48,5,14,16,34,10,11,57
1988,Kelly Tripucka,SF,28,UTA,49,976,139,303,31,74,108,229,59,68,368
1988,Trent Tucker,SG,28,NYK,71,1248,193,455,69,167,124,288,51,71,506
1988,Andre Turner,PG,23,HOU,12,99,12,34,1,7,11,27,10,14,35
1988,Elston Turner,SF,28,CHI,17,98,8,30,0,0,8,30,1,2,17
1988,Melvin Turpin,C,27,UTA,79,1011,199,389,1,3,198,386,71,98,470
1988,Terry Tyler,SF,31,SAC,74,1185,184,407,1,7,183,400,41,64,410
1988,Darnell Valentine,PG,28,LAC,79,1636,223,533,15,33,208,500,101,136,562
1988,Kiki Vandeweghe,SF,29,POR,37,1038,283,557,22,58,261,499,159,181,747
1988,Jay Vincent,SF,28,DEN,73,1755,446,958,1,4,445,954,231,287,1124
1988,Sam Vincent,PG,24,TOT,72,1501,210,461,8,21,202,440,145,167,573
1988,Sam Vincent,PG,24,SEA,43,548,72,152,5,13,67,139,46,60,195
1988,Sam Vincent,PG,24,CHI,29,953,138,309,3,8,135,301,99,107,378
1988,Danny Vranes,SF,29,PHI,57,772,53,121,0,3,53,118,15,35,121
1988,Mark Wade,PG,22,GSW,11,123,3,20,0,2,3,18,2,4,8
1988,Milt Wagner,SG,24,LAL,40,380,62,147,2,10,60,137,26,29,152
1988,Granville Waiters,C,27,CHI,22,114,9,29,0,1,9,28,0,2,18
1988,Darrell Walker,SG,26,WSB,52,940,114,291,0,6,114,285,82,105,310
1988,Kenny Walker,SF,23,NYK,82,2139,344,728,0,1,344,727,138,178,826
1988,Jamie Waller,SG,23,NJN,9,91,16,40,0,2,16,38,10,18,42
1988,Chris Washburn,C,22,TOT,37,260,36,81,0,0,36,81,18,31,90
1988,Chris Washburn,C,22,GSW,8,86,14,32,0,0,14,32,5,8,33
1988,Chris Washburn,C,22,ATL,29,174,22,49,0,0,22,49,13,23,57
1988,Duane Washington,SG,23,NJN,15,156,18,42,2,4,16,38,16,20,54
1988,Kermit Washington,PF,36,GSW,6,56,7,14,0,0,7,14,2,2,16
1988,Pearl Washington,PG,24,NJN,68,1379,245,547,11,49,234,498,132,189,633
1988,Spud Webb,PG,24,ATL,82,1347,191,402,1,19,190,383,107,131,490
1988,Chris Welp,C,24,PHI,10,132,18,31,0,0,18,31,12,18,48
1988,Bill Wennington,C,24,DAL,30,125,25,49,1,2,24,47,12,19,63
1988,Mark West,C,27,TOT,83,2098,316,573,0,1,316,572,170,285,802
1988,Mark West,C,27,CLE,54,1183,182,316,0,0,182,316,95,153,459
1988,Mark West,C,27,PHO,29,915,134,257,0,1,134,256,75,132,343
1988,Ennis Whatley,PG,25,ATL,5,24,4,9,0,0,4,9,3,4,11
1988,Clinton Wheeler,PG,28,IND,59,513,62,132,0,0,62,132,25,34,149
1988,Eric White,SF,22,LAC,17,352,66,124,1,1,65,123,45,57,178
1988,Tony White,PG,22,TOT,49,581,111,249,0,6,111,243,39,54,261
1988,Tony White,PG,22,CHI,2,2,0,0,0,0,0,0,0,0,0
1988,Tony White,PG,22,NYK,12,117,17,46,0,1,17,45,9,13,43
1988,Tony White,PG,22,GSW,35,462,94,203,0,5,94,198,30,41,218
1988,Jerome Whitehead,C,31,GSW,72,1221,174,360,0,0,174,360,59,82,407
1988,Dominique Wilkins*,SF,28,ATL,78,2948,909,1957,38,129,871,1828,541,655,2397
1988,Gerald Wilkins,SG,24,NYK,81,2703,591,1324,39,129,552,1195,191,243,1412
1988,Buck Williams,PF,27,NJN,70,2637,466,832,1,1,465,831,346,518,1279
1988,Herb Williams,C,29,IND,75,1966,311,732,0,6,311,726,126,171,748
1988,Hot Rod,PF,25,CLE,77,2106,316,663,0,1,316,662,211,279,843
1988,John Williams,SF,21,WSB,82,2428,427,910,5,38,422,872,188,256,1047
1988,Kevin Williams,SG,26,SEA,80,1084,199,450,1,7,198,443,103,122,502
1988,Reggie Williams,SF,23,LAC,35,857,152,427,13,58,139,369,48,66,365
1988,Kevin Willis,PF,25,ATL,75,2091,356,687,0,2,356,685,159,245,871
1988,Nikita Wilson,SF,23,POR,15,54,7,23,0,0,7,23,5,6,19
1988,Ricky Wilson,PG,23,TOT,24,420,43,110,10,26,33,84,29,40,125
1988,Ricky Wilson,PG,23,NJN,6,47,7,11,1,1,6,10,6,11,21
1988,Ricky Wilson,PG,23,SAS,18,373,36,99,9,25,27,74,23,29,104
1988,David Wingate,SG,24,PHI,61,1419,218,545,10,40,208,505,99,132,545
1988,Rickie Winslow,SF,23,MIL,7,45,3,13,0,1,3,12,1,2,7
1988,Randy Wittman,SG,28,ATL,82,2412,376,787,0,0,376,787,71,89,823
1988,Joe Wolf,C,23,LAC,42,1137,136,334,3,15,133,319,45,54,320
1988,Leon Wood,PG,25,TOT,52,909,136,312,52,127,84,185,76,99,400
1988,Leon Wood,PG,25,SAS,38,830,120,282,43,108,77,174,69,91,352
1988,Leon Wood,PG,25,ATL,14,79,16,30,9,19,7,11,7,8,48
1988,Mike Woodson,SG,29,LAC,80,2534,562,1263,18,78,544,1185,296,341,1438
1988,Orlando Woolridge,SF,28,NJN,19,622,110,247,0,2,110,245,92,130,312
1988,James Worthy*,SF,26,LAL,75,2655,617,1161,2,16,615,1145,242,304,1478
1988,Brad Wright,PF,25,DEN,2,7,1,5,0,0,1,5,0,0,2
1988,Danny Young,PG,25,SEA,77,949,89,218,22,77,67,141,43,53,243
1988,Phil Zevenbergen,C,23,SAS,8,58,15,27,0,0,15,27,0,2,30
,,,,,,,,,,,,,,,
1989,Kareem Abdul-Jabbar*,C,41,LAL,74,1695,313,659,0,3,313,656,122,165,748
1989,Mark Acres,C,26,BOS,62,632,55,114,1,1,54,113,26,48,137
1989,Michael Adams,PG,26,DEN,77,2787,468,1082,166,466,302,616,322,393,1424
1989,Mark Aguirre,SF,29,TOT,80,2597,586,1270,51,174,535,1096,288,393,1511
1989,Mark Aguirre,SF,29,DAL,44,1529,373,829,29,99,344,730,178,244,953
1989,Mark Aguirre,SF,29,DET,36,1068,213,441,22,75,191,366,110,149,558
1989,Danny Ainge,PG,29,TOT,73,2377,480,1051,116,305,364,746,205,240,1281
1989,Danny Ainge,PG,29,BOS,45,1349,271,589,58,155,213,434,114,128,714
1989,Danny Ainge,PG,29,SAC,28,1028,209,462,58,150,151,312,91,112,567
1989,Mark Alarie,PF,25,WSB,74,1141,206,431,13,38,193,393,73,87,498
1989,Steve Alford,PG,24,TOT,66,906,148,324,20,55,128,269,50,61,366
1989,Steve Alford,PG,24,DAL,9,38,3,11,0,2,3,9,1,2,7
1989,Steve Alford,PG,24,GSW,57,868,145,313,20,53,125,260,49,59,359
1989,Randy Allen,SG,24,SAC,7,43,8,19,0,1,8,18,1,2,17
1989,Greg Anderson,PF,24,SAS,82,2401,460,914,0,3,460,911,207,403,1127
1989,Michael Anderson,PG,22,SAS,36,730,73,175,1,7,72,168,57,82,204
1989,Richard Anderson,PF,28,POR,72,1082,145,348,49,141,96,207,32,38,371
1989,Ron Anderson,SF,30,PHI,82,2618,566,1152,2,11,564,1141,196,229,1330
1989,Willie Anderson,SF,22,SAS,81,2738,640,1285,4,21,636,1264,224,289,1508
1989,John Bagley,PG,28,NJN,68,1642,200,481,11,54,189,427,89,123,500
1989,Thurl Bailey,SF,27,UTA,82,2777,615,1272,2,5,613,1267,363,440,1595
1989,Greg Ballard,SF,34,SEA,2,15,1,8,0,1,1,7,4,4,6
1989,Ken Bannister,PF,28,LAC,9,130,22,36,0,1,22,35,30,53,74
1989,Charles Barkley*,PF,25,PHI,79,3088,700,1208,35,162,665,1046,602,799,2037
1989,John Battle,SG,26,ATL,82,1672,287,628,11,34,276,594,194,238,779
1989,Benoit Benjamin,C,24,LAC,79,2585,491,907,0,2,491,905,317,426,1299
1989,Ricky Berry,SG,24,SAC,64,1406,255,567,65,160,190,407,131,166,706
1989,Walter Berry,PF,24,TOT,69,1355,254,501,1,2,253,499,100,143,609
1989,Walter Berry,PF,24,NJN,29,556,108,231,0,0,108,231,43,63,259
1989,Walter Berry,PF,24,HOU,40,799,146,270,1,2,145,268,57,80,350
1989,Larry Bird*,SF,32,BOS,6,189,49,104,0,0,49,104,18,19,116
1989,Otis Birdsong,SG,33,BOS,13,108,18,36,1,3,17,33,0,2,37
1989,Uwe Blab,C,26,DAL,37,208,24,52,0,0,24,52,20,25,68
1989,Rolando Blackman,SG,29,DAL,78,2946,594,1249,30,85,564,1164,316,370,1534
1989,Muggsy Bogues,PG,24,CHH,79,1755,178,418,1,13,177,405,66,88,423
1989,Manute Bol,C,26,GSW,80,1769,127,344,20,91,107,253,40,66,314
1989,Anthony Bowie,SG,25,SAS,18,438,72,144,1,5,71,139,10,15,155
1989,Sam Bowie,C,27,POR,20,412,69,153,5,7,64,146,28,49,171
1989,Dudley Bradley,SG,31,ATL,38,267,28,86,8,31,20,55,8,16,72
1989,Adrian Branch,SF,25,POR,67,811,202,436,7,31,195,405,87,120,498
1989,Randy Breuer,C,28,MIL,48,513,86,179,0,0,86,179,28,51,200
1989,Frank Brickowski,C,29,SAS,64,1822,337,654,0,2,337,652,201,281,875
1989,Scott Brooks,PG,23,PHI,82,1372,156,371,55,153,101,218,61,69,428
1989,Mike Brown,C,25,UTA,66,1051,104,248,0,0,104,248,92,130,300
1989,Tony Brown,SF-SG,28,TOT,43,365,50,118,4,16,46,102,24,31,128
1989,Tony Brown,SG,28,HOU,14,91,14,45,2,9,12,36,6,8,36
1989,Tony Brown,SF,28,MIL,29,274,36,73,2,7,34,66,18,23,92
1989,Mark Bryant,PF,23,POR,56,803,120,247,0,0,120,247,40,69,280
1989,Greg Butler,C,22,NYK,33,140,20,48,0,3,20,45,16,20,56
1989,Michael Cage,PF,27,SEA,80,2536,314,630,0,4,314,626,197,265,825
1989,Tony Campbell,SF,26,LAL,63,787,158,345,2,21,156,324,70,83,388
1989,Antoine Carr,PF,27,ATL,78,1488,226,471,0,1,226,470,130,152,582
1989,Joe Barry,C,30,NJN,64,1996,363,810,0,0,363,810,176,220,902
1989,Bill Cartwright,C,31,CHI,78,2333,365,768,0,0,365,768,236,308,966
1989,Terry Catledge,PF,25,WSB,79,2077,334,681,1,5,333,676,153,254,822
1989,Ron Cavenall,C,29,NJN,5,16,2,3,0,0,2,3,2,5,6
1989,Tom Chambers,PF,29,PHO,81,3002,774,1643,28,86,746,1557,509,598,2085
1989,Mike Champion,SF,24,SEA,2,4,0,3,0,1,0,2,0,0,0
1989,Rex Chapman,SG,21,CHH,75,2219,526,1271,60,191,466,1080,155,195,1267
1989,Maurice Cheeks,PG,32,PHI,71,2298,336,696,1,13,335,683,151,195,824
1989,Derrick Chievous,SF,21,HOU,81,1539,277,634,5,24,272,610,191,244,750
1989,Ben Coleman,PF,27,PHI,58,703,117,241,0,0,117,241,61,77,295
1989,Steve Colter,PG,26,WSB,80,1425,203,457,3,25,200,432,125,167,534
1989,Dallas Comegys,PF,24,SAS,67,1119,166,341,0,2,166,339,106,161,438
1989,Lester Conner,PG,29,NJN,82,2532,309,676,13,37,296,639,212,269,843
1989,Darwin Cook,SG,30,TOT,66,1143,218,478,8,41,210,437,63,78,507
1989,Darwin Cook,SG,30,SAS,36,757,147,315,6,31,141,284,46,56,346
1989,Darwin Cook,SG,30,DEN,30,386,71,163,2,10,69,153,17,22,161
1989,Michael Cooper,SG,32,LAL,80,1943,213,494,80,210,133,284,81,93,587
1989,Wayne Cooper,C,32,DEN,79,1864,220,444,1,4,219,440,79,106,520
1989,Tyrone Corbin,SF,26,PHO,77,1655,245,454,0,2,245,452,141,179,631
1989,Dave Corzine,C,32,CHI,81,1483,203,440,2,8,201,432,71,96,479
1989,Winston Crite,SF,23,PHO,2,6,0,3,0,0,0,3,0,0,0
1989,Pat Cummings,PF,32,MIA,53,1096,197,394,0,2,197,392,72,97,466
1989,Terry Cummings,SF,27,MIL,80,2824,730,1563,7,15,723,1548,362,460,1829
1989,Earl Cureton,C,31,CHH,82,2047,233,465,0,1,233,464,66,123,532
1989,Dell Curry,SG,24,CHH,48,813,256,521,19,55,237,466,40,46,571
1989,Quintin Dailey,SG,28,LAC,69,1722,448,964,1,9,447,955,217,286,1114
1989,Adrian Dantley*,SF,32,TOT,73,2422,470,954,0,1,470,953,460,568,1400
1989,Adrian Dantley*,SF,32,DET,42,1341,258,495,0,0,258,495,256,305,772
1989,Adrian Dantley*,SF,32,DAL,31,1081,212,459,0,1,212,458,204,263,628
1989,Brad Daugherty,C,23,CLE,78,2821,544,1012,1,3,543,1009,386,524,1475
1989,Brad Davis,PG,33,DAL,78,1395,183,379,32,102,151,277,99,123,497
1989,Charles Davis,SF,30,CHI,49,545,81,190,4,15,77,175,19,26,185
1989,Mark Davis,SF,25,TOT,33,258,49,102,1,10,48,92,28,34,127
1989,Mark Davis,SF,25,PHO,2,7,1,5,0,1,1,4,2,2,4
1989,Mark Davis,SF,25,MIL,31,251,48,97,1,9,47,88,26,32,123
1989,Walter Davis,SG,34,DEN,81,1857,536,1076,20,69,516,1007,175,199,1267
1989,Darryl Dawkins,C,32,DET,14,48,9,19,0,0,9,19,9,18,27
1989,Johnny Dawkins,PG,25,SAS,32,1083,177,400,0,4,177,396,100,112,454
1989,Vinny Del,SG,22,SAC,80,1556,239,503,6,20,233,483,85,100,569
1989,Fennis Dembo,SF,23,DET,31,74,14,42,0,4,14,38,8,10,36
1989,James Donaldson,C,31,DAL,53,1746,193,337,0,0,193,337,95,124,481
1989,Greg Dreiling,C,26,IND,53,396,43,77,0,0,43,77,43,64,129
1989,Clyde Drexler*,SG,26,POR,78,3064,829,1672,27,104,802,1568,438,548,2123
1989,Kevin Duckworth,C,24,POR,79,2662,554,1161,0,2,554,1159,324,428,1432
1989,Chris Dudley,C,23,CLE,61,544,73,168,0,1,73,167,39,107,185
1989,Joe Dumars*,SG,25,DET,69,2408,456,903,14,29,442,874,260,306,1186
1989,Mike Dunleavy,PG,34,MIL,2,5,1,2,1,2,0,0,0,0,3
1989,T.R. Dunn,SG,33,PHO,34,321,12,35,0,0,12,35,9,12,33
1989,Ledell Eackles,SG,22,WSB,80,1459,318,732,9,40,309,692,272,346,917
1989,Mark Eaton,C,32,UTA,82,2914,188,407,0,0,188,407,132,200,508
1989,James Edwards,C,33,DET,76,1254,211,422,0,2,211,420,133,194,555
1989,Kevin Edwards,SG,23,MIA,79,2349,470,1105,10,37,460,1068,144,193,1094
1989,Craig Ehlo,SG,27,CLE,82,1867,249,524,39,100,210,424,71,117,608
1989,Dale Ellis,SG,28,SEA,82,3190,857,1710,162,339,695,1371,377,462,2253
1989,Wayne Englestad,PF,22,DEN,11,50,11,29,0,0,11,29,6,10,28
1989,Alex English*,SF,35,DEN,82,2990,924,1881,2,8,922,1873,325,379,2175
1989,Patrick Ewing*,C,26,NYK,80,2896,727,1282,0,6,727,1276,361,484,1815
1989,Jim Farmer,SG,24,UTA,37,412,57,142,9,20,48,122,29,41,152
1989,Dave Feitl,C,26,WSB,57,828,116,266,0,1,116,265,54,65,286
1989,Rolando Ferreira,C,24,POR,12,34,1,18,0,0,1,18,7,8,9
1989,Duane Ferrell,SF,23,ATL,41,231,35,83,0,0,35,83,30,44,100
1989,Vern Fleming,PG,26,IND,76,2552,419,814,3,23,416,791,243,304,1084
1989,Sleepy Floyd,PG,28,HOU,82,2788,396,893,109,292,287,601,261,309,1162
1989,Tellis Frank,PF,23,GSW,32,245,34,91,0,1,34,90,39,51,107
1989,Anthony Frederick,SF,24,IND,46,313,63,125,2,5,61,120,24,34,152
1989,Corey Gaines,SG,23,NJN,32,337,27,64,1,5,26,59,12,16,67
1989,Kevin Gamble,SF,23,BOS,44,375,75,136,2,11,73,125,35,55,187
1989,Winston Garland,PG,24,GSW,79,2661,466,1074,10,43,456,1031,203,251,1145
1989,Tom Garrick,SG,22,LAC,71,1499,176,359,0,13,176,346,102,127,454
1989,Kenny Gattison,PF,24,PHO,2,9,0,1,0,0,0,1,1,2,1
1989,Ben Gillery,C,23,SAC,24,84,6,19,0,0,6,19,13,23,25
1989,Armen Gilliam,PF,24,PHO,74,2120,468,930,0,0,468,930,240,323,1176
1989,Mike Gminski,C,29,PHI,82,2739,556,1166,0,6,556,1160,297,341,1409
1989,Grant Gondrezick,SG,26,LAC,27,244,38,95,3,11,35,84,26,40,105
1989,Orlando Graham,PF,23,GSW,7,22,3,10,0,0,3,10,2,4,8
1989,Ron Grandison,PF,24,BOS,72,528,59,142,0,10,59,132,59,80,177
1989,Gary Grant,PG,23,LAC,71,1924,361,830,5,22,356,808,119,162,846
1989,Harvey Grant,PF,23,WSB,71,1193,181,390,0,1,181,389,34,57,396
1989,Horace Grant,PF,23,CHI,79,2809,405,781,0,5,405,776,140,199,950
1989,Stuart Gray,C,25,IND,72,783,72,153,0,1,72,152,44,64,188
1989,Sylvester Gray,SF,21,MIA,55,1220,167,398,1,4,166,394,105,156,440
1989,Jeff Grayer,SG,23,MIL,11,200,32,73,0,2,32,71,17,20,81
1989,A.C. Green,PF,25,LAL,82,2510,401,758,4,17,397,741,282,359,1088
1989,Rickey Green,PG,34,TOT,63,871,129,264,3,11,126,253,30,33,291
1989,Rickey Green,PG,34,CHH,33,370,57,132,1,5,56,127,13,14,128
1989,Rickey Green,PG,34,MIL,30,501,72,132,2,6,70,126,17,19,163
1989,Sidney Green,PF,28,NYK,82,1277,194,422,0,3,194,419,129,170,517
1989,Dave Greenwood,PF,31,TOT,67,1403,167,395,0,0,167,395,132,176,466
1989,Dave Greenwood,PF,31,SAS,38,912,105,247,0,0,105,247,84,105,294
1989,Dave Greenwood,PF,31,DEN,29,491,62,148,0,0,62,148,48,71,172
1989,Darrell Griffith,SG,30,UTA,82,2382,466,1045,61,196,405,849,142,182,1135
1989,Petur Gudmundsson,C,30,SAS,5,70,9,25,0,0,9,25,3,4,21
1989,Jack Haley,PF,25,CHI,51,289,37,78,0,0,37,78,36,46,110
1989,Bob Hansen,SG,28,UTA,46,964,140,300,19,54,121,246,42,75,341
1989,Bill Hanzlik,PF,31,DEN,41,701,66,151,1,5,65,146,68,87,201
1989,Derek Harper,PG,27,DAL,81,2968,538,1127,99,278,439,849,229,284,1404
1989,Ron Harper,SG,25,CLE,82,2851,587,1149,29,116,558,1033,323,430,1526
1989,Steve Harris,SG,25,DET,3,7,1,4,0,0,1,4,2,2,4
1989,Scott Hastings,C,28,MIA,75,1206,143,328,9,28,134,300,91,107,386
1989,Hersey Hawkins,SG,22,PHI,79,2577,442,971,71,166,371,805,241,290,1196
1989,Gerald Henderson,PG,33,PHI,65,986,144,348,33,107,111,241,104,127,425
1989,Rod Higgins,PF,29,GSW,81,1887,301,633,66,168,235,465,188,229,856
1989,Roy Hinson,SF,27,NJN,82,2542,495,1027,0,2,495,1025,318,420,1308
1989,Craig Hodges,SG,28,TOT,59,1204,203,430,75,180,128,250,48,57,529
1989,Craig Hodges,SG,28,PHO,10,92,16,36,4,12,12,24,3,4,39
1989,Craig Hodges,SG,28,CHI,49,1112,187,394,71,168,116,226,45,53,490
1989,Mike Holton,PG,27,CHH,67,1696,215,504,3,14,212,490,120,143,553
1989,Dave Hoppen,C,24,CHH,77,1419,199,353,1,2,198,351,101,139,500
1989,Dennis Hopson,SG,23,NJN,62,1551,299,714,4,27,295,687,186,219,788
1989,Tito Horford,C,23,MIL,25,112,15,46,0,0,15,46,12,19,42
1989,Jeff Hornacek,SG,25,PHO,78,2487,440,889,27,81,413,808,147,178,1054
1989,Phil Hubbard,SF,32,CLE,31,191,28,63,0,0,28,63,17,25,73
1989,Eddie Hughes,PG,28,DEN,26,224,28,64,7,22,21,42,7,12,70
1989,Jay Humphries,PG,26,MIL,73,2220,345,714,25,94,320,620,129,158,844
1989,Marc Iavaroni,PF,32,UTA,77,796,72,163,0,1,72,162,36,44,180
1989,Mark Jackson,PG,23,NYK,72,2477,479,1025,81,240,398,785,180,258,1219
1989,Michael Jackson,PG,24,SAC,14,70,9,24,2,6,7,18,1,2,21
1989,Avery Johnson,PG,23,SEA,43,291,29,83,1,9,28,74,9,16,68
1989,Buck Johnson,SF,25,HOU,67,1850,270,515,1,9,269,506,101,134,642
1989,Dennis Johnson*,PG,34,BOS,72,2309,277,638,7,50,270,588,160,195,721
1989,Eddie Johnson,SF,29,PHO,70,2043,608,1224,71,172,537,1052,217,250,1504
1989,Frank Johnson,PG,30,HOU,67,879,109,246,1,6,108,240,75,93,294
1989,Kevin Johnson,PG,22,PHO,81,3179,570,1128,2,22,568,1106,508,576,1650
1989,Magic Johnson*,PG,29,LAL,77,2886,579,1137,59,188,520,949,513,563,1730
1989,Steve Johnson,C,31,POR,72,1477,296,565,0,0,296,565,129,245,721
1989,Vinnie Johnson,SG,32,DET,82,2073,462,996,13,44,449,952,193,263,1130
1989,Anthony Jones,SG,26,TOT,33,196,29,79,4,16,25,63,14,16,76
1989,Anthony Jones,SG,26,CHI,8,65,5,15,0,1,5,14,2,2,12
1989,Anthony Jones,SG,26,DAL,25,131,24,64,4,15,20,49,12,14,64
1989,Bill Jones,PF,22,NJN,37,307,50,102,0,1,50,101,29,43,129
1989,Caldwell Jones,PF,38,POR,72,1279,77,183,0,1,77,182,48,61,202
1989,Charles Jones,C,31,WSB,53,1154,60,125,0,1,60,124,16,25,136
1989,Charles Jones,PF,27,WSB,43,516,38,82,1,3,37,79,33,53,110
1989,Shelton Jones,SF,22,TOT,51,682,93,209,0,1,93,208,58,80,244
1989,Shelton Jones,SF,22,SAS,7,92,9,25,0,0,9,25,8,13,26
1989,Shelton Jones,SF,22,GSW,2,13,3,5,0,0,3,5,0,0,6
1989,Shelton Jones,SF,22,PHI,42,577,81,179,0,1,81,178,50,67,212
1989,Michael Jordan*,SG,25,CHI,81,3255,966,1795,27,98,939,1697,674,793,2633
1989,Tim Kempton,PF,25,CHH,79,1341,171,335,0,1,171,334,142,207,484
1989,Steve Kerr,PG,23,PHO,26,157,20,46,8,17,12,29,6,9,54
1989,Jerome Kersey,SF,26,POR,76,2716,533,1137,6,21,527,1116,258,372,1330
1989,Randolph Keys,SF,22,CLE,42,331,74,172,1,10,73,162,20,29,169
1989,Albert King,SF,29,SAS,46,791,141,327,8,32,133,295,37,48,327
1989,Bernard King*,SF,32,WSB,81,2559,654,1371,5,30,649,1341,361,441,1674
1989,Greg Kite,C,27,TOT,70,942,65,151,0,0,65,151,20,41,150
1989,Greg Kite,C,27,LAC,58,729,49,121,0,0,49,121,14,31,112
1989,Greg Kite,C,27,CHH,12,213,16,30,0,0,16,30,6,10,38
1989,Joe Kleine,C,27,TOT,75,1411,175,432,0,2,175,430,134,152,484
1989,Joe Kleine,C,27,SAC,47,913,116,303,0,1,116,302,81,88,313
1989,Joe Kleine,C,27,BOS,28,498,59,129,0,1,59,128,53,64,171
1989,Bart Kofoed,SG,24,UTA,19,176,12,33,0,1,12,32,6,11,30
1989,Jon Koncak,C,25,ATL,74,1531,141,269,0,3,141,266,63,114,345
1989,Larry Krystkowiak,PF,24,MIL,80,2472,362,766,4,12,358,754,289,351,1017
1989,Bill Laimbeer,C,31,DET,81,2640,449,900,30,86,419,814,178,212,1106
1989,Jeff Lamp,SF,29,LAL,37,176,27,69,2,4,25,65,4,5,60
1989,Jerome Lane,PF,22,DEN,54,550,109,256,0,7,109,249,43,112,261
1989,Andrew Lang,C,22,PHO,62,526,60,117,0,0,60,117,39,60,159
1989,Allen Leavell,SG,31,HOU,55,627,65,188,5,41,60,147,44,60,179
1989,Eric Leckner,C,22,UTA,75,779,120,220,0,0,120,220,79,113,319
1989,Keith Lee,PF,26,NJN,57,840,109,258,0,2,109,256,53,71,271
1989,Jim Les,PG,25,UTA,82,781,40,133,1,14,39,119,57,73,138
1989,Fat Lever,SG,28,DEN,71,2745,558,1221,23,66,535,1155,270,344,1409
1989,Cliff Levingston,PF,28,ATL,80,2184,300,568,1,5,299,563,133,191,734
1989,Ralph Lewis,SG,25,CHH,42,336,58,121,1,3,57,118,19,39,136
1989,Reggie Lewis,SF,23,BOS,81,2657,604,1242,3,22,601,1220,284,361,1495
1989,Alton Lister,C,30,SEA,82,1806,271,543,0,0,271,543,115,178,657
1989,Rob Lock,PF,22,LAC,20,110,9,32,0,0,9,32,12,15,30
1989,Brad Lohaus,PF,24,TOT,77,1214,210,486,1,11,209,475,81,103,502
1989,Brad Lohaus,PF,24,BOS,48,738,117,270,0,4,117,266,35,46,269
1989,Brad Lohaus,PF,24,SAC,29,476,93,216,1,7,92,209,46,57,233
1989,Grant Long,PF,22,MIA,82,2435,336,692,0,5,336,687,304,406,976
1989,John Long,SG,32,TOT,68,919,147,359,8,20,139,339,70,76,372
1989,John Long,SG,32,IND,44,767,128,319,8,20,120,299,59,63,323
1989,John Long,SG,32,DET,24,152,19,40,0,0,19,40,11,13,49
1989,Sidney Lowe,SG,29,CHH,14,250,8,25,0,2,8,23,7,11,23
1989,John Lucas,PG,35,SEA,74,842,119,299,18,68,101,231,54,77,310
1989,Rick Mahorn,PF,30,DET,72,1795,203,393,0,2,203,391,116,155,522
1989,Dan Majerle,SG,23,PHO,54,1354,181,432,27,82,154,350,78,127,467
1989,Jeff Malone,SG,27,WSB,76,2418,677,1410,1,19,676,1391,296,340,1651
1989,Karl Malone*,PF,25,UTA,80,3126,809,1559,5,16,804,1543,703,918,2326
1989,Moses Malone*,C,33,ATL,81,2878,538,1096,0,12,538,1084,561,711,1637
1989,Danny Manning,PF,22,LAC,26,950,177,358,1,5,176,353,79,103,434
1989,Pace Mannion,SF,28,TOT,10,32,4,8,0,2,4,6,0,0,8
1989,Pace Mannion,SF,28,DET,5,14,2,2,0,0,2,2,0,0,4
1989,Pace Mannion,SF,28,ATL,5,18,2,6,0,2,2,4,0,0,4
1989,Vernon Maxwell,SG,23,SAS,79,2065,357,827,32,129,325,698,181,243,927
1989,Tim McCormick,C,26,HOU,81,1257,169,351,0,4,169,347,87,129,425
1989,Rodney McCray,SF,27,SAC,68,2435,340,729,5,22,335,707,169,234,854
1989,Xavier McDaniel,SF,25,SEA,82,2385,677,1385,11,36,666,1349,312,426,1677
1989,Ben McDonald,PF,26,GSW,11,103,13,19,0,0,13,19,9,15,35
1989,Mike McGee,SG,29,NJN,80,2027,434,917,93,255,341,662,77,144,1038
1989,Kevin McHale*,PF,31,BOS,78,2876,661,1211,0,4,661,1207,436,533,1758
1989,Derrick McKey,SF,22,SEA,82,2804,487,970,30,89,457,881,301,375,1305
1989,Nate McMillan,PG,24,SEA,75,2341,199,485,15,70,184,415,119,189,532
1989,Mark McNamara,C,29,LAL,39,318,32,64,0,0,32,64,49,78,113
1989,Reggie Miller*,SG,23,IND,74,2536,398,831,98,244,300,587,287,340,1181
1989,Todd Mitchell,SF,22,TOT,24,353,43,97,0,0,43,97,37,64,123
1989,Todd Mitchell,SF,22,MIA,22,320,41,88,0,0,41,88,36,60,118
1989,Todd Mitchell,SF,22,SAS,2,33,2,9,0,0,2,9,1,4,5
1989,Paul Mokeski,C,32,MIL,74,690,59,164,7,26,52,138,40,51,165
1989,Sidney Moncrief,PG,31,MIL,62,1594,261,532,25,73,236,459,205,237,752
1989,Chris Morris,SF,23,NJN,76,2096,414,905,64,175,350,730,182,254,1074
1989,Richard Morton,PG,22,IND,2,11,3,4,0,0,3,4,0,0,6
1989,Chris Mullin*,SF,25,GSW,82,3093,830,1630,23,100,807,1530,493,553,2176
1989,Pete Myers,SG,25,TOT,33,270,31,73,0,2,31,71,33,48,95
1989,Pete Myers,SG,25,PHI,4,40,6,12,0,0,6,12,2,4,14
1989,Pete Myers,SG,25,NYK,29,230,25,61,0,2,25,59,31,44,81
1989,Larry Nance,PF,29,CLE,73,2526,496,920,0,4,496,916,267,334,1259
1989,Calvin Natt,SF,32,TOT,24,353,47,116,0,1,47,115,57,79,151
1989,Calvin Natt,SF,32,DEN,14,168,22,50,0,1,22,49,22,31,66
1989,Calvin Natt,SF,32,SAS,10,185,25,66,0,0,25,66,35,48,85
1989,Craig Neal,PG,24,TOT,53,500,45,123,10,34,35,89,14,23,114
1989,Craig Neal,PG,24,POR,21,159,11,35,2,9,9,26,1,2,25
1989,Craig Neal,PG,24,MIA,32,341,34,88,8,25,26,63,13,21,89
1989,Ed Nealy,PF,28,TOT,43,258,13,36,0,2,13,34,4,9,30
1989,Ed Nealy,PF,28,CHI,13,94,5,7,0,0,5,7,1,2,11
1989,Ed Nealy,PF,28,PHO,30,164,8,29,0,2,8,27,3,7,19
1989,Chuck Nevitt,C,29,HOU,43,228,27,62,0,0,27,62,11,16,65
1989,Johnny Newman,SF,25,NYK,81,2336,455,957,97,287,358,670,286,351,1293
1989,Norm Nixon,PG,33,LAC,53,1318,153,370,8,29,145,341,48,65,362
1989,Ken Norman,SF,24,LAC,80,3020,638,1271,4,21,634,1250,170,270,1450
1989,Charles Oakley,PF,25,NYK,82,2604,426,835,12,48,414,787,197,255,1061
1989,Hakeem Olajuwon*,C,26,HOU,82,3024,790,1556,0,10,790,1546,454,652,2034
1989,Jose Ortiz,PF,25,UTA,51,327,55,125,0,1,55,124,31,52,141
1989,Robert Parish*,C,35,BOS,80,2840,596,1045,0,0,596,1045,294,409,1486
1989,Jim Paxson,PG,31,BOS,57,1138,202,445,4,24,198,421,84,103,492
1989,John Paxson,PG,28,CHI,78,1738,246,513,44,133,202,380,31,36,567
1989,Will Perdue,C,23,CHI,30,190,29,72,0,0,29,72,8,14,66
1989,Sam Perkins,PF,27,DAL,78,2860,445,959,7,38,438,921,274,329,1171
1989,Tim Perry,C,23,PHO,62,614,108,201,1,4,107,197,40,65,257
1989,Chuck Person,SF,24,IND,80,3012,711,1453,63,205,648,1248,243,307,1728
1989,Jim Petersen,C,26,SAC,66,1633,278,606,0,8,278,598,115,154,671
1989,Ricky Pierce,SG,29,MIL,75,2078,527,1018,8,36,519,982,255,297,1317
1989,Ed Pinckney,PF,25,TOT,80,2012,319,622,0,6,319,616,280,350,918
1989,Ed Pinckney,PF,25,SAC,51,1334,224,446,0,6,224,440,177,221,625
1989,Ed Pinckney,PF,25,BOS,29,678,95,176,0,0,95,176,103,129,293
1989,Scottie Pippen*,SF,23,CHI,73,2413,413,867,21,77,392,790,201,301,1048
1989,Olden Polynice,C,24,SEA,80,835,91,180,0,2,91,178,51,86,233
1989,Dave Popson,PF,24,TOT,17,106,16,40,0,0,16,40,2,4,34
1989,Dave Popson,PF,24,LAC,10,68,11,25,0,0,11,25,1,2,23
1989,Dave Popson,PF,24,MIA,7,38,5,15,0,0,5,15,1,2,11
1989,Terry Porter,PG,25,POR,81,3102,540,1146,79,219,461,927,272,324,1431
1989,Paul Pressey,SG,30,MIL,67,2170,307,648,12,55,295,593,187,241,813
1989,Dominic Pressley,PG,24,TOT,13,124,9,31,0,2,9,29,5,9,23
1989,Dominic Pressley,PG,24,WSB,10,107,8,25,0,0,8,25,5,9,21
1989,Dominic Pressley,PG,24,CHI,3,17,1,6,0,2,1,4,0,0,2
1989,Harold Pressley,PF,25,SAC,80,2257,383,873,119,295,264,578,96,123,981
1989,Mark Price,PG,24,CLE,75,2728,529,1006,93,211,436,795,263,292,1414
1989,Kurt Rambis,PF,30,CHH,75,2233,325,627,0,3,325,624,182,248,832
1989,Blair Rasmussen,C,26,DEN,77,1308,257,577,0,0,257,577,69,81,583
1989,Robert Reid,SF,33,CHH,82,2152,519,1214,17,52,502,1162,152,196,1207
1989,Jerry Reynolds,SG,26,SEA,56,737,149,357,3,15,146,342,127,167,428
1989,Mitch Richmond*,SG,23,GSW,79,2717,649,1386,33,90,616,1296,410,506,1741
1989,Ramon Rivas,C,22,BOS,28,91,12,31,0,1,12,30,16,25,40
1989,David Rivers,PG,24,LAL,47,440,49,122,1,6,48,116,35,42,134
1989,Doc Rivers,PG,27,ATL,76,2462,371,816,43,124,328,692,247,287,1032
1989,Fred Roberts,PF,28,MIL,71,1251,155,319,3,14,152,305,104,129,417
1989,Alvin Robertson,SG,26,SAS,65,2287,465,962,9,45,456,917,183,253,1122
1989,Cliff Robinson,SF,28,PHI,14,416,90,187,0,1,90,186,32,44,212
1989,Dennis Rodman*,SF,27,DET,82,2208,316,531,6,26,310,505,97,155,735
1989,Tree Rollins,C,33,CLE,60,583,62,138,0,1,62,137,12,19,136
1989,Rob Rose,SG,24,LAC,2,3,0,1,0,0,0,1,0,0,0
1989,Scott Roth,SF,25,TOT,63,536,59,167,3,16,56,151,60,87,181
1989,Scott Roth,SF,25,UTA,16,72,7,24,1,6,6,18,8,11,23
1989,Scott Roth,SF,25,SAS,47,464,52,143,2,10,50,133,52,76,158
1989,Jim Rowinski,PF-C,28,TOT,9,15,1,4,0,0,1,4,5,6,7
1989,Jim Rowinski,PF,28,DET,6,8,0,2,0,0,0,2,4,4,4
1989,Jim Rowinski,C,28,PHI,3,7,1,2,0,0,1,2,1,2,3
1989,Brian Rowsom,PF,23,CHH,34,517,80,162,1,1,79,161,65,81,226
1989,John Salley,PF,24,DET,67,1458,166,333,0,2,166,331,135,195,467
1989,Ralph Sampson*,C,28,GSW,61,1086,164,365,3,8,161,357,62,95,393
1989,Mike Sanders,SF,28,CLE,82,2102,332,733,3,10,329,723,97,135,764
1989,Danny Schayes,C,29,DEN,76,1918,317,607,3,9,314,598,332,402,969
1989,Russ Schoene,PF,28,SEA,69,774,135,349,42,110,93,239,46,57,358
1989,Detlef Schrempf,PF,26,TOT,69,1850,274,578,7,35,267,543,273,350,828
1989,Detlef Schrempf,PF,26,DAL,37,845,112,263,2,16,110,247,127,161,353
1989,Detlef Schrempf,PF,26,IND,32,1005,162,315,5,19,157,296,146,189,475
1989,Byron Scott,SG,27,LAL,74,2605,588,1198,77,193,511,1005,195,226,1448
1989,Rony Seikaly,C,23,MIA,78,1962,333,744,1,4,332,740,181,354,848
1989,Brad Sellers,PF,26,CHI,80,1732,231,476,3,6,228,470,86,101,551
1989,Charles Shackleford,C,22,NJN,60,484,83,168,0,1,83,167,21,42,187
1989,John Shasky,C,24,MIA,65,944,121,248,0,2,121,246,115,167,357
1989,Brian Shaw,SG,22,BOS,82,2301,297,686,0,13,297,673,109,132,703
1989,Purvis Short,SF,31,HOU,65,1157,198,480,9,33,189,447,77,89,482
1989,Jerry Sichting,PG,32,POR,25,390,46,104,3,12,43,92,7,8,102
1989,Jack Sikma,C,33,MIL,80,2587,360,835,82,216,278,619,266,294,1068
1989,Scott Skiles,PG,24,IND,80,1571,198,442,20,75,178,367,130,144,546
1989,Keith Smart,PG,24,SAS,2,12,0,2,0,1,0,1,2,2,2
1989,Charles Smith,PF,23,LAC,71,2161,435,878,0,3,435,875,285,393,1155
1989,Derek Smith,SG,27,TOT,65,1295,216,496,7,31,209,465,129,188,568
1989,Derek Smith,SG,27,SAC,29,600,111,276,3,15,108,261,64,95,289
1989,Derek Smith,SG,27,PHI,36,695,105,220,4,16,101,204,65,93,279
1989,Kenny Smith,PG,23,SAC,81,3145,547,1183,46,128,501,1055,263,357,1403
1989,Larry Smith,PF,31,GSW,80,1897,219,397,0,0,219,397,18,58,456
1989,Otis Smith,SG,25,GSW,80,1597,311,715,7,37,304,678,174,218,803
1989,Rik Smits,C,22,IND,82,2041,386,746,0,1,386,745,184,255,956
1989,Mike Smrek,PF,26,SAS,43,623,72,153,0,0,72,153,49,76,193
1989,Rory Sparrow,PG,30,MIA,80,2613,444,982,18,74,426,908,94,107,1000
1989,John Starks,SG,23,GSW,36,316,51,125,10,26,41,99,34,52,146
1989,Everette Stephens,PG,22,IND,35,209,23,72,2,10,21,62,17,22,65
1989,Brook Steppe,PG,29,POR,27,244,33,78,5,9,28,69,32,37,103
1989,John Stockton*,PG,26,UTA,82,3171,497,923,16,66,481,857,390,452,1400
1989,Rod Strickland,PG,22,NYK,81,1358,265,567,19,59,246,508,172,231,721
1989,John Stroeder,PF,30,TOT,5,22,2,5,0,0,2,5,0,0,4
1989,John Stroeder,PF,30,SAS,1,2,0,0,0,0,0,0,0,0,0
1989,John Stroeder,PF,30,GSW,4,20,2,5,0,0,2,5,0,0,4
1989,Barry Sumpter,PF,23,LAC,1,1,0,1,0,0,0,1,0,0,0
1989,Jon Sundvold,SG,27,MIA,68,1338,307,675,48,92,259,583,47,57,709
1989,Roy Tarpley,PF,24,DAL,19,591,131,242,0,1,131,241,66,96,328
1989,Anthony Taylor,PG,23,MIA,21,368,60,151,0,2,60,149,24,32,144
1989,Terry Teagle,SF,28,GSW,66,1569,409,859,2,12,407,847,182,225,1002
1989,Reggie Theus,SG,31,ATL,82,2517,497,1067,17,58,480,1009,285,335,1296
1989,Isiah Thomas*,PG,27,DET,80,2924,569,1227,33,121,536,1106,287,351,1458
1989,Bernard Thompson,PF,26,HOU,23,222,20,59,0,2,20,57,22,26,62
1989,Billy Thompson,SF,25,MIA,79,2273,349,716,0,4,349,712,156,224,854
1989,LaSalle Thompson,C,27,TOT,76,2329,416,850,0,1,416,849,227,281,1059
1989,LaSalle Thompson,C,27,SAC,43,1276,247,536,0,1,247,535,152,188,646
1989,LaSalle Thompson,C,27,IND,33,1053,169,314,0,0,169,314,75,93,413
1989,Mychal Thompson,C,34,LAL,80,1994,291,521,0,1,291,520,156,230,738
1989,Bob Thornton,PF,26,PHI,54,449,47,111,1,3,46,108,32,60,127
1989,Otis Thorpe,PF,26,HOU,82,3135,521,961,0,2,521,959,328,450,1370
1989,Sedale Threatt,PG,27,SEA,63,1220,235,476,11,30,224,446,63,77,544
1989,Wayman Tisdale,PF,24,TOT,79,2434,532,1036,0,4,532,1032,317,410,1381
1989,Wayman Tisdale,PF,24,IND,48,1326,285,564,0,4,285,560,198,250,768
1989,Wayman Tisdale,PF,24,SAC,31,1108,247,472,0,0,247,472,119,160,613
1989,Ray Tolbert,PF,30,ATL,50,341,40,94,0,0,40,94,23,37,103
1989,Tom Tolbert,SF,23,CHH,14,117,17,37,0,3,17,34,6,12,40
1989,Sedric Toney,PG,26,IND,2,9,1,5,0,3,1,2,0,1,2
1989,Kelly Tripucka,SF,29,CHH,71,2302,568,1215,30,84,538,1131,440,508,1606
1989,Trent Tucker,SG,29,NYK,81,1824,263,579,118,296,145,283,43,55,687
1989,Andre Turner,PG,24,MIL,4,13,3,6,0,0,3,6,0,0,6
1989,Elston Turner,SF,29,DEN,78,1746,151,353,2,7,149,346,33,56,337
1989,Terry Tyler,SF,32,DAL,70,1057,169,360,1,9,168,351,47,62,386
1989,Kelvin Upshaw,SG,26,TOT,32,617,99,212,3,15,96,197,18,26,219
1989,Kelvin Upshaw,SG,26,MIA,9,144,26,63,1,5,25,58,4,6,57
1989,Kelvin Upshaw,SG,26,BOS,23,473,73,149,2,10,71,139,14,20,162
1989,Darnell Valentine,SG,29,CLE,77,1086,136,319,3,14,133,305,91,112,366
1989,Kiki Vandeweghe,PF,30,TOT,45,934,200,426,19,48,181,378,80,89,499
1989,Kiki Vandeweghe,PF,30,POR,18,432,103,217,16,38,87,179,29,33,251
1989,Kiki Vandeweghe,PF,30,NYK,27,502,97,209,3,10,94,199,51,56,248
1989,Jay Vincent,SF,29,TOT,29,646,104,257,1,3,103,254,40,60,249
1989,Jay Vincent,SF,29,DEN,5,95,13,38,1,2,12,36,5,9,32
1989,Jay Vincent,SF,29,SAS,24,551,91,219,0,1,91,218,35,51,217
1989,Sam Vincent,PG,25,CHI,70,1703,274,566,2,17,272,549,106,129,656
1989,Darrell Walker,PG,27,WSB,79,2565,286,681,0,9,286,672,142,184,714
1989,Kenny Walker,SF,24,NYK,79,1163,174,356,5,20,169,336,66,85,419
1989,Pearl Washington,PG,25,MIA,54,1065,164,387,1,14,163,373,82,104,411
1989,Spud Webb,PG,25,ATL,81,1219,133,290,1,22,132,268,52,60,319
1989,Chris Welp,C,25,PHI,72,843,99,222,0,1,99,221,48,73,246
1989,Bill Wennington,C,25,DAL,65,1074,119,275,1,9,118,266,61,82,300
1989,Mark West,C,28,PHO,82,2019,243,372,0,0,243,372,108,202,594
1989,Ennis Whatley,PG,26,LAC,8,90,12,33,0,0,12,33,10,11,34
1989,Clinton Wheeler,PG,29,TOT,28,354,45,87,0,1,45,86,15,20,105
1989,Clinton Wheeler,PG,29,MIA,8,143,24,42,0,0,24,42,8,10,56
1989,Clinton Wheeler,PG,29,POR,20,211,21,45,0,1,21,44,7,10,49
1989,Eric White,SF,23,TOT,38,436,62,120,0,0,62,120,34,42,158
1989,Eric White,SF,23,UTA,1,2,0,1,0,0,0,1,0,0,0
1989,Eric White,SF,23,LAC,37,434,62,119,0,0,62,119,34,42,158
1989,Jerome Whitehead,C,32,TOT,57,622,72,182,0,0,72,182,31,47,175
1989,Jerome Whitehead,C,32,GSW,5,42,3,6,0,0,3,6,1,2,7
1989,Jerome Whitehead,C,32,SAS,52,580,69,176,0,0,69,176,30,45,168
1989,Morlon Wiley,PG,22,DAL,51,408,46,114,6,24,40,90,13,16,111
1989,Dominique Wilkins*,SF,29,ATL,80,2997,814,1756,29,105,785,1651,442,524,2099
1989,Eddie Lee,C,26,NYK,71,584,114,245,0,1,114,244,61,111,289
1989,Gerald Wilkins,SG,25,NYK,81,2414,462,1025,51,172,411,853,186,246,1161
1989,Buck Williams,PF,28,NJN,74,2446,373,702,0,3,373,699,213,320,959
1989,Herb Williams,C,30,TOT,76,2470,322,739,0,5,322,734,133,194,777
1989,Herb Williams,C,30,IND,46,1567,244,542,0,3,244,539,90,126,578
1989,Herb Williams,C,30,DAL,30,903,78,197,0,2,78,195,43,68,199
1989,Hot Rod,PF,26,CLE,82,2125,356,700,1,4,355,696,235,314,948
1989,John Williams,SF,22,WSB,82,2413,438,940,19,71,419,869,225,290,1120
1989,Kevin Williams,SG,27,TOT,50,547,81,200,1,6,80,194,46,59,209
1989,Kevin Williams,SG,27,NJN,41,433,67,168,1,6,66,162,40,51,175
1989,Kevin Williams,SG,27,LAC,9,114,14,32,0,0,14,32,6,8,34
1989,Micheal Williams,PG,22,DET,49,358,47,129,2,9,45,120,31,47,127
1989,Reggie Williams,SF,24,LAC,63,1303,260,594,30,104,230,490,92,122,642
1989,David Wingate,SG,25,PHI,33,372,54,115,2,6,52,109,27,34,137
1989,Randy Wittman,SF,29,TOT,64,1120,130,286,3,6,127,280,28,41,291
1989,Randy Wittman,SF,29,SAC,31,416,50,117,2,4,48,113,16,22,118
1989,Randy Wittman,SF,29,IND,33,704,80,169,1,2,79,167,12,19,173
1989,Joe Wolf,C,24,LAC,66,1450,170,402,2,14,168,388,44,64,386
1989,David Wood,PF,24,CHI,2,2,0,0,0,0,0,0,0,0,0
1989,Mike Woodson,SG,30,HOU,81,2259,410,936,31,89,379,847,195,237,1046
1989,Orlando Woolridge,SF,29,LAL,74,1491,231,494,0,1,231,493,253,343,715
1989,James Worthy*,SF,27,LAL,81,2960,702,1282,2,23,700,1259,251,321,1657
1989,Danny Young,PG,26,POR,48,952,115,250,17,50,98,200,50,64,297
,,,,,,,,,,,,,,,
1990,Mark Acres,C,27,ORL,80,1691,138,285,3,4,135,281,83,120,362
1990,Michael Adams,PG,27,DEN,79,2690,398,989,158,432,240,557,267,314,1221
1990,Mark Aguirre,SF,30,DET,78,2005,438,898,31,93,407,805,192,254,1099
1990,Danny Ainge,PG,30,SAC,75,2727,506,1154,108,289,398,865,222,267,1342
1990,Mark Alarie,PF,26,WSB,82,1893,371,785,10,49,361,736,108,133,860
1990,Steve Alford,PG,25,DAL,41,302,63,138,7,22,56,116,35,37,168
1990,Randy Allen,SG,25,SAC,63,746,106,239,0,7,106,232,23,43,235
1990,Greg Anderson,PF,25,MIL,60,1291,219,432,0,0,219,432,91,170,529
1990,Nick Anderson,SG,22,ORL,81,1785,372,753,1,17,371,736,186,264,931
1990,Richard Anderson,PF,29,CHH,54,604,88,211,37,100,51,111,18,23,231
1990,Ron Anderson,SF,31,PHI,78,2089,379,841,3,21,376,820,165,197,926
1990,Willie Anderson,SG,23,SAS,82,2788,532,1082,7,26,525,1056,217,290,1288
1990,Michael Ansley,SF,22,ORL,72,1221,231,465,0,0,231,465,164,227,626
1990,B.J. Armstrong,PG,22,CHI,81,1291,190,392,3,6,187,386,69,78,452
1990,John Bagley,PG,29,BOS,54,1095,100,218,1,18,99,200,29,39,230
1990,Thurl Bailey,SF,28,UTA,82,2583,470,977,0,8,470,969,222,285,1162
1990,Ken Bannister,PF,29,LAC,52,589,77,161,0,1,77,160,52,110,206
1990,Charles Barkley*,SF,26,PHI,79,3085,706,1177,20,92,686,1085,557,744,1989
1990,Dana Barros,PG,22,SEA,81,1630,299,738,95,238,204,500,89,110,782
1990,John Battle,SG,27,ATL,60,1477,275,544,2,13,273,531,102,135,654
1990,Kenny Battle,SG,25,PHO,59,729,93,170,1,4,92,166,55,82,242
1990,William Bedford,C,26,DET,42,246,54,125,1,6,53,119,9,22,118
1990,Benoit Benjamin,C,25,LAC,71,2313,362,688,0,1,362,687,235,321,959
1990,Winston Bennett,SF,24,CLE,55,990,137,286,0,0,137,286,64,96,338
1990,Larry Bird*,SF,33,BOS,75,2944,718,1517,65,195,653,1322,319,343,1820
1990,Uwe Blab,C,27,TOT,47,531,39,98,0,0,39,98,20,37,98
1990,Uwe Blab,C,27,GSW,40,481,33,87,0,0,33,87,17,31,83
1990,Uwe Blab,C,27,SAS,7,50,6,11,0,0,6,11,3,6,15
1990,Rolando Blackman,SG,30,DAL,80,2934,626,1256,13,43,613,1213,287,340,1552
1990,Mookie Blaylock,PG,22,NJN,50,1267,212,571,18,80,194,491,63,81,505
1990,Muggsy Bogues,PG,25,CHH,81,2743,326,664,5,26,321,638,106,134,763
1990,Manute Bol,C,27,GSW,75,1310,56,169,9,48,47,121,25,49,146
1990,Anthony Bowie,SG,26,HOU,66,918,119,293,6,21,113,272,40,54,284
1990,Sam Bowie,C,28,NJN,68,2207,347,834,10,31,337,803,294,379,998
1990,Adrian Branch,SF,26,MIN,11,91,25,61,1,1,24,60,14,22,65
1990,Randy Breuer,C,29,TOT,81,1879,298,696,0,1,298,695,126,193,722
1990,Randy Breuer,C,29,MIL,30,554,86,186,0,0,86,186,32,51,204
1990,Randy Breuer,C,29,MIN,51,1325,212,510,0,1,212,509,94,142,518
1990,Frank Brickowski,C,30,SAS,78,1438,211,387,0,2,211,385,95,141,517
1990,Scott Brooks,PG,24,PHI,72,975,119,276,31,79,88,197,50,57,319
1990,Chucky Brown,SF,21,CLE,75,1339,210,447,0,7,210,440,125,164,545
1990,Mike Brown,C,26,UTA,82,1397,177,344,1,2,176,342,157,199,512
1990,Raymond Brown,PF,24,UTA,16,56,8,28,0,0,8,28,0,2,16
1990,Tony Brown,SF,29,MIL,61,635,88,206,5,20,83,186,38,56,219
1990,Stanley Brundy,SF,22,NJN,16,128,15,30,0,0,15,30,7,18,37
1990,Mark Bryant,PF,24,POR,58,562,70,153,0,0,70,153,28,50,168
1990,Torgeir Bryn,C,25,LAC,3,10,0,2,0,0,0,2,4,6,4
1990,Steve Bucknall,SG,23,LAL,18,75,9,33,0,1,9,32,5,6,23
1990,Greg Butler,C,23,NYK,13,33,3,12,0,0,3,12,0,2,6
1990,Michael Cage,C,28,SEA,82,2595,325,645,0,0,325,645,148,212,798
1990,Adrian Caldwell,PF,23,HOU,51,331,42,76,0,0,42,76,13,28,97
1990,Tony Campbell,SG,27,MIN,82,3164,723,1581,9,54,714,1527,448,569,1903
1990,Rick Carlisle,SG,30,NJN,5,21,1,7,0,3,1,4,0,0,2
1990,Antoine Carr,PF,28,TOT,77,1727,356,721,0,7,356,714,237,298,949
1990,Antoine Carr,PF,28,ATL,44,803,128,248,0,4,128,244,79,102,335
1990,Antoine Carr,PF,28,SAC,33,924,228,473,0,3,228,470,158,196,614
1990,Joe Barry,C,31,TOT,76,1721,312,759,0,2,312,757,137,177,761
1990,Joe Barry,C,31,NJN,46,1002,159,405,0,2,159,403,85,107,403
1990,Joe Barry,C,31,DEN,30,719,153,354,0,0,153,354,52,70,358
1990,Bill Cartwright,C,32,CHI,71,2160,292,598,0,0,292,598,227,280,811
1990,Terry Catledge,PF,26,ORL,74,2462,546,1152,2,8,544,1144,341,486,1435
1990,Tom Chambers,PF,30,PHO,81,3046,810,1617,24,86,786,1531,557,647,2201
1990,Rex Chapman,SG,22,CHH,54,1762,377,924,47,142,330,782,144,192,945
1990,Maurice Cheeks,PG,33,TOT,81,2519,307,609,4,16,303,593,171,202,789
1990,Maurice Cheeks,PG,33,SAS,50,1766,215,450,1,9,214,441,114,137,545
1990,Maurice Cheeks,PG,33,NYK,31,753,92,159,3,7,89,152,57,65,244
1990,Derrick Chievous,SF,22,TOT,55,591,105,220,3,9,102,211,80,111,293
1990,Derrick Chievous,SF,22,HOU,41,492,90,178,3,8,87,170,61,87,244
1990,Derrick Chievous,SF,22,CLE,14,99,15,42,0,1,15,41,19,24,49
1990,Ben Coleman,PF,28,MIL,22,305,46,97,0,1,46,96,34,41,126
1990,Steve Colter,PG,27,WSB,73,977,142,297,0,5,142,292,77,95,361
1990,Lester Conner,PG,30,NJN,82,2355,237,573,2,13,235,560,172,214,648
1990,Michael Cooper,SG,33,LAL,80,1851,191,493,50,157,141,336,83,94,515
1990,Wayne Cooper,C,33,POR,79,1176,138,304,0,3,138,301,25,39,301
1990,Lanard Copeland,SG,24,PHI,23,110,31,68,1,5,30,63,11,14,74
1990,Tyrone Corbin,SF,27,MIN,82,3011,521,1083,0,11,521,1072,161,209,1203
1990,Dave Corzine,C,33,ORL,6,79,11,29,0,0,11,29,0,2,22
1990,Pat Cummings,C,33,MIA,37,391,77,159,0,0,77,159,21,37,175
1990,Terry Cummings,PF,28,SAS,81,2821,728,1532,19,59,709,1473,343,440,1818
1990,Dell Curry,SG,25,CHH,67,1860,461,990,52,147,409,843,96,104,1070
1990,Quintin Dailey,SG,29,SEA,30,491,97,240,1,5,96,235,52,66,247
1990,Adrian Dantley*,SF,33,DAL,45,1300,231,484,0,2,231,482,200,254,662
1990,Brad Daugherty,C,24,CLE,41,1438,244,509,0,2,244,507,202,287,690
1990,Brad Davis,PG,34,DAL,73,1292,179,365,35,104,144,261,77,100,470
1990,Charles Davis,SF,31,CHI,53,429,58,158,7,25,51,133,7,8,130
1990,Terry Davis,PF,22,MIA,63,884,122,262,0,1,122,261,54,87,298
1990,Walter Davis,SG,35,DEN,69,1635,497,1033,6,46,491,987,207,227,1207
1990,Johnny Dawkins,PG,26,PHI,81,2865,465,950,22,66,443,884,210,244,1162
1990,Vinny Del,SG,23,SAC,76,1858,297,643,10,32,287,611,135,155,739
1990,Byron Dinkins,PG,22,HOU,33,362,44,109,1,9,43,100,26,30,115
1990,Vlade Divac,C,21,LAL,82,1611,274,549,0,5,274,544,153,216,701
1990,James Donaldson,C,32,DAL,73,2265,258,479,0,0,258,479,149,213,665
1990,Sherman Douglas,PG,23,MIA,81,2470,463,938,5,31,458,907,224,326,1155
1990,Terry Dozier,SF,23,CHH,9,92,9,27,0,1,9,26,4,8,22
1990,Greg Dreiling,C,27,IND,49,307,20,53,0,0,20,53,25,34,65
1990,Larry Drew,PG,31,LAL,80,1333,170,383,32,81,138,302,46,60,418
1990,Clyde Drexler*,SG,27,POR,73,2683,670,1357,30,106,640,1251,333,430,1703
1990,Kevin Duckworth,C,25,POR,82,2462,548,1146,0,0,548,1146,231,312,1327
1990,Chris Dudley,PF,24,TOT,64,1356,146,355,0,0,146,355,58,182,350
1990,Chris Dudley,PF,24,CLE,37,684,79,203,0,0,79,203,26,77,184
1990,Chris Dudley,PF,24,NJN,27,672,67,152,0,0,67,152,32,105,166
1990,Joe Dumars*,SG,26,DET,75,2578,508,1058,22,55,486,1003,297,330,1335
1990,Mike Dunleavy,PG,35,MIL,5,43,4,14,2,9,2,5,7,8,17
1990,T.R. Dunn,SF,34,DEN,65,657,44,97,0,2,44,95,26,39,114
1990,Ledell Eackles,SG,23,WSB,78,1696,413,940,19,59,394,881,210,280,1055
1990,Mark Eaton,C,33,UTA,82,2281,158,300,0,0,158,300,79,118,395
1990,Blue Edwards,SF,24,UTA,82,1889,286,564,9,30,277,534,146,203,727
1990,James Edwards,C,34,DET,82,2283,462,928,0,3,462,925,265,354,1189
1990,Jay Edwards,SG,21,LAC,4,26,3,7,0,2,3,5,1,3,7
1990,Kevin Edwards,SG,24,MIA,78,2211,395,959,9,30,386,929,139,183,938
1990,Craig Ehlo,SG,28,CLE,81,2894,436,940,104,248,332,692,126,185,1102
1990,Sean Elliott,SF,21,SAS,81,2032,311,647,1,9,310,638,187,216,810
1990,Dale Ellis,SG,29,SEA,55,2033,502,1011,96,256,406,755,193,236,1293
1990,Pervis Ellison,C,22,SAC,34,866,111,251,0,2,111,249,49,78,271
1990,Alex English*,SF,36,DEN,80,2211,635,1293,2,5,633,1288,161,183,1433
1990,Patrick Ewing*,C,27,NYK,82,3165,922,1673,1,4,921,1669,502,648,2347
1990,Jim Farmer,SG,25,SEA,38,400,89,203,8,27,81,176,57,80,243
1990,Duane Ferrell,SF,24,ATL,14,29,5,14,0,1,5,13,2,6,12
1990,Vern Fleming,PG,27,IND,82,2876,467,919,12,34,455,885,230,294,1176
1990,Sleepy Floyd,PG,29,HOU,82,2630,362,803,89,234,273,569,187,232,1000
1990,Tellis Frank,PF,24,MIA,77,1762,278,607,0,0,278,607,179,234,735
1990,Corey Gaines,SG,24,PHI,9,81,4,12,1,2,3,10,1,4,10
1990,Kevin Gamble,SF,24,BOS,71,990,137,301,3,18,134,283,85,107,362
1990,Winston Garland,PG,25,TOT,79,1762,230,573,12,36,218,537,102,122,574
1990,Winston Garland,PG,25,GSW,51,891,108,288,1,10,107,278,53,63,270
1990,Winston Garland,PG,25,LAC,28,871,122,285,11,26,111,259,49,59,304
1990,Tom Garrick,SG,23,LAC,73,1721,208,421,4,21,204,400,88,114,508
1990,Kenny Gattison,PF,25,CHH,63,941,148,269,1,1,147,268,75,110,372
1990,Derrick Gervin,PF,26,NJN,21,339,93,197,0,3,93,194,65,89,251
1990,Armen Gilliam,PF,25,TOT,76,2426,484,940,0,2,484,938,303,419,1271
1990,Armen Gilliam,PF,25,PHO,16,267,52,121,0,0,52,121,39,56,143
1990,Armen Gilliam,PF,25,CHH,60,2159,432,819,0,2,432,817,264,363,1128
1990,Mike Gminski,C,30,PHI,81,2659,458,1002,3,17,455,985,193,235,1112
1990,Gary Grant,PG,24,LAC,44,1529,241,517,5,21,236,496,88,113,575
1990,Greg Grant,PG,23,PHO,67,678,83,216,3,16,80,200,39,59,208
1990,Harvey Grant,PF,24,WSB,81,1846,284,601,0,8,284,593,96,137,664
1990,Horace Grant,PF,24,CHI,80,2753,446,853,0,0,446,853,179,256,1071
1990,Stuart Gray,C,26,TOT,58,560,42,99,0,5,42,94,32,47,116
1990,Stuart Gray,C,26,CHH,39,466,38,82,0,2,38,80,25,39,101
1990,Stuart Gray,C,26,NYK,19,94,4,17,0,3,4,14,7,8,15
1990,Jeff Grayer,SF,24,MIL,71,1427,224,487,1,8,223,479,99,152,548
1990,A.C. Green,PF,26,LAL,82,2709,385,806,13,46,372,760,278,370,1061
1990,Rickey Green,PG,35,IND,69,927,100,231,1,11,99,220,43,51,244
1990,Sidney Green,C,29,ORL,73,1860,312,667,1,3,311,664,136,209,761
1990,Dave Greenwood,PF,32,DET,37,205,22,52,0,0,22,52,16,29,60
1990,Darrell Griffith,SG,31,UTA,82,1444,301,649,80,215,221,434,51,78,733
1990,Scott Haffner,PG,23,MIA,43,559,88,217,3,21,85,196,17,25,196
1990,Jack Haley,PF,26,TOT,67,1084,138,347,0,1,138,346,85,125,361
1990,Jack Haley,PF,26,CHI,11,58,9,20,0,0,9,20,7,7,25
1990,Jack Haley,PF,26,NJN,56,1026,129,327,0,1,129,326,78,118,336
1990,Tom Hammonds,PF,22,WSB,61,805,129,295,0,1,129,294,63,98,321
1990,Bob Hansen,SG,29,UTA,81,2174,265,568,54,154,211,414,33,64,617
1990,Bill Hanzlik,PF,32,DEN,81,1605,179,396,6,31,173,365,136,183,500
1990,Tim Hardaway,PG,23,GSW,79,2663,464,985,23,84,441,901,211,276,1162
1990,Derek Harper,PG,28,DAL,82,3007,567,1161,89,240,478,921,250,315,1473
1990,Ron Harper,SG,26,TOT,35,1367,301,637,14,51,287,586,182,231,798
1990,Ron Harper,SG,26,CLE,7,262,61,138,1,5,60,133,31,41,154
1990,Ron Harper,SG,26,LAC,28,1105,240,499,13,46,227,453,151,190,644
1990,Steve Harris,SG,26,LAC,15,93,14,40,0,0,14,40,3,4,31
1990,Scott Hastings,PF,29,DET,40,166,10,33,3,12,7,21,19,22,42
1990,Hersey Hawkins,SG,23,PHI,82,2856,522,1136,84,200,438,936,387,436,1515
1990,Gerald Henderson,PG,34,TOT,57,464,53,109,17,38,36,71,12,15,135
1990,Gerald Henderson,PG,34,MIL,11,129,11,26,3,7,8,19,2,2,27
1990,Gerald Henderson,PG,34,DET,46,335,42,83,14,31,28,52,10,13,108
1990,Mike Higgins,SF,22,TOT,11,50,3,8,0,0,3,8,8,10,14
1990,Mike Higgins,SF,22,LAL,6,18,0,0,0,0,0,0,1,2,1
1990,Mike Higgins,SF,22,DEN,5,32,3,8,0,0,3,8,7,8,13
1990,Rod Higgins,PF,30,GSW,82,1993,304,632,67,193,237,439,234,285,909
1990,Roy Hinson,PF,28,NJN,25,793,145,286,0,0,145,286,86,99,376
1990,Craig Hodges,SG,29,CHI,63,1055,145,331,87,181,58,150,30,33,407
1990,Mike Holton,PG,28,CHH,16,109,14,26,0,0,14,26,1,2,29
1990,Dave Hoppen,C,25,CHH,10,135,16,41,0,0,16,41,8,10,40
1990,Dennis Hopson,SG,24,NJN,79,2551,474,1093,32,101,442,992,271,342,1251
1990,Tito Horford,C,24,MIL,35,236,18,62,0,0,18,62,15,24,51
1990,Jeff Hornacek,SG,26,PHO,67,2278,483,901,40,98,443,803,173,202,1179
1990,Ed Horton,PF,22,WSB,45,374,80,162,0,4,80,158,42,69,202
1990,Eddie Hughes,PG,29,DEN,60,892,83,202,20,49,63,153,23,34,209
1990,Jay Humphries,PG,27,MIL,81,2818,496,1005,21,70,475,935,224,285,1237
1990,Byron Irvin,SG,23,POR,50,488,96,203,5,14,91,189,61,91,258
1990,Jaren Jackson,SG,22,NJN,28,160,25,69,0,3,25,66,17,21,67
1990,Mark Jackson,PG,24,NYK,82,2428,327,749,35,131,292,618,120,165,809
1990,Michael Jackson,PG,25,SAC,17,58,3,11,1,2,2,9,3,6,10
1990,Avery Johnson,PG,24,SEA,53,575,55,142,1,4,54,138,29,40,140
1990,Buck Johnson,SF,26,HOU,82,2832,504,1019,2,17,502,1002,205,270,1215
1990,Dennis Johnson*,PG,35,BOS,75,2036,206,475,1,24,205,451,118,140,531
1990,Eddie Johnson,SF,30,PHO,64,1811,411,907,70,184,341,723,188,205,1080
1990,Eric Johnson,PG,23,UTA,48,272,20,84,1,6,19,78,13,17,54
1990,Kevin Johnson,PG,23,PHO,74,2782,578,1159,8,41,570,1118,501,598,1665
1990,Magic Johnson*,PG,30,LAL,79,2937,546,1138,106,276,440,862,567,637,1765
1990,Marques Johnson,SF,33,GSW,10,99,12,32,2,3,10,29,14,17,40
1990,Steve Johnson,C,32,TOT,25,259,48,92,0,0,48,92,21,35,117
1990,Steve Johnson,C,32,MIN,4,17,0,2,0,0,0,2,0,0,0
1990,Steve Johnson,C,32,SEA,21,242,48,90,0,0,48,90,21,35,117
1990,Vinnie Johnson,SG,33,DET,82,1972,334,775,5,34,329,741,131,196,804
1990,Nate Johnston,PF-SF,23,TOT,21,87,18,48,1,4,17,44,9,13,46
1990,Nate Johnston,SF,23,UTA,6,13,4,11,1,1,3,10,2,2,11
1990,Nate Johnston,PF,23,POR,15,74,14,37,0,3,14,34,7,11,35
1990,Anthony Jones,SG,27,DAL,66,650,72,194,4,13,68,181,47,69,195
1990,Caldwell Jones,PF,39,SAS,72,885,67,144,1,5,66,139,38,54,173
1990,Charles Jones,C,32,WSB,81,2240,94,185,0,0,94,185,68,105,256
1990,Michael Jordan*,SG,26,CHI,82,3197,1034,1964,92,245,942,1719,593,699,2753
1990,Shawn Kemp,PF,20,SEA,81,1120,203,424,2,12,201,412,117,159,525
1990,Tim Kempton,PF,26,DEN,71,1061,153,312,0,1,153,311,77,114,383
1990,Steve Kerr,PG,24,CLE,78,1664,192,432,73,144,119,288,63,73,520
1990,Jerome Kersey,SF,27,POR,82,2843,519,1085,3,20,516,1065,269,390,1310
1990,Randolph Keys,SF,23,TOT,80,1615,293,678,14,43,279,635,101,140,701
1990,Randolph Keys,SF,23,CLE,48,892,151,359,2,10,149,349,61,82,365
1990,Randolph Keys,SF,23,CHH,32,723,142,319,12,33,130,286,40,58,336
1990,Stan Kimbrough,PG,23,DET,10,50,7,16,0,0,7,16,2,2,16
1990,Bernard King*,SF,33,WSB,82,2687,711,1459,3,23,708,1436,412,513,1837
1990,Stacey King,PF,23,CHI,82,1777,267,530,0,1,267,529,194,267,728
1990,Greg Kite,C,28,SAC,71,1515,101,234,1,1,100,233,27,54,230
1990,Joe Kleine,C,28,BOS,81,1365,176,367,0,4,176,363,83,100,435
1990,Jon Koncak,C,26,ATL,54,977,78,127,0,1,78,126,42,79,198
1990,Frank Kornet,PF,23,MIL,57,438,42,114,5,20,37,94,24,39,113
1990,Larry Krystkowiak,PF,25,MIL,16,381,43,118,0,2,43,116,26,33,112
1990,Bill Laimbeer,C,32,DET,81,2675,380,785,57,158,323,627,164,192,981
1990,Jerome Lane,PF,23,DEN,67,956,145,309,0,5,145,304,44,120,334
1990,Andrew Lang,C,23,PHO,74,1011,97,174,0,0,97,174,64,98,258
1990,Jeff Lebo,SG,23,SAS,4,32,2,7,0,0,2,7,2,2,6
1990,Eric Leckner,C,23,UTA,77,764,125,222,0,0,125,222,81,109,331
1990,Tim Legler,SG,23,PHO,11,83,11,29,0,1,11,28,6,6,28
1990,Gary Leonard,C,22,MIN,22,127,13,31,0,1,13,30,6,14,32
1990,Jim Les,PG,26,TOT,7,92,5,14,0,1,5,13,13,17,23
1990,Jim Les,PG,26,UTA,1,6,0,0,0,0,0,0,2,4,2
1990,Jim Les,PG,26,LAC,6,86,5,14,0,1,5,13,11,13,21
1990,Clifford Lett,PG,24,CHI,4,28,2,8,0,0,2,8,0,0,4
1990,Fat Lever,SG,29,DEN,79,2832,568,1283,36,87,532,1196,271,337,1443
1990,Cliff Levingston,PF,29,ATL,75,1706,216,424,1,5,215,419,83,122,516
1990,Ralph Lewis,SG,26,TOT,7,26,4,7,0,0,4,7,2,2,10
1990,Ralph Lewis,SG,26,DET,4,6,0,1,0,0,0,1,0,0,0
1990,Ralph Lewis,SG,26,CHH,3,20,4,6,0,0,4,6,2,2,10
1990,Reggie Lewis,SG,24,BOS,79,2522,540,1089,4,15,536,1074,256,317,1340
1990,Todd Lichti,SG,23,DEN,79,1326,250,514,0,14,250,500,130,174,630
1990,Alton Lister,C,31,GSW,3,40,4,8,0,1,4,7,4,7,12
1990,Lewis Lloyd,SG,30,TOT,21,123,30,53,0,0,30,53,9,16,69
1990,Lewis Lloyd,SG,30,PHI,2,10,1,2,0,0,1,2,0,0,2
1990,Lewis Lloyd,SG,30,HOU,19,113,29,51,0,0,29,51,9,16,67
1990,Brad Lohaus,PF,25,TOT,80,1943,305,663,47,137,258,526,75,103,732
1990,Brad Lohaus,PF,25,MIN,28,590,94,202,1,16,93,186,21,26,210
1990,Brad Lohaus,PF,25,MIL,52,1353,211,461,46,121,165,340,54,77,522
1990,Grant Long,PF,23,MIA,81,1856,257,532,0,3,257,529,172,241,686
1990,John Long,SG,33,ATL,48,1030,174,384,10,29,164,355,46,55,404
1990,Sidney Lowe,PG,30,MIN,80,1744,73,229,2,9,71,220,39,54,187
1990,John Lucas,PG,36,HOU,49,938,109,291,26,87,83,204,42,55,286
1990,Rick Mahorn,PF,31,PHI,75,2271,313,630,2,9,311,621,183,256,811
1990,Dan Majerle,SG,24,PHO,73,2244,296,698,19,80,277,618,198,260,809
1990,Jeff Malone,SG,28,WSB,75,2567,781,1592,1,6,780,1586,257,293,1820
1990,Karl Malone*,PF,26,UTA,82,3122,914,1627,16,43,898,1584,696,913,2540
1990,Moses Malone*,C,34,ATL,81,2735,517,1077,1,9,516,1068,493,631,1528
1990,Danny Manning,PF,23,LAC,71,2269,440,826,0,5,440,821,274,370,1154
1990,Roy Marble,SG,23,ATL,24,162,16,58,0,2,16,56,19,29,51
1990,Sarunas Marciulionis*,SG,25,GSW,75,1695,289,557,10,39,279,518,317,403,905
1990,Jeff Martin,SG,23,LAC,69,1351,170,414,2,15,168,399,91,129,433
1990,Anthony Mason,PF,23,NJN,21,108,14,40,0,0,14,40,9,15,37
1990,Wes Matthews,PG,30,ATL,1,13,1,3,0,1,1,2,2,2,4
1990,Vernon Maxwell,SG,24,TOT,79,1987,275,627,28,105,247,522,136,211,714
1990,Vernon Maxwell,SG,24,SAS,49,1118,133,306,15,52,118,254,59,95,340
1990,Vernon Maxwell,SG,24,HOU,30,869,142,321,13,53,129,268,77,116,374
1990,Bob McCann,SF,25,DAL,10,62,7,21,0,0,7,21,12,14,26
1990,Mel McCants,SF,22,LAL,13,65,8,26,0,0,8,26,6,8,22
1990,George McCloud,SF,22,IND,44,413,45,144,13,40,32,104,15,19,118
1990,Tim McCormick,C,27,HOU,18,116,10,29,0,0,10,29,10,19,30
1990,Rodney McCray,SF,28,SAC,82,3238,537,1043,11,42,526,1001,273,348,1358
1990,Xavier McDaniel,SF,26,SEA,69,2432,611,1233,5,17,606,1216,244,333,1471
1990,Mike McGee,SF,30,PHO,14,280,42,87,8,23,34,64,10,21,102
1990,Kevin McHale*,PF,32,BOS,82,2722,648,1181,23,69,625,1112,393,440,1712
1990,Derrick McKey,SF,23,SEA,80,2748,468,949,3,23,465,926,315,403,1254
1990,Carlton McKinney,SG,25,LAC,7,104,8,32,0,1,8,31,2,4,18
1990,Nate McMillan,SG,25,SEA,82,2338,207,438,11,31,196,407,98,153,523
1990,Mark McNamara,C,30,LAL,33,190,38,86,0,0,38,86,26,40,102
1990,Scott Meents,PF,26,SEA,26,148,19,44,0,0,19,44,17,23,55
1990,Reggie Miller*,SG,24,IND,82,3192,661,1287,150,362,511,925,544,627,2016
1990,Sam Mitchell,PF,26,MIN,80,2414,372,834,0,9,372,825,268,349,1012
1990,Paul Mokeski,C,33,CLE,38,449,63,150,0,1,63,149,25,36,151
1990,Johnny Moore,PG,31,SAS,53,516,47,126,8,34,39,92,16,27,118
1990,Chris Morris,SF,24,NJN,80,2449,449,1065,61,193,388,872,228,316,1187
1990,Mike Morrison,SG,22,PHO,36,153,23,68,2,7,21,61,24,30,72
1990,John Morton,SG,22,CLE,37,402,48,161,7,30,41,131,43,62,146
1990,Chris Mullin*,SF,26,GSW,78,2830,682,1272,87,234,595,1038,505,568,1956
1990,Tod Murphy,C,26,MIN,82,2493,260,552,16,43,244,509,144,203,680
1990,Pete Myers,SG,26,TOT,52,751,89,225,0,7,89,218,66,100,244
1990,Pete Myers,SG,26,NYK,24,208,15,45,0,1,15,44,16,31,46
1990,Pete Myers,SG,26,NJN,28,543,74,180,0,6,74,174,50,69,198
1990,Larry Nance,PF,30,CLE,62,2065,412,807,1,1,411,806,186,239,1011
1990,Calvin Natt,SF,33,IND,14,164,20,31,0,0,20,31,17,22,57
1990,Ed Nealy,PF,29,CHI,46,503,37,70,0,2,37,68,30,41,104
1990,Chuck Nevitt,C,30,HOU,3,9,2,2,0,0,2,2,0,0,4
1990,Johnny Newman,SF,26,NYK,80,2277,374,786,45,142,329,644,239,299,1032
1990,Kurt Nimphius,C,31,PHI,38,314,38,91,0,1,38,90,14,30,90
1990,Dyron Nix,SF,22,IND,20,109,14,39,0,0,14,39,11,16,39
1990,Ken Norman,SF,25,LAC,70,2334,484,949,7,16,477,933,153,242,1128
1990,Charles Oakley,PF,26,NYK,61,2196,336,641,0,3,336,638,217,285,889
1990,Hakeem Olajuwon*,C,27,HOU,82,3124,806,1609,1,6,805,1603,382,536,1995
1990,Jawann Oldham,C,32,TOT,6,45,3,6,0,0,3,6,3,7,9
1990,Jawann Oldham,C,32,ORL,3,36,1,3,0,0,1,3,2,5,4
1990,Jawann Oldham,C,32,LAL,3,9,2,3,0,0,2,3,1,2,5
1990,Jose Ortiz,PF,26,UTA,13,64,19,42,1,2,18,40,3,5,42
1990,Robert Parish*,C,36,BOS,79,2396,505,871,0,0,505,871,233,312,1243
1990,Zarko Paspalj,SF,23,SAS,28,181,27,79,0,1,27,78,18,22,72
1990,Jim Paxson,PG,32,BOS,72,1283,191,422,5,20,186,402,73,90,460
1990,John Paxson,PG,29,CHI,82,2365,365,708,33,92,332,616,56,68,819
1990,Kenny Payne,SF,23,PHI,35,216,47,108,4,10,43,98,16,18,114
1990,Will Perdue,C,24,CHI,77,884,111,268,0,5,111,263,72,104,294
1990,Sam Perkins,SF,28,DAL,76,2668,435,883,6,28,429,855,330,424,1206
1990,Tim Perry,C,24,PHO,60,612,100,195,1,1,99,194,53,90,254
1990,Chuck Person,SF,25,IND,77,2714,605,1242,94,253,511,989,211,270,1515
1990,Jim Petersen,C,27,GSW,43,592,60,141,0,1,60,140,52,73,172
1990,Drazen Petrovic*,SG,25,POR,77,967,207,427,34,74,173,353,135,160,583
1990,Ricky Pierce,SG,30,MIL,59,1709,503,987,46,133,457,854,307,366,1359
1990,Ed Pinckney,PF,26,BOS,77,1082,135,249,0,1,135,248,92,119,362
1990,Scottie Pippen*,SF,24,CHI,82,3148,562,1150,28,112,534,1038,199,295,1351
1990,Olden Polynice,C,25,SEA,79,1085,156,289,1,2,155,287,47,99,360
1990,Terry Porter,PG,26,POR,80,2781,448,969,89,238,359,731,421,472,1406
1990,Paul Pressey,SG,31,MIL,57,1400,239,506,6,43,233,463,144,190,628
1990,Harold Pressley,SF,26,SAC,72,1603,240,566,46,148,194,418,110,141,636
1990,Mark Price,PG,25,CLE,73,2706,489,1066,152,374,337,692,300,338,1430
1990,Brian Quinnett,SG,23,NYK,31,193,19,58,0,2,19,56,2,3,40
1990,Kurt Rambis,PF,31,TOT,74,1904,190,373,0,3,190,370,82,127,462
1990,Kurt Rambis,PF,31,CHH,16,448,58,116,0,1,58,115,30,55,146
1990,Kurt Rambis,PF,31,PHO,58,1456,132,257,0,2,132,255,52,72,316
1990,Blair Rasmussen,C,27,DEN,81,1995,445,895,0,1,445,894,111,134,1001
1990,J.R. Reid,C,21,CHH,82,2757,358,814,0,5,358,809,192,289,908
1990,Robert Reid,SF,34,TOT,72,1202,175,447,10,32,165,415,54,86,414
1990,Robert Reid,SF,34,POR,12,85,13,33,1,3,12,30,4,8,31
1990,Robert Reid,SF,34,CHH,60,1117,162,414,9,29,153,385,50,78,383
1990,Jerry Reynolds,SF,27,ORL,67,1817,309,741,1,14,308,727,239,322,858
1990,Glen Rice,SF,22,MIA,77,2311,470,1071,17,69,453,1002,91,124,1048
1990,Pooh Richardson,PG,23,MIN,82,2581,426,925,23,83,403,842,63,107,938
1990,Mitch Richmond*,SG,24,GSW,78,2799,640,1287,34,95,606,1192,406,469,1720
1990,David Rivers,PG,25,LAC,52,724,80,197,0,5,80,192,59,78,219
1990,Doc Rivers,PG,28,ATL,48,1526,218,480,24,66,194,414,138,170,598
1990,Fred Roberts,PF,29,MIL,82,2235,330,666,2,11,328,655,195,249,857
1990,Alvin Robertson,SG,27,MIL,81,2599,476,946,4,26,472,920,197,266,1153
1990,Clifford Robinson,PF,23,POR,82,1565,298,751,12,44,286,707,138,251,746
1990,David Robinson*,C,24,SAS,82,3002,690,1300,0,2,690,1298,613,837,1993
1990,Dennis Rodman*,SF,28,DET,82,2377,288,496,1,9,287,487,142,217,719
1990,Tree Rollins,C,34,CLE,48,674,57,125,0,1,57,124,11,16,125
1990,Doug Roth,C,22,WSB,42,412,37,86,0,1,37,85,7,14,81
1990,Scott Roth,SF,26,MIN,71,1061,159,420,18,52,141,368,150,201,486
1990,Jim Rowinski,PF,29,MIA,14,112,14,32,0,0,14,32,22,26,50
1990,Brian Rowsom,PF,24,CHH,44,559,78,179,1,2,77,177,68,83,225
1990,Donald Royal,SF,23,MIN,66,746,117,255,0,1,117,254,153,197,387
1990,Delaney Rudd,PG,27,UTA,77,850,111,259,16,56,95,203,35,53,273
1990,John Salley,PF,25,DET,82,1914,209,408,1,4,208,404,174,244,593
1990,Ralph Sampson*,C,29,SAC,26,417,48,129,1,4,47,125,12,23,109
1990,Jeff Sanders,PF,24,CHI,31,182,13,40,0,0,13,40,2,4,28
1990,Mike Sanders,SF,29,IND,82,1531,225,479,5,14,220,465,55,75,510
1990,Danny Schayes,C,30,DEN,53,1194,163,330,0,4,163,326,225,264,551
1990,Detlef Schrempf,PF,27,IND,78,2573,424,822,17,48,407,774,402,490,1267
1990,Byron Scott,SG,28,LAL,77,2593,472,1005,93,220,379,785,160,209,1197
1990,Rony Seikaly,C,24,MIA,74,2409,486,968,0,1,486,967,256,431,1228
1990,Brad Sellers,PF,27,TOT,59,700,103,254,0,5,103,249,58,73,264
1990,Brad Sellers,PF,27,SEA,45,587,84,198,0,3,84,195,49,61,217
1990,Brad Sellers,PF,27,MIN,14,113,19,56,0,2,19,54,9,12,47
1990,Charles Shackleford,C,23,NJN,70,1557,247,535,0,1,247,534,79,115,573
1990,John Shasky,C,25,GSW,14,51,4,14,0,0,4,14,2,6,10
1990,Purvis Short,SF,32,NJN,82,2213,432,950,10,35,422,915,198,237,1072
1990,Dexter Shouse,PG,26,PHI,3,18,0,4,0,1,0,3,0,0,0
1990,Jerry Sichting,PG,33,TOT,35,496,50,125,3,12,47,113,18,22,121
1990,Jerry Sichting,PG,33,CHH,34,469,50,119,3,12,47,107,15,18,118
1990,Jerry Sichting,PG,33,MIL,1,27,0,6,0,0,0,6,3,4,3
1990,Jack Sikma,C,34,MIL,71,2250,344,827,68,199,276,628,230,260,986
1990,Scott Skiles,PG,25,ORL,70,1460,190,464,52,132,138,332,104,119,536
1990,Charles Smith,PG,22,BOS,60,519,59,133,0,7,59,126,53,76,171
1990,Charles Smith,PF,24,LAC,78,2732,595,1145,1,12,594,1133,454,572,1645
1990,Derek Smith,SF,28,PHI,75,1405,261,514,16,36,245,478,130,186,668
1990,Kenny Smith,PG,24,TOT,79,2421,378,811,26,83,352,728,161,196,943
1990,Kenny Smith,PG,24,SAC,46,1747,280,607,22,59,258,548,106,131,688
1990,Kenny Smith,PG,24,ATL,33,674,98,204,4,24,94,180,55,65,255
1990,Larry Smith,PF,32,HOU,74,1300,101,213,0,2,101,211,20,55,222
1990,Michael Smith,PF,24,BOS,65,620,136,286,2,28,134,258,53,64,327
1990,Otis Smith,SF,26,ORL,65,1644,348,708,10,40,338,668,169,222,875
1990,Rik Smits,C,23,IND,82,2404,515,967,0,1,515,966,241,297,1271
1990,Mike Smrek,C,27,GSW,13,107,10,24,0,0,10,24,1,6,21
1990,Rory Sparrow,PG,31,MIA,82,1756,210,510,8,40,202,470,59,77,487
1990,John Stockton*,PG,27,UTA,78,2915,472,918,47,113,425,805,354,432,1345
1990,Greg Stokes,PF,26,SAC,11,34,1,9,0,0,1,9,2,2,4
1990,Rod Strickland,PG,23,TOT,82,2140,343,756,8,30,335,726,174,278,868
1990,Rod Strickland,PG,23,NYK,51,1019,170,386,6,21,164,365,83,130,429
1990,Rod Strickland,PG,23,SAS,31,1121,173,370,2,9,171,361,91,148,439
1990,Jon Sundvold,SG,28,MIA,63,867,148,363,44,100,104,263,44,52,384
1990,Roy Tarpley,PF,25,DAL,45,1648,314,696,0,6,314,690,130,172,758
1990,Jay Taylor,SG,22,NJN,17,114,21,52,3,13,18,39,6,9,51
1990,Leonard Taylor,PF,23,GSW,10,37,0,6,0,1,0,5,11,16,11
1990,Terry Teagle,SF,29,GSW,82,2376,538,1122,3,14,535,1108,244,294,1323
1990,Reggie Theus,SG,32,ORL,76,2350,517,1178,26,105,491,1073,378,443,1438
1990,Isiah Thomas*,PG,28,DET,81,2993,579,1322,42,136,537,1186,292,377,1492
1990,Billy Thompson,SF,26,MIA,79,2142,375,727,2,4,373,723,115,185,867
1990,LaSalle Thompson,C,28,IND,82,2126,223,471,1,5,222,466,107,134,554
1990,Mychal Thompson,C,35,LAL,70,1883,281,562,0,0,281,562,144,204,706
1990,Bob Thornton,PF,27,PHI,56,592,48,112,1,3,47,109,26,51,123
1990,Otis Thorpe,PF,27,HOU,82,2947,547,998,0,10,547,988,307,446,1401
1990,Sedale Threatt,PG,28,SEA,65,1481,303,599,8,32,295,567,130,157,744
1990,Wayman Tisdale,PF,25,SAC,79,2937,726,1383,0,6,726,1377,306,391,1758
1990,Tom Tolbert,PF,24,GSW,70,1347,218,442,5,18,213,424,175,241,616
1990,Sedric Toney,PG,27,TOT,64,968,87,250,23,63,64,187,67,83,264
1990,Sedric Toney,PG,27,ATL,32,286,30,72,7,13,23,59,21,25,88
1990,Sedric Toney,PG,27,SAC,32,682,57,178,16,50,41,128,46,58,176
1990,Kelly Tripucka,SF,30,CHH,79,2404,442,1029,38,104,404,925,310,351,1232
1990,Trent Tucker,SG,30,NYK,81,1725,253,606,95,245,158,361,66,86,667
1990,Andre Turner,PG,25,TOT,11,115,11,38,0,2,11,36,4,4,26
1990,Andre Turner,PG,25,LAC,3,31,2,13,0,1,2,12,0,0,4
1990,Andre Turner,PG,25,CHH,8,84,9,25,0,1,9,24,4,4,22
1990,Henry Turner,PF,23,SAC,36,315,58,122,0,3,58,119,40,65,156
1990,Jeff Turner,PF,27,ORL,60,1105,132,308,2,10,130,298,42,54,308
1990,Melvin Turpin,C,29,WSB,59,818,110,209,0,2,110,207,56,71,276
1990,Kelvin Upshaw,SG,27,TOT,40,387,64,146,4,15,60,131,28,37,160
1990,Kelvin Upshaw,SG,27,BOS,14,131,12,39,2,5,10,34,4,6,30
1990,Kelvin Upshaw,SG,27,DAL,3,4,1,3,0,1,1,2,0,0,2
1990,Kelvin Upshaw,SG,27,GSW,23,252,51,104,2,9,49,95,24,31,128
1990,Kiki Vandeweghe,SF,31,NYK,22,563,102,231,10,19,92,212,44,48,258
1990,Jay Vincent,SF,30,TOT,41,459,86,183,1,2,85,181,41,49,214
1990,Jay Vincent,SF,30,PHI,17,259,45,105,1,1,44,104,33,37,124
1990,Jay Vincent,SF,30,LAL,24,200,41,78,0,1,41,77,8,12,90
1990,Sam Vincent,PG,26,ORL,63,1657,258,564,1,14,257,550,188,214,705
1990,Gary Voce,PF,24,CLE,1,4,1,3,0,0,1,3,0,0,2
1990,Alexander Volkov,C,25,ATL,72,937,137,284,13,34,124,250,70,120,357
1990,Mark Wade,PG,24,DAL,1,3,0,0,0,0,0,0,0,0,0
1990,Darrell Walker,PG,28,WSB,81,2883,316,696,2,21,314,675,138,201,772
1990,Kenny Walker,PF,25,NYK,68,1595,204,384,2,5,202,379,125,173,535
1990,Spud Webb,PG,26,ATL,82,2184,294,616,1,19,293,597,162,186,751
1990,Chris Welp,C,26,TOT,27,198,23,61,0,0,23,61,19,25,65
1990,Chris Welp,C,26,SAS,13,56,7,23,0,0,7,23,1,2,15
1990,Chris Welp,C,26,GSW,14,142,16,38,0,0,16,38,18,23,50
1990,Bill Wennington,C,26,DAL,60,814,105,234,0,4,105,230,60,75,270
1990,Doug West,SG,22,MIN,52,378,53,135,3,11,50,124,26,32,135
1990,Mark West,C,29,PHO,82,2399,331,530,0,0,331,530,199,288,861
1990,Randy White,PF,22,DAL,55,707,93,252,1,14,92,238,50,89,237
1990,Mitchell Wiggins,SG,30,HOU,66,1852,416,853,0,3,416,850,192,237,1024
1990,Morlon Wiley,PG,23,ORL,40,638,92,208,17,46,75,162,28,38,229
1990,Dominique Wilkins*,SF,30,ATL,80,2888,810,1672,59,183,751,1489,459,569,2138
1990,Eddie Lee,C,27,NYK,79,972,141,310,0,2,141,308,89,147,371
1990,Gerald Wilkins,SG,26,NYK,82,2609,472,1032,39,125,433,907,208,259,1191
1990,Buck Williams,PF,29,POR,82,2801,413,754,0,1,413,753,288,408,1114
1990,Herb Williams,C,31,DAL,81,2199,295,665,2,9,293,656,108,159,700
1990,Hot Rod,PF,27,CLE,82,2776,528,1070,0,0,528,1070,325,440,1381
1990,John Williams,SF,23,WSB,18,632,130,274,2,18,128,256,65,84,327
1990,Micheal Williams,PG,23,TOT,28,329,60,119,0,3,60,116,36,46,156
1990,Micheal Williams,PG,23,PHO,6,26,2,10,0,0,2,10,1,2,5
1990,Micheal Williams,PG,23,CHH,22,303,58,109,0,3,58,106,35,44,151
1990,Mike Williams,PF-SF,26,TOT,21,102,6,18,0,1,6,17,3,6,15
1990,Mike Williams,PF,26,SAC,16,88,6,14,0,1,6,13,3,6,15
1990,Mike Williams,SF,26,ATL,5,14,0,4,0,0,0,4,0,0,0
1990,Reggie Williams,SF,25,TOT,47,743,131,338,6,37,125,301,52,68,320
1990,Reggie Williams,SF,25,LAC,5,133,21,57,0,5,21,52,18,21,60
1990,Reggie Williams,SF,25,CLE,32,542,91,239,6,27,85,212,30,41,218
1990,Reggie Williams,SF,25,SAS,10,68,19,42,0,5,19,37,4,6,42
1990,Kevin Willis,PF,27,ATL,81,2273,418,805,2,7,416,798,168,246,1006
1990,David Wingate,SG,26,SAS,78,1856,220,491,0,13,220,478,87,112,527
1990,Randy Wittman,SF,30,IND,61,544,62,122,1,2,61,120,5,6,130
1990,Joe Wolf,C,25,LAC,77,1325,155,392,5,25,150,367,55,71,370
1990,Leon Wood,SG,27,NJN,28,200,16,49,4,21,12,28,14,16,50
1990,Mike Woodson,SG,31,HOU,61,972,160,405,12,41,148,364,62,86,394
1990,Orlando Woolridge,SF,30,LAL,62,1421,306,550,0,5,306,545,176,240,788
1990,Haywoode Workman,PG,24,ATL,6,16,2,3,0,0,2,3,2,2,6
1990,James Worthy*,SF,28,LAL,80,2960,711,1298,15,49,696,1249,248,317,1685
1990,Danny Young,PG,27,POR,82,1393,138,328,16,59,122,269,91,112,383
1990,Michael Young,SF,29,LAC,45,459,92,194,8,26,84,168,27,38,219
,,,,,,,,,,,,,,,
1991,Alaa Abdelnaby,PF,22,POR,43,290,55,116,0,0,55,116,25,44,135
1991,Mahmoud Abdul-Rauf,PG,21,DEN,67,1505,417,1009,24,100,393,909,84,98,942
1991,Mark Acres,C,28,ORL,68,1313,109,214,1,3,108,211,66,101,285
1991,Michael Adams,PG,28,DEN,66,2346,560,1421,167,564,393,857,465,529,1752
1991,Mark Aguirre,SF,31,DET,78,2006,420,909,24,78,396,831,240,317,1104
1991,Danny Ainge,SG,31,POR,80,1710,337,714,102,251,235,463,114,138,890
1991,Mark Alarie,PF,27,WSB,42,587,99,225,5,21,94,204,41,48,244
1991,Steve Alford,PG,26,DAL,34,236,59,117,7,23,52,94,26,31,151
1991,Greg Anderson,PF,26,TOT,68,924,116,270,0,1,116,269,60,115,292
1991,Greg Anderson,PF,26,MIL,26,247,27,73,0,1,27,72,16,28,70
1991,Greg Anderson,PF,26,NJN,1,18,4,4,0,0,4,4,0,0,8
1991,Greg Anderson,PF,26,DEN,41,659,85,193,0,0,85,193,44,87,214
1991,Nick Anderson,SG,23,ORL,70,1971,400,857,17,58,383,799,173,259,990
1991,Ron Anderson,SF,32,PHI,82,2340,512,1055,9,43,503,1012,165,198,1198
1991,Willie Anderson,SG,24,SAS,75,2592,453,991,7,35,446,956,170,213,1083
1991,Michael Ansley,SF,23,ORL,67,877,144,263,0,0,144,263,91,127,379
1991,B.J. Armstrong,PG,23,CHI,82,1731,304,632,15,30,289,602,97,111,720
1991,Vincent Askew,SG,24,GSW,7,85,12,25,0,0,12,25,9,11,33
1991,Keith Askins,SF,23,MIA,39,266,34,81,6,25,28,56,12,25,86
1991,Milos Babic,PF,22,CLE,12,52,6,19,0,0,6,19,7,12,19
1991,Thurl Bailey,PF,29,UTA,82,2486,399,872,0,3,399,869,219,271,1017
1991,Cedric Ball,PF,22,LAC,7,26,3,8,0,0,3,8,2,2,8
1991,Ken Bannister,PF,30,LAC,47,339,43,81,0,1,43,80,25,65,111
1991,Charles Barkley*,SF,27,PHI,67,2498,665,1167,44,155,621,1012,475,658,1849
1991,Dana Barros,PG,23,SEA,66,750,154,311,32,81,122,230,78,85,418
1991,John Battle,SG,28,ATL,79,1863,397,862,14,49,383,813,270,316,1078
1991,Kenny Battle,SG,26,TOT,56,945,133,282,3,24,130,258,70,93,339
1991,Kenny Battle,SG,26,PHO,16,263,38,86,0,2,38,84,20,29,96
1991,Kenny Battle,SG,26,DEN,40,682,95,196,3,22,92,174,50,64,243
1991,William Bedford,C,27,DET,60,562,106,242,5,13,101,229,55,78,272
1991,Benoit Benjamin,C,26,TOT,70,2236,386,778,0,0,386,778,210,295,982
1991,Benoit Benjamin,C,26,LAC,39,1337,229,465,0,0,229,465,123,169,581
1991,Benoit Benjamin,C,26,SEA,31,899,157,313,0,0,157,313,87,126,401
1991,Winston Bennett,SF,25,CLE,27,334,40,107,0,0,40,107,35,47,115
1991,Larry Bird*,SF,34,BOS,60,2277,462,1017,77,198,385,819,163,183,1164
1991,Rolando Blackman,SG,31,DAL,80,2965,634,1316,40,114,594,1202,282,326,1590
1991,Lance Blanks,SG,24,DET,38,214,26,61,2,16,24,45,10,14,64
1991,Mookie Blaylock,PG,23,NJN,72,2585,432,1039,14,91,418,948,139,176,1017
1991,Muggsy Bogues,PG,26,CHH,81,2299,241,524,0,12,241,512,86,108,568
1991,Manute Bol,C,28,PHI,82,1522,65,164,1,14,64,150,24,41,155
1991,Anthony Bonner,PF,22,SAC,34,750,103,230,0,0,103,230,44,76,250
1991,Sam Bowie,C,29,NJN,62,1916,314,723,4,22,310,701,169,231,801
1991,Randy Breuer,C,30,MIN,73,1505,197,435,0,0,197,435,35,79,429
1991,Frank Brickowski,PF,31,MIL,75,1912,372,706,0,2,372,704,198,248,942
1991,Scott Brooks,PG,25,MIN,80,980,159,370,45,135,114,235,61,72,424
1991,Chucky Brown,SF,22,CLE,74,1485,263,502,0,4,263,498,101,144,627
1991,Dee Brown,PG,22,BOS,82,1945,284,612,7,34,277,578,137,157,712
1991,Mike Brown,C,27,UTA,82,1391,129,284,0,0,129,284,132,178,390
1991,Tony Brown,SG-SF,30,TOT,30,294,30,80,3,12,27,68,20,23,83
1991,Tony Brown,SF,30,LAL,7,27,2,3,1,1,1,2,0,0,5
1991,Tony Brown,SG,30,UTA,23,267,28,77,2,11,26,66,20,23,78
1991,Mark Bryant,PF,25,POR,53,781,99,203,0,1,99,202,74,101,272
1991,Jud Buechler,SF,22,NJN,74,859,94,226,1,4,93,222,43,66,232
1991,Matt Bullard,PF,23,HOU,18,63,14,31,0,3,14,28,11,17,39
1991,Willie Burton,SF,22,MIA,76,1928,341,773,4,30,337,743,229,293,915
1991,Greg Butler,C,24,LAC,9,37,5,19,0,0,5,19,4,6,14
1991,Michael Cage,C,29,SEA,82,2141,226,445,0,3,226,442,70,112,522
1991,Adrian Caldwell,PF,24,HOU,42,343,35,83,0,1,35,82,7,17,77
1991,Rick Calloway,SG,24,SAC,64,678,75,192,0,2,75,190,55,79,205
1991,Elden Campbell,PF,22,LAL,52,380,56,123,0,0,56,123,32,49,144
1991,Tony Campbell,SG,28,MIN,77,2893,652,1502,16,61,636,1441,358,446,1678
1991,Antoine Carr,PF,29,SAC,77,2527,628,1228,0,3,628,1225,295,389,1551
1991,Joe Barry,C,32,PHO,11,96,13,36,0,0,13,36,11,12,37
1991,Bill Cartwright,C,33,CHI,79,2273,318,649,0,0,318,649,124,178,760
1991,Terry Catledge,PF,27,ORL,51,1459,292,632,0,5,292,627,161,258,745
1991,Duane Causwell,C,22,SAC,76,1719,210,413,0,0,210,413,105,165,525
1991,Cedric Ceballos,SF,21,PHO,63,730,204,419,1,6,203,413,110,166,519
1991,Tom Chambers,PF,31,PHO,76,2475,556,1271,20,73,536,1198,379,459,1511
1991,Rex Chapman,PG,23,CHH,70,2100,410,922,48,148,362,774,234,282,1102
1991,Maurice Cheeks,PG,34,NYK,76,2147,241,483,5,20,236,463,105,129,592
1991,Derrick Chievous,SF,23,CLE,18,110,17,46,0,0,17,46,9,16,43
1991,Richard Coffey,SF,25,MIN,52,320,28,75,0,1,28,74,12,22,68
1991,Derrick Coleman,PF,23,NJN,74,2602,514,1100,13,38,501,1062,323,442,1364
1991,Bimbo Coles,PG,22,MIA,82,1355,162,393,6,34,156,359,71,95,401
1991,Steve Colter,PG,28,SAC,19,251,23,56,5,14,18,42,7,10,58
1991,Lester Conner,PG,31,TOT,74,1008,96,207,0,5,96,202,68,94,260
1991,Lester Conner,PG,31,NJN,35,489,58,111,0,2,58,109,29,42,145
1991,Lester Conner,PG,31,MIL,39,519,38,96,0,3,38,93,39,52,115
1991,Anthony Cook,PF,23,DEN,58,1121,118,283,0,3,118,280,71,129,307
1991,Wayne Cooper,C,34,POR,67,746,57,145,0,1,57,144,33,42,147
1991,Tyrone Corbin,SF,28,MIN,82,3196,587,1311,2,10,585,1301,296,371,1472
1991,Dave Corzine,C,34,SEA,28,147,17,38,0,0,17,38,13,22,47
1991,Pat Cummings,PF,34,UTA,4,26,4,6,0,0,4,6,7,10,15
1991,Terry Cummings,PF,29,SAS,67,2195,503,1039,7,33,496,1006,164,240,1177
1991,Earl Cureton,PF,33,CHH,9,159,8,24,0,1,8,23,1,3,17
1991,Dell Curry,SG,26,CHH,76,1515,337,715,32,86,305,629,96,114,802
1991,Quintin Dailey,SG,30,SEA,30,299,73,155,0,1,73,154,38,62,184
1991,Adrian Dantley*,SF,34,MIL,10,126,19,50,1,3,18,47,18,26,57
1991,Brad Daugherty,C,25,CLE,76,2946,605,1155,0,3,605,1152,435,579,1645
1991,Brad Davis,PG,35,DAL,80,1426,159,373,22,85,137,288,91,118,431
1991,Terry Davis,PF,23,MIA,55,996,115,236,1,2,114,234,69,124,300
1991,Walter Davis,SG,36,TOT,71,1483,403,862,11,36,392,826,107,117,924
1991,Walter Davis,SG,36,DEN,39,1044,316,667,10,33,306,634,86,94,728
1991,Walter Davis,SG,36,POR,32,439,87,195,1,3,86,192,21,23,196
1991,Johnny Dawkins,PG,27,PHI,4,124,26,41,1,4,25,37,10,11,63
1991,Tony Dawson,SF,23,SAC,4,17,4,7,1,1,3,6,0,0,9
1991,Byron Dinkins,PG,23,TOT,12,149,14,34,0,0,14,34,8,9,36
1991,Byron Dinkins,PG,23,SAS,10,144,13,33,0,0,13,33,8,9,34
1991,Byron Dinkins,PG,23,IND,2,5,1,1,0,0,1,1,0,0,2
1991,Vlade Divac,C,22,LAL,82,2310,360,637,5,14,355,623,196,279,921
1991,James Donaldson,C,33,DAL,82,2800,327,615,0,0,327,615,165,229,819
1991,Sherman Douglas,PG,24,MIA,73,2562,532,1055,4,31,528,1024,284,414,1352
1991,Greg Dreiling,C,28,IND,73,1031,98,194,0,2,98,192,63,105,259
1991,Larry Drew,PG,32,LAL,48,496,54,125,14,33,40,92,17,22,139
1991,Clyde Drexler*,SG,28,POR,82,2852,645,1338,61,191,584,1147,416,524,1767
1991,Kevin Duckworth,C,26,POR,81,2511,521,1084,0,2,521,1082,240,311,1282
1991,Chris Dudley,C,25,NJN,61,1560,170,417,0,0,170,417,94,176,434
1991,Joe Dumars*,SG,27,DET,80,3046,622,1292,14,45,608,1247,371,417,1629
1991,T.R. Dunn,SG,35,DEN,17,217,21,47,1,4,20,43,9,10,52
1991,Ledell Eackles,SG,24,WSB,67,1616,345,762,14,59,331,703,164,222,868
1991,Mark Eaton,C,34,UTA,80,2580,169,292,0,0,169,292,71,112,409
1991,Blue Edwards,SF,25,UTA,62,1611,244,464,6,24,238,440,82,117,576
1991,James Edwards,C,35,DET,72,1903,383,792,1,2,382,790,215,295,982
1991,Kevin Edwards,SG,25,MIA,79,2000,380,927,24,84,356,843,171,213,955
1991,Craig Ehlo,SG,29,CLE,82,2766,344,773,49,149,295,624,95,140,832
1991,Mario Elie,SF-SG,27,TOT,33,644,79,159,4,10,75,149,75,89,237
1991,Mario Elie,SG,27,PHI,3,20,2,7,1,2,1,5,1,2,6
1991,Mario Elie,SF,27,GSW,30,624,77,152,3,8,74,144,74,87,231
1991,Sean Elliott,SF,22,SAS,82,3044,478,976,20,64,458,912,325,402,1301
1991,Dale Ellis,SG,30,TOT,51,1424,340,718,57,157,283,561,120,166,857
1991,Dale Ellis,SG,30,SEA,30,800,181,391,27,89,154,302,62,84,451
1991,Dale Ellis,SG,30,MIL,21,624,159,327,30,68,129,259,58,82,406
1991,Pervis Ellison,C,23,WSB,76,1942,326,636,0,6,326,630,139,214,791
1991,A.J. English,SG,23,WSB,70,1443,251,572,3,31,248,541,111,157,616
1991,Alex English*,SF,37,DAL,79,1748,322,734,0,1,322,733,119,140,763
1991,Patrick Ewing*,C,28,NYK,81,3104,845,1645,0,6,845,1639,464,623,2154
1991,Jim Farmer,SG,26,TOT,27,456,101,223,5,23,96,200,48,65,255
1991,Jim Farmer,SG,26,PHI,2,13,2,7,0,1,2,6,2,2,6
1991,Jim Farmer,SG,26,DEN,25,443,99,216,5,22,94,194,46,63,249
1991,Dave Feitl,C,28,HOU,52,372,52,140,0,3,52,137,33,44,137
1991,Duane Ferrell,SF,25,ATL,78,1165,174,356,2,3,172,353,125,156,475
1991,Danny Ferry,PF,24,CLE,81,1661,275,643,23,77,252,566,124,152,697
1991,Vern Fleming,PG,28,IND,69,1929,356,671,4,18,352,653,161,221,877
1991,Sleepy Floyd,PG,30,HOU,82,1850,386,939,48,176,338,763,185,246,1005
1991,Greg Foster,PF,22,WSB,54,606,97,211,0,5,97,206,42,61,236
1991,Anthony Frederick,SF,26,SAC,35,475,67,168,0,0,67,168,43,60,177
1991,Corey Gaines,SG,25,DEN,10,226,28,70,5,21,23,49,22,26,83
1991,Kevin Gamble,SF,25,BOS,82,2706,548,933,0,7,548,926,185,227,1281
1991,Winston Garland,PG,26,LAC,69,1702,221,519,4,26,217,493,118,157,564
1991,Tom Garrick,SG,24,LAC,67,949,100,236,0,22,100,214,60,79,260
1991,Kenny Gattison,PF,26,CHH,72,1552,243,457,0,2,243,455,164,248,650
1991,Tate George,PG,22,NJN,56,594,80,193,0,2,80,191,32,40,192
1991,Derrick Gervin,PF,27,NJN,56,743,164,394,7,28,157,366,90,114,425
1991,Kendall Gill,SG,22,CHH,82,1944,376,836,2,14,374,822,152,182,906
1991,Armen Gilliam,PF,26,TOT,75,2644,487,1001,0,2,487,999,268,329,1242
1991,Armen Gilliam,PF,26,CHH,25,949,195,380,0,0,195,380,104,128,494
1991,Armen Gilliam,PF,26,PHI,50,1695,292,621,0,2,292,619,164,201,748
1991,Gerald Glass,SF,23,MIN,51,606,149,340,2,17,147,323,52,76,352
1991,Mike Gminski,C,31,TOT,80,2196,357,808,2,14,355,794,128,158,844
1991,Mike Gminski,C,31,PHI,30,791,109,284,1,8,108,276,53,63,272
1991,Mike Gminski,C,31,CHH,50,1405,248,524,1,6,247,518,75,95,572
1991,Dan Godfread,C,23,MIN,10,20,5,12,0,1,5,11,3,4,13
1991,Jim Grandholm,PF,30,DAL,26,168,30,58,9,17,21,41,10,21,79
1991,Gary Grant,PG,25,LAC,68,2105,265,587,9,39,256,548,51,74,590
1991,Greg Grant,PG,24,NYK,22,107,10,27,1,3,9,24,5,6,26
1991,Harvey Grant,PF,25,WSB,77,2842,609,1224,2,15,607,1209,185,249,1405
1991,Horace Grant,PF,25,CHI,78,2641,401,733,1,6,400,727,197,277,1000
1991,Stuart Gray,C,27,NYK,8,37,4,12,0,0,4,12,3,3,11
1991,Jeff Grayer,SG,25,MIL,82,1422,210,485,0,3,210,482,101,147,521
1991,A.C. Green,PF,27,LAL,82,2164,258,542,11,55,247,487,223,302,750
1991,Rickey Green,PG,36,PHI,79,2248,334,722,8,36,326,686,117,141,793
1991,Sidney Green,PF,30,SAS,66,1099,177,384,0,3,177,381,89,105,443
1991,Dave Greenwood,PF,33,SAS,63,1018,85,169,0,2,85,167,69,94,239
1991,Darrell Griffith,SG,32,UTA,75,1005,174,445,48,138,126,307,34,45,430
1991,Scott Haffner,PG,24,CHH,7,50,8,21,0,2,8,19,1,2,17
1991,Jack Haley,PF,27,NJN,78,1178,161,343,0,0,161,343,112,181,434
1991,Tom Hammonds,PF,23,WSB,70,1023,155,336,0,4,155,332,57,79,367
1991,Bob Hansen,SG,30,SAC,36,811,96,256,19,69,77,187,18,36,229
1991,Tim Hardaway,PG,24,GSW,82,3215,739,1551,97,252,642,1299,306,381,1881
1991,Derek Harper,PG,29,DAL,77,2879,572,1226,89,246,483,980,286,391,1519
1991,Ron Harper,SG,27,LAC,39,1383,285,729,48,148,237,581,145,217,763
1991,Tony Harris,SG,23,PHI,6,41,4,16,0,2,4,14,2,4,10
1991,Scott Hastings,PF,30,DET,27,113,16,28,3,4,13,24,13,13,48
1991,Hersey Hawkins,SG,24,PHI,80,3110,590,1251,108,270,482,981,479,550,1767
1991,Gerald Henderson,PG,35,DET,23,392,50,117,7,21,43,96,16,21,123
1991,Steve Henson,PG,22,MIL,68,690,79,189,18,54,61,135,38,42,214
1991,Mike Higgins,SF,23,SAC,7,61,6,10,0,0,6,10,4,7,16
1991,Rod Higgins,SF,31,GSW,82,2024,259,559,73,220,186,339,185,226,776
1991,Sean Higgins,SF,22,SAS,50,464,97,212,3,19,94,193,28,33,225
1991,Tyrone Hill,PF,22,GSW,74,1192,147,299,0,0,147,299,96,152,390
1991,Roy Hinson,PF,29,NJN,9,91,20,39,0,0,20,39,1,3,41
1991,Craig Hodges,SG,30,CHI,73,843,146,344,44,115,102,229,26,27,362
1991,Dave Hoppen,C,26,TOT,30,155,24,44,0,2,24,42,16,22,64
1991,Dave Hoppen,C,26,CHH,19,112,18,32,0,1,18,31,8,10,44
1991,Dave Hoppen,C,26,PHI,11,43,6,12,0,1,6,11,8,12,20
1991,Dennis Hopson,SF,25,CHI,61,728,104,244,1,5,103,239,55,83,264
1991,Jeff Hornacek,SG,27,PHO,80,2733,544,1051,61,146,483,905,201,224,1350
1991,Jay Humphries,PG,28,MIL,80,2726,482,960,60,161,422,799,191,239,1215
1991,Byron Irvin,SG,24,WSB,33,316,60,129,1,5,59,124,50,61,171
1991,Mark Jackson,PG,25,NYK,72,1595,250,508,13,51,237,457,117,160,630
1991,Dave Jamerson,SG,23,HOU,37,202,43,113,5,19,38,94,22,27,113
1991,Henry James,PF,25,CLE,37,505,112,254,24,60,88,194,52,72,300
1991,Les Jepsen,C,23,GSW,21,105,11,36,0,1,11,35,6,9,28
1991,Avery Johnson,PG,25,TOT,68,959,130,277,1,9,129,268,59,87,320
1991,Avery Johnson,PG,25,DEN,21,217,29,68,0,4,29,64,21,32,79
1991,Avery Johnson,PG,25,SAS,47,742,101,209,1,5,100,204,38,55,241
1991,Buck Johnson,SF,27,HOU,73,2279,416,873,2,15,414,858,157,216,991
1991,Eddie Johnson,SG,31,TOT,81,2085,543,1122,39,120,504,1002,229,257,1354
1991,Eddie Johnson,SG,31,PHO,15,312,88,186,6,21,82,165,21,29,203
1991,Eddie Johnson,SG,31,SEA,66,1773,455,936,33,99,422,837,208,228,1151
1991,Kevin Johnson,PG,24,PHO,77,2772,591,1145,9,44,582,1101,519,616,1710
1991,Magic Johnson*,PG,31,LAL,79,2933,466,976,80,250,386,726,519,573,1531
1991,Steve Johnson,C,33,GSW,24,228,34,63,0,0,34,63,22,37,90
1991,Vinnie Johnson,SG,34,DET,82,2390,406,936,11,34,395,902,135,209,958
1991,Charles Jones,C,33,WSB,62,1499,67,124,0,0,67,124,29,50,163
1991,Michael Jordan*,SG,27,CHI,82,3034,990,1837,29,93,961,1744,571,671,2580
1991,Shawn Kemp,PF,21,SEA,81,2442,462,909,2,12,460,897,288,436,1214
1991,Steve Kerr,PG,25,CLE,57,905,99,223,28,62,71,161,45,53,271
1991,Jerome Kersey,SF,28,POR,73,2359,424,887,4,13,420,874,232,327,1084
1991,Alec Kessler,C,24,MIA,78,1259,199,468,0,4,199,464,88,131,486
1991,Randolph Keys,SF,24,CHH,44,473,59,145,3,14,56,131,19,33,140
1991,Bo Kimble,SG,24,LAC,62,1004,159,418,19,65,140,353,92,119,429
1991,Bernard King*,SF,34,WSB,64,2401,713,1511,8,37,705,1474,383,485,1817
1991,Stacey King,PF,24,CHI,76,1198,156,334,0,2,156,332,107,152,419
1991,Greg Kite,C,29,ORL,82,2225,166,338,0,0,166,338,63,123,395
1991,Joe Kleine,C,29,BOS,72,850,102,218,0,2,102,216,54,69,258
1991,Negele Knight,PG,23,PHO,64,792,131,308,6,25,125,283,71,118,339
1991,Bart Kofoed,SG,26,GSW,5,21,0,3,0,0,0,3,3,6,3
1991,Jon Koncak,C,27,ATL,77,1931,140,321,1,8,139,313,32,54,313
1991,Frank Kornet,PF,24,MIL,32,157,23,62,5,18,18,44,7,13,58
1991,Bill Laimbeer,C,33,DET,82,2668,372,778,37,125,335,653,123,147,904
1991,Jerome Lane,PF,24,DEN,62,1383,202,461,1,4,201,457,58,141,463
1991,Andrew Lang,C,24,PHO,63,1152,109,189,0,1,109,188,93,130,311
1991,Eric Leckner,C,24,TOT,72,1122,131,294,0,0,131,294,62,111,324
1991,Eric Leckner,C,24,SAC,32,378,39,96,0,0,39,96,16,27,94
1991,Eric Leckner,C,24,CHH,40,744,92,198,0,0,92,198,46,84,230
1991,Kurk Lee,PG,23,NJN,48,265,19,71,3,15,16,56,25,28,66
1991,Tim Legler,SG,24,DEN,10,148,25,72,3,12,22,60,5,6,58
1991,Gary Leonard,C,23,ATL,4,9,0,0,0,0,0,0,2,4,2
1991,Jim Les,PG,27,SAC,55,1399,119,268,71,154,48,114,86,103,395
1991,Clifford Lett,PG,25,SAS,7,99,14,29,0,1,14,28,6,9,34
1991,Fat Lever,SG,30,DAL,4,86,9,23,0,3,9,20,11,14,29
1991,Cliff Levingston,PF,30,CHI,78,1013,127,282,1,4,126,278,59,91,314
1991,Reggie Lewis,SG,25,BOS,79,2878,598,1219,1,13,597,1206,281,340,1478
1991,Marcus Liberty,SF,22,DEN,76,1171,216,513,17,57,199,456,58,92,507
1991,Todd Lichti,SG,24,DEN,29,860,166,378,14,47,152,331,59,69,405
1991,Alton Lister,C,32,GSW,77,1552,188,393,0,1,188,392,115,202,491
1991,Ian Lockhart,SF,23,PHO,1,2,1,1,0,0,1,1,2,2,4
1991,Brad Lohaus,PF,26,MIL,81,1219,179,415,33,119,146,296,37,54,428
1991,Grant Long,PF,24,MIA,80,2514,276,561,1,6,275,555,181,230,734
1991,John Long,SG,34,DET,25,256,35,85,2,6,33,79,24,25,96
1991,Rick Mahorn,C,32,PHI,80,2439,261,559,0,9,261,550,189,240,711
1991,Dan Majerle,SF,25,PHO,77,2281,397,821,30,86,367,735,227,298,1051
1991,Jeff Malone,SG,29,UTA,69,2466,525,1034,1,6,524,1028,231,252,1282
1991,Karl Malone*,PF,27,UTA,82,3302,847,1608,4,14,843,1594,684,888,2382
1991,Moses Malone*,C,35,ATL,82,1912,280,598,0,7,280,591,309,372,869
1991,Danny Manning,PF,24,LAC,73,2197,470,905,0,3,470,902,219,306,1159
1991,Sarunas Marciulionis*,SG,26,GSW,50,987,183,365,1,6,182,359,178,246,545
1991,Jeff Martin,PG,24,LAC,74,1334,214,507,27,88,187,419,68,100,523
1991,Anthony Mason,PF,24,DEN,3,21,2,4,0,0,2,4,6,8,10
1991,Tony Massenburg,PF,23,SAS,35,161,27,60,0,0,27,60,28,45,82
1991,Vernon Maxwell,SG,25,HOU,82,2870,504,1247,172,510,332,737,217,296,1397
1991,Travis Mays,PG,22,SAC,64,2145,294,724,72,197,222,527,255,331,915
1991,George McCloud,SF,23,IND,74,1070,131,351,43,124,88,227,38,49,343
1991,Tim McCormick,C,28,ATL,56,689,93,187,0,3,93,184,66,90,252
1991,Rodney McCray,PF,29,DAL,74,2561,336,679,13,39,323,640,159,198,844
1991,Xavier McDaniel,SF,27,TOT,81,2634,590,1186,0,8,590,1178,193,267,1373
1991,Xavier McDaniel,SF,27,SEA,15,529,139,290,0,3,139,287,49,69,327
1991,Xavier McDaniel,SF,27,PHO,66,2105,451,896,0,5,451,891,144,198,1046
1991,Kevin McHale*,PF,33,BOS,68,2067,504,912,15,37,489,875,228,275,1251
1991,Derrick McKey,SF,24,SEA,73,2503,438,847,4,19,434,828,235,278,1115
1991,Nate McMillan,SG,26,SEA,78,1434,132,305,17,48,115,257,57,93,338
1991,Mark McNamara,C,31,ORL,2,13,0,1,0,0,0,1,0,0,0
1991,Scott Meents,PF,27,SEA,13,53,7,28,1,1,6,27,2,4,17
1991,Reggie Miller*,SG,25,IND,82,2972,596,1164,112,322,484,842,551,600,1855
1991,Terry Mills,PF,23,TOT,55,819,134,288,0,4,134,284,47,66,315
1991,Terry Mills,PF,23,DEN,17,279,56,120,0,2,56,118,16,22,128
1991,Terry Mills,PF,23,NJN,38,540,78,168,0,2,78,166,31,44,187
1991,Sam Mitchell,PF,27,MIN,82,3121,445,1010,0,9,445,1001,307,396,1197
1991,Paul Mokeski,C,34,GSW,36,257,21,59,3,9,18,50,12,15,57
1991,Sidney Moncrief,SG,33,ATL,72,1096,117,240,21,64,96,176,82,105,337
1991,Chris Morris,SF,25,NJN,79,2553,409,962,45,179,364,783,179,244,1042
1991,John Morton,SF,23,CLE,66,1207,120,274,4,12,116,262,113,139,357
1991,Chris Mullin*,SF,27,GSW,82,3315,777,1449,40,133,737,1316,513,580,2107
1991,Chris Munk,PF,23,UTA,11,29,3,7,0,0,3,7,7,12,13
1991,Tod Murphy,PF,27,MIN,52,1063,90,227,1,17,89,210,70,105,251
1991,Jerrod Mustaf,PF,21,NYK,62,825,106,228,0,1,106,227,56,87,268
1991,Pete Myers,SG,27,SAS,8,103,10,23,0,1,10,22,9,11,29
1991,Larry Nance,PF,31,CLE,80,2927,635,1211,2,8,633,1203,265,330,1537
1991,Craig Neal,PG,26,DEN,10,125,14,35,3,9,11,26,13,22,44
1991,Ed Nealy,PF,30,PHO,55,573,45,97,5,16,40,81,28,38,123
1991,Johnny Newman,SF,27,CHH,81,2477,478,1017,30,84,448,933,385,476,1371
1991,Ken Norman,SF,26,LAC,70,2309,520,1037,6,32,514,1005,173,275,1219
1991,Dan O'Sullivan,C,22,UTA,21,85,7,16,0,0,7,16,7,11,21
1991,Charles Oakley,PF,27,NYK,76,2739,307,595,0,2,307,593,239,305,853
1991,Alan Ogg,C,23,MIA,31,261,24,55,0,2,24,53,6,10,54
1991,Hakeem Olajuwon*,C,28,HOU,56,2062,487,959,0,4,487,955,213,277,1187
1991,Jawann Oldham,C,33,IND,4,19,3,6,0,0,3,6,0,0,6
1991,Brian Oliver,SG,22,PHI,73,800,111,272,5,18,106,254,52,71,279
1991,Gerald Paddio,SF,25,CLE,70,1181,212,506,6,24,206,482,74,93,504
1991,Walter Palmer,C,22,UTA,28,85,15,45,0,1,15,44,10,15,40
1991,Robert Parish*,C,37,BOS,81,2441,485,811,0,1,485,810,237,309,1207
1991,John Paxson,PG,30,CHI,82,1971,317,578,42,96,275,482,34,41,710
1991,Kenny Payne,SF,24,PHI,47,444,68,189,4,18,64,171,26,29,166
1991,Gary Payton*,PG,22,SEA,82,2244,259,575,1,13,258,562,69,97,588
1991,Will Perdue,C,25,CHI,74,972,116,235,0,3,116,232,75,112,307
1991,Sam Perkins,PF,29,LAL,73,2504,368,744,18,64,350,680,229,279,983
1991,Tim Perry,C,25,PHO,46,587,75,144,0,5,75,139,43,70,193
1991,Chuck Person,SF,26,IND,80,2566,620,1231,69,203,551,1028,165,229,1474
1991,Jim Petersen,C,28,GSW,62,834,114,236,1,4,113,232,50,76,279
1991,Drazen Petrovic*,SG,26,TOT,61,1015,243,493,23,65,220,428,114,137,623
1991,Drazen Petrovic*,SG,26,POR,18,133,32,71,1,6,31,65,15,22,80
1991,Drazen Petrovic*,SG,26,NJN,43,882,211,422,22,59,189,363,99,115,543
1991,Ricky Pierce,SG,31,TOT,78,2167,561,1156,46,116,515,1040,430,471,1598
1991,Ricky Pierce,SG,31,MIL,46,1327,359,720,37,93,322,627,282,311,1037
1991,Ricky Pierce,SG,31,SEA,32,840,202,436,9,23,193,413,148,160,561
1991,Ed Pinckney,PF,27,BOS,70,1165,131,243,0,1,131,242,104,116,366
1991,Scottie Pippen*,SF,25,CHI,82,3014,600,1153,21,68,579,1085,240,340,1461
1991,Olden Polynice,C,26,TOT,79,2092,316,564,0,1,316,563,146,252,778
1991,Olden Polynice,C,26,SEA,48,960,165,303,0,0,165,303,67,114,397
1991,Olden Polynice,C,26,LAC,31,1132,151,261,0,1,151,260,79,138,381
1991,Dave Popson,PF,26,BOS,19,64,13,32,0,0,13,32,9,10,35
1991,Terry Porter,PG,27,POR,81,2665,486,944,130,313,356,631,279,339,1381
1991,Paul Pressey,SG,32,SAS,70,1683,201,426,16,57,185,369,110,133,528
1991,Mark Price,PG,26,CLE,16,571,97,195,18,53,79,142,59,62,271
1991,Kevin Pritchard,PG,23,GSW,62,773,88,229,5,31,83,198,62,77,243
1991,Brian Quinnett,SG,24,NYK,68,1011,139,303,15,43,124,260,26,36,319
1991,Kurt Rambis,PF,32,PHO,62,900,83,167,0,2,83,165,60,85,226
1991,Blair Rasmussen,C,28,DEN,70,2325,405,885,2,5,403,880,63,93,875
1991,J.R. Reid,C,22,CHH,80,2467,360,773,0,2,360,771,182,259,902
1991,Robert Reid,SF,35,PHI,3,37,2,14,0,0,2,14,0,0,4
1991,Jerry Reynolds,SG,28,ORL,80,1843,344,793,10,34,334,759,336,419,1034
1991,Glen Rice,SF,23,MIA,77,2646,550,1193,71,184,479,1009,171,209,1342
1991,Pooh Richardson,PG,24,MIN,82,3154,635,1350,42,128,593,1222,89,165,1401
1991,Mitch Richmond*,SG,25,GSW,77,3027,703,1424,40,115,663,1309,394,465,1840
1991,Doc Rivers,PG,29,ATL,79,2586,444,1020,88,262,356,758,221,262,1197
1991,Fred Roberts,PF,30,MIL,82,2114,357,670,4,25,353,645,170,209,888
1991,Alvin Robertson,SG,28,MIL,81,2598,438,904,23,63,415,841,199,263,1098
1991,Clifford Robinson,PF,24,POR,82,1940,373,806,6,19,367,787,205,314,957
1991,David Robinson*,C,25,SAS,82,3095,754,1366,1,7,753,1359,592,777,2101
1991,Larry Robinson,SG,23,TOT,36,425,62,150,0,1,62,149,15,27,139
1991,Larry Robinson,SG,23,GSW,24,170,24,59,0,0,24,59,8,15,56
1991,Larry Robinson,SG,23,WSB,12,255,38,91,0,1,38,90,7,12,83
1991,Rumeal Robinson,PG,24,ATL,47,674,108,242,2,11,106,231,47,80,265
1991,Dennis Rodman*,SF,29,DET,82,2747,276,560,6,30,270,530,111,176,669
1991,Tree Rollins,C,35,DET,37,202,14,33,0,0,14,33,8,14,36
1991,Delaney Rudd,PG,28,UTA,82,874,124,285,17,61,107,224,59,71,324
1991,John Salley,PF,26,DET,74,1649,179,377,0,1,179,376,186,256,544
1991,Ralph Sampson*,C,30,SAC,25,348,34,93,1,5,33,88,5,19,74
1991,Jeff Sanders,PF,25,CHH,3,43,6,14,0,0,6,14,1,2,13
1991,Mike Sanders,SF,30,IND,80,1357,206,494,4,20,202,474,47,57,463
1991,Danny Schayes,C,31,MIL,82,2228,298,597,0,5,298,592,274,328,870
1991,Steve Scheffler,C,23,CHH,39,227,20,39,0,0,20,39,19,21,59
1991,Dwayne Schintzius,C,22,SAS,42,398,68,155,0,2,68,153,22,40,158
1991,Detlef Schrempf,PF,28,IND,82,2632,432,831,15,40,417,791,441,539,1320
1991,Byron Scott,SG,29,LAL,82,2630,501,1051,71,219,430,832,118,148,1191
1991,Dennis Scott,SG,22,ORL,82,2336,503,1183,125,334,378,849,153,204,1284
1991,Rony Seikaly,C,25,MIA,64,2171,395,822,2,6,393,816,258,417,1050
1991,John Shasky,C,26,DAL,57,510,51,116,0,0,51,116,48,79,150
1991,Brian Shaw,PG,24,BOS,79,2772,442,942,3,27,439,915,204,249,1091
1991,Jack Sikma,C,35,MIL,77,1940,295,691,46,135,249,556,166,197,802
1991,Lionel Simmons,SF,22,SAC,79,2978,549,1301,3,11,546,1290,320,435,1421
1991,Scott Skiles,PG,26,ORL,79,2714,462,1039,93,228,369,811,340,377,1357
1991,Charles Smith,PG,23,BOS,5,30,3,7,0,0,3,7,3,5,9
1991,Charles Smith,SF,25,LAC,74,2703,548,1168,0,7,548,1161,384,484,1480
1991,Clinton Smith,SG,27,WSB,5,45,2,4,0,0,2,4,3,6,7
1991,Derek Smith,SF,29,BOS,2,16,1,4,0,1,1,3,3,4,5
1991,Kenny Smith,PG,25,HOU,78,2699,522,1003,49,135,473,868,287,340,1380
1991,Larry Smith,PF,33,HOU,81,1923,128,263,0,0,128,263,12,50,268
1991,Michael Smith,PF,25,BOS,47,389,95,200,6,24,89,176,22,27,218
1991,Otis Smith,SF,27,ORL,75,1885,407,902,9,46,398,856,221,301,1044
1991,Tony Smith,SG,22,LAL,64,695,97,220,0,7,97,213,40,57,234
1991,Rik Smits,C,24,IND,76,1690,342,705,0,0,342,705,144,189,828
1991,Mike Smrek,C,28,TOT,15,95,9,27,0,0,9,27,6,12,24
1991,Mike Smrek,C,28,GSW,5,25,6,11,0,0,6,11,2,4,14
1991,Mike Smrek,C,28,LAC,10,70,3,16,0,0,3,16,4,8,10
1991,Rory Sparrow,PG,32,SAC,80,2375,371,756,31,78,340,678,58,83,831
1991,Felton Spencer,C,23,MIN,81,2099,195,381,0,1,195,380,182,252,572
1991,John Starks,SG,25,NYK,61,1173,180,410,27,93,153,317,79,105,466
1991,Everette Stephens,PG,24,MIL,3,6,2,3,0,0,2,3,2,2,6
1991,John Stockton*,PG,28,UTA,82,3103,496,978,58,168,438,810,363,434,1413
1991,Rod Strickland,PG,24,SAS,58,2076,314,651,11,33,303,618,161,211,800
1991,Jon Sundvold,SG,29,MIA,24,225,43,107,15,35,28,72,11,11,112
1991,Roy Tarpley,C,26,DAL,5,171,43,79,0,1,43,78,16,18,102
1991,Terry Teagle,SG,30,LAL,82,1498,335,757,0,9,335,748,145,177,815
1991,Reggie Theus,SG,33,NJN,81,2955,583,1247,52,144,531,1103,292,343,1510
1991,Irving Thomas,PF,25,LAL,26,108,17,50,0,0,17,50,12,21,46
1991,Isiah Thomas*,PG,29,DET,48,1657,289,665,19,65,270,600,179,229,776
1991,Jim Thomas,SG,30,MIN,3,14,1,4,0,0,1,4,0,0,2
1991,Billy Thompson,SF,27,MIA,73,1481,205,411,0,4,205,407,89,124,499
1991,LaSalle Thompson,C,29,IND,82,1946,276,565,1,5,275,560,72,104,625
1991,Mychal Thompson,C,36,LAL,72,1077,113,228,0,2,113,226,62,88,288
1991,Bob Thornton,PF,28,MIN,12,110,4,13,0,0,4,13,8,10,16
1991,Otis Thorpe,PF,28,HOU,82,3039,549,988,3,7,546,981,334,480,1435
1991,Sedale Threatt,PG,29,SEA,80,2066,433,835,10,35,423,800,137,173,1013
1991,Wayman Tisdale,PF,26,SAC,33,1116,262,542,0,1,262,541,136,170,660
1991,Tom Tolbert,PF,25,GSW,62,1371,183,433,7,21,176,412,127,172,500
1991,Andy Toolson,SF,25,UTA,47,470,50,124,12,32,38,92,25,33,137
1991,Kelly Tripucka,SF,31,CHH,77,1289,187,412,15,45,172,367,152,167,541
1991,Trent Tucker,SG,31,NYK,65,1194,191,434,64,153,127,281,17,27,463
1991,Andre Turner,PG,26,PHI,70,1407,168,383,12,33,156,350,64,87,412
1991,Jeff Turner,PF,28,ORL,71,1683,259,532,6,15,253,517,85,112,609
1991,Kelvin Upshaw,SG,28,DAL,48,514,104,231,7,29,97,202,55,64,270
1991,Darnell Valentine,PG,31,CLE,65,1841,230,496,6,25,224,471,143,172,609
1991,Kiki Vandeweghe,SF,32,NYK,75,2420,458,927,51,141,407,786,259,288,1226
1991,Loy Vaught,PF,22,LAC,73,1178,175,359,0,2,175,357,49,74,399
1991,Sam Vincent,PG,27,ORL,49,975,152,353,3,19,149,334,99,120,406
1991,Stojko Vrankovic,C,27,BOS,31,166,24,52,0,0,24,52,10,18,58
1991,Milt Wagner,SG,27,MIA,13,116,24,57,6,17,18,40,9,11,63
1991,Darrell Walker,PG,29,WSB,71,2305,230,535,0,9,230,526,93,154,553
1991,Kenny Walker,SF,26,NYK,54,771,83,191,0,1,83,190,64,82,230
1991,Spud Webb,PG,27,ATL,75,2197,359,803,54,168,305,635,231,266,1003
1991,Bill Wennington,C,27,SAC,77,1455,181,415,1,5,180,410,74,94,437
1991,Doug West,SG,23,MIN,75,824,118,246,0,1,118,245,58,84,294
1991,Mark West,C,30,PHO,82,1957,247,382,0,0,247,382,135,206,629
1991,Randy White,PF,23,DAL,79,1901,265,665,6,37,259,628,159,225,695
1991,Morlon Wiley,PG,24,ORL,34,350,45,108,6,12,39,96,17,25,113
1991,Dominique Wilkins*,SF,31,ATL,81,3078,770,1640,85,249,685,1391,476,574,2101
1991,Eddie Lee,C,28,NYK,68,668,114,255,0,1,114,254,51,90,279
1991,Gerald Wilkins,SG,27,NYK,68,2164,380,804,9,43,371,761,169,206,938
1991,Buck Williams,PF,30,POR,80,2582,358,595,0,0,358,595,217,308,933
1991,Herb Williams,C,32,DAL,60,1832,332,655,0,4,332,651,83,130,747
1991,Hot Rod,C,28,CLE,43,1293,199,430,0,1,199,429,107,164,505
1991,Jayson Williams,PF,22,PHI,52,508,72,161,1,2,71,159,37,56,182
1991,John Williams,SF,24,WSB,33,941,164,393,10,41,154,352,73,97,411
1991,Kenny Williams,PF,21,IND,75,527,93,179,0,3,93,176,34,50,220
1991,Micheal Williams,PG,24,IND,73,1706,261,523,1,7,260,516,290,330,813
1991,Reggie Williams,SF,26,TOT,73,1896,384,855,57,157,327,698,166,197,991
1991,Reggie Williams,SF,26,SAS,22,354,61,127,14,26,47,101,35,41,171
1991,Reggie Williams,SF,26,DEN,51,1542,323,728,43,131,280,597,131,156,820
1991,Scott Williams,PF,22,CHI,51,337,53,104,1,2,52,102,20,28,127
1991,Kevin Willis,PF,28,ATL,80,2373,444,881,4,10,440,871,159,238,1051
1991,Trevor Wilson,PF,22,ATL,25,162,21,70,0,2,21,68,13,26,55
1991,Kennard Winchester,SF,24,HOU,64,607,98,245,8,20,90,225,35,45,239
1991,David Wingate,SG,27,SAS,25,563,53,138,1,9,52,129,29,41,136
1991,Randy Wittman,SF,31,IND,41,355,35,79,0,5,35,74,4,6,74
1991,Joe Wolf,C,26,DEN,74,1593,234,519,2,15,232,504,69,83,539
1991,David Wood,SF,26,HOU,82,1421,148,349,28,90,120,259,108,133,432
1991,Leon Wood,SG,28,SAC,12,222,25,63,12,38,13,25,19,21,81
1991,Mike Woodson,SG,32,TOT,15,171,26,77,1,7,25,70,11,13,64
1991,Mike Woodson,SG,32,HOU,11,125,21,54,1,6,20,48,10,12,53
1991,Mike Woodson,SG,32,CLE,4,46,5,23,0,1,5,22,1,1,11
1991,Orlando Woolridge,SF,31,DEN,53,1823,490,983,0,4,490,979,350,439,1330
1991,Haywoode Workman,PG,25,WSB,73,2034,234,515,12,50,222,465,101,133,581
1991,James Worthy*,SF,29,LAL,78,3008,716,1455,26,90,690,1365,212,266,1670
1991,Howard Wright,PF,23,TOT,15,164,19,47,0,1,19,46,16,24,54
1991,Howard Wright,PF,23,ATL,4,20,2,3,0,0,2,3,1,1,5
1991,Howard Wright,PF,23,ORL,8,136,15,41,0,0,15,41,13,21,43
1991,Howard Wright,PF,23,DAL,3,8,2,3,0,1,2,2,2,2,6
1991,A.J. Wynder,PG,26,BOS,6,39,3,12,0,1,3,11,6,8,12
1991,Danny Young,PG,28,POR,75,897,103,271,36,104,67,167,41,45,283
,,,,,,,,,,,,,,,
1992,Alaa Abdelnaby,PF,23,POR,71,934,178,361,0,0,178,361,76,101,432
1992,Mahmoud Abdul-Rauf,PG,22,DEN,81,1538,356,845,31,94,325,751,94,108,837
1992,Mark Acres,C,29,ORL,68,926,78,151,1,3,77,148,51,67,208
1992,Michael Adams,PG,29,WSB,78,2795,485,1233,125,386,360,847,313,360,1408
1992,Rafael Addison,SF,27,NJN,76,1175,187,432,14,49,173,383,56,76,444
1992,Mark Aguirre,SF,32,DET,75,1582,339,787,15,71,324,716,158,230,851
1992,Danny Ainge,SG,32,POR,81,1595,299,676,78,230,221,446,108,131,784
1992,Victor Alexander,C,22,GSW,80,1350,243,459,0,1,243,458,103,149,589
1992,Greg Anderson,PF,27,DEN,82,2793,389,854,0,4,389,850,167,268,945
1992,Kenny Anderson,PG,21,NJN,64,1086,187,480,3,13,184,467,73,98,450
1992,Nick Anderson,SG,24,ORL,60,2203,482,1042,30,85,452,957,202,303,1196
1992,Ron Anderson,SF,33,PHI,82,2432,469,1008,42,127,427,881,143,163,1123
1992,Willie Anderson,SG,25,SAS,57,1889,312,685,13,56,299,629,107,138,744
1992,Michael Ansley,SF,24,TOT,10,45,8,18,0,0,8,18,5,6,21
1992,Michael Ansley,SF,24,PHI,8,32,5,11,0,0,5,11,5,6,15
1992,Michael Ansley,SF,24,CHH,2,13,3,7,0,0,3,7,0,0,6
1992,Greg Anthony,PG,24,NYK,82,1510,161,435,8,55,153,380,117,158,447
1992,B.J. Armstrong,PG,24,CHI,82,1875,335,697,35,87,300,610,104,129,809
1992,Vincent Askew,SG,25,GSW,80,1496,193,379,1,10,192,369,111,160,498
1992,Keith Askins,SF,24,MIA,59,843,84,205,25,73,59,132,26,37,219
1992,Stacey Augmon,SG,23,ATL,82,2505,440,899,1,6,439,893,213,320,1094
1992,Isaac Austin,C,22,UTA,31,112,21,46,0,0,21,46,19,30,61
1992,Milos Babic,C,23,MIA,9,35,6,13,0,0,6,13,6,8,18
1992,John Bagley,PG,31,BOS,73,1742,223,506,10,42,213,464,68,95,524
1992,Thurl Bailey,PF,30,TOT,84,2104,368,836,0,2,368,834,215,270,951
1992,Thurl Bailey,PF,30,UTA,13,327,39,101,0,1,39,100,44,55,122
1992,Thurl Bailey,PF,30,MIN,71,1777,329,735,0,1,329,734,171,215,829
1992,Steve Bardo,SG,23,SAS,1,1,0,0,0,0,0,0,0,0,0
1992,Charles Barkley*,SF,28,PHI,75,2881,622,1126,32,137,590,989,454,653,1730
1992,Dana Barros,PG,24,SEA,75,1331,238,493,83,186,155,307,60,79,619
1992,John Battle,SG,29,CLE,76,1637,316,659,2,17,314,642,145,171,779
1992,Kenny Battle,SG,27,TOT,16,92,11,17,0,1,11,16,10,12,32
1992,Kenny Battle,SG,27,BOS,8,46,3,4,0,0,3,4,8,8,14
1992,Kenny Battle,SG,27,GSW,8,46,8,13,0,1,8,12,2,4,18
1992,William Bedford,C,28,DET,32,363,50,121,0,1,50,120,14,22,114
1992,Benoit Benjamin,C,27,SEA,63,1941,354,740,0,2,354,738,171,249,879
1992,Winston Bennett,SF,26,TOT,54,833,80,211,0,1,80,210,35,50,195
1992,Winston Bennett,SF,26,CLE,52,831,79,209,0,1,79,208,35,50,193
1992,Winston Bennett,SF,26,MIA,2,2,1,2,0,0,1,2,0,0,2
1992,David Benoit,SF,23,UTA,77,1161,175,375,3,14,172,361,81,100,434
1992,Larry Bird*,SF,35,BOS,45,1662,353,758,52,128,301,630,150,162,908
1992,Rolando Blackman,SG,32,DAL,75,2527,535,1161,65,169,470,992,239,266,1374
1992,Lance Blanks,SG,25,DET,43,189,25,55,6,16,19,39,8,11,64
1992,Mookie Blaylock,PG,24,NJN,72,2548,429,993,12,54,417,939,126,177,996
1992,Muggsy Bogues,PG,27,CHH,82,2790,317,671,2,27,315,644,94,120,730
1992,Manute Bol,C,29,PHI,71,1267,49,128,0,9,49,119,12,26,110
1992,Anthony Bonner,PF,23,SAC,79,2287,294,658,1,4,293,654,151,241,740
1992,Anthony Bowie,SG,28,ORL,52,1721,312,633,17,44,295,589,117,136,758
1992,Sam Bowie,C,30,NJN,71,2179,421,947,8,25,413,922,212,280,1062
1992,Terrell Brandon,PG,21,CLE,82,1605,252,601,1,23,251,578,100,124,605
1992,Randy Breuer,C,31,MIN,67,1176,161,344,0,1,161,343,41,77,363
1992,Frank Brickowski,SF,32,MIL,65,1556,306,584,3,6,303,578,125,163,740
1992,Kevin Brooks,SF,22,DEN,37,270,43,97,2,11,41,86,17,21,105
1992,Scott Brooks,PG,26,MIN,82,1082,167,374,32,90,135,284,51,63,417
1992,Chucky Brown,SF,23,TOT,42,431,60,128,0,3,60,125,30,49,150
1992,Chucky Brown,SF,23,CLE,6,50,5,10,0,0,5,10,5,8,15
1992,Chucky Brown,SF,23,LAL,36,381,55,118,0,3,55,115,25,41,135
1992,Dee Brown,PG,23,BOS,31,883,149,350,5,22,144,328,60,78,363
1992,Mike Brown,C,28,UTA,82,1783,221,488,0,1,221,487,190,285,632
1992,Myron Brown,PG,22,MIN,4,23,4,6,1,3,3,3,0,0,9
1992,Randy Brown,PG,23,SAC,56,535,77,169,0,6,77,163,38,58,192
1992,Tony Brown,SF,31,TOT,57,655,102,249,19,63,83,186,48,66,271
1992,Tony Brown,SF,31,LAC,22,254,39,89,7,22,32,67,18,29,103
1992,Tony Brown,SF,31,SEA,35,401,63,160,12,41,51,119,30,37,168
1992,Mark Bryant,PF,26,POR,56,800,95,198,0,3,95,195,40,60,230
1992,Jud Buechler,SF,23,TOT,28,290,29,71,0,1,29,70,12,21,70
1992,Jud Buechler,SF,23,NJN,2,29,4,8,0,0,4,8,0,0,8
1992,Jud Buechler,SF,23,SAS,11,140,15,30,0,0,15,30,3,9,33
1992,Jud Buechler,SF,23,GSW,15,121,10,33,0,1,10,32,9,12,29
1992,Matt Bullard,PF,24,HOU,80,1278,205,447,64,166,141,281,38,50,512
1992,Willie Burton,SF,23,MIA,68,1585,280,622,6,15,274,607,196,245,762
1992,Steve Burtt,SG,29,PHO,31,356,74,160,1,6,73,154,38,54,187
1992,Michael Cage,PF,30,SEA,82,2461,307,542,0,5,307,537,106,171,720
1992,Demetrius Calip,PG,22,LAL,7,58,4,18,1,5,3,13,2,3,11
1992,Elden Campbell,C,23,LAL,81,1876,220,491,0,2,220,489,138,223,578
1992,Tony Campbell,SF,29,MIN,78,2441,527,1137,13,37,514,1100,240,299,1307
1992,Antoine Carr,PF,30,SAS,81,1867,359,732,1,5,358,727,162,212,881
1992,Bill Cartwright,C,34,CHI,64,1471,208,445,0,0,208,445,96,159,512
1992,Terry Catledge,PF,28,ORL,78,2430,457,922,0,4,457,918,240,346,1154
1992,Duane Causwell,C,23,SAC,80,2291,250,455,0,1,250,454,136,222,636
1992,Cedric Ceballos,SF,22,PHO,64,725,176,365,1,6,175,359,109,148,462
1992,Tom Chambers,PF,32,PHO,69,1948,426,989,18,49,408,940,258,311,1128
1992,Rex Chapman,PG-SG,24,TOT,22,567,113,252,8,29,105,223,36,53,270
1992,Rex Chapman,PG,24,CHH,21,545,108,240,8,27,100,213,36,53,260
1992,Rex Chapman,SG,24,WSB,1,22,5,12,0,2,5,10,0,0,10
1992,Maurice Cheeks,PG,35,ATL,56,1086,115,249,3,6,112,243,26,43,259
1992,Pete Chilcutt,PF,23,SAC,69,817,113,250,2,2,111,248,23,28,251
1992,Derrick Coleman,PF,24,NJN,65,2207,483,958,23,76,460,882,300,393,1289
1992,Bimbo Coles,PG,23,MIA,81,1976,295,649,10,52,285,597,216,262,816
1992,Marty Conlon,C,24,SEA,45,381,48,101,0,0,48,101,24,32,120
1992,Lester Conner,PG,32,MIL,81,1420,103,239,0,7,103,232,81,115,287
1992,Anthony Cook,PF,24,DEN,22,115,15,25,0,0,15,25,4,6,34
1992,Wayne Cooper,C,35,POR,35,344,35,82,0,0,35,82,7,11,77
1992,Tom Copa,C,27,SAS,33,132,22,40,0,0,22,40,4,13,48
1992,Lanard Copeland,SG,26,LAC,10,48,7,23,0,2,7,21,2,2,16
1992,Tyrone Corbin,SF,29,TOT,80,2207,303,630,0,4,303,626,174,201,780
1992,Tyrone Corbin,SF,29,MIN,11,344,57,142,0,1,57,141,44,53,158
1992,Tyrone Corbin,SF,29,UTA,69,1863,246,488,0,3,246,485,130,148,622
1992,Chris Corchiani,PG,23,ORL,51,741,77,193,10,37,67,156,91,104,255
1992,Corey Crowder,SF,22,UTA,51,328,43,112,13,30,30,82,15,18,114
1992,Terry Cummings,PF,30,SAS,70,2149,514,1053,5,13,509,1040,177,249,1210
1992,Dell Curry,SG,27,CHH,77,2020,504,1038,74,183,430,855,127,152,1209
1992,Quintin Dailey,SG,31,SEA,11,98,9,37,0,1,9,36,13,16,31
1992,Brad Daugherty,C,26,CLE,73,2643,576,1010,0,2,576,1008,414,533,1566
1992,Brad Davis,PG,36,DAL,33,429,38,86,5,18,33,68,11,15,92
1992,Dale Davis,PF,22,IND,64,1301,154,279,0,1,154,278,87,152,395
1992,Terry Davis,PF,24,DAL,68,2149,256,531,0,5,256,526,181,285,693
1992,Walter Davis,SF,37,DEN,46,741,185,403,5,16,180,387,82,94,457
1992,Johnny Dawkins,PG,28,PHI,82,2815,394,902,36,101,358,801,164,186,988
1992,Bison Dele,PF,22,ORL,48,905,171,324,0,0,171,324,95,142,437
1992,Vlade Divac,C,23,LAL,36,979,157,317,5,19,152,298,86,112,405
1992,James Donaldson,C,34,TOT,58,1075,112,245,0,0,112,245,61,86,285
1992,James Donaldson,C,34,DAL,44,994,107,227,0,0,107,227,59,84,273
1992,James Donaldson,C,34,NYK,14,81,5,18,0,0,5,18,2,2,12
1992,Sherman Douglas,PG,25,TOT,42,752,117,253,1,10,116,243,73,107,308
1992,Sherman Douglas,PG,25,MIA,5,98,16,31,0,1,16,30,5,7,37
1992,Sherman Douglas,PG,25,BOS,37,654,101,222,1,9,100,213,68,100,271
1992,Greg Dreiling,C,29,IND,60,509,43,87,1,1,42,86,30,40,117
1992,Clyde Drexler*,SG,29,POR,76,2751,694,1476,114,338,580,1138,401,505,1903
1992,Kevin Duckworth,C,27,POR,82,2222,362,786,0,3,362,783,156,226,880
1992,Chris Dudley,C,26,NJN,82,1902,190,472,0,0,190,472,80,171,460
1992,Joe Dumars*,SG,28,DET,82,3192,587,1311,49,120,538,1191,412,475,1635
1992,Ledell Eackles,SG,25,WSB,65,1463,355,759,7,35,348,724,139,187,856
1992,Mark Eaton,C,35,UTA,81,2023,107,240,0,0,107,240,52,87,266
1992,Patrick Eddie,C,24,NYK,4,13,2,9,0,0,2,9,0,0,4
1992,Blue Edwards,SF,26,UTA,81,2283,433,830,39,103,394,727,113,146,1018
1992,James Edwards,C,36,LAC,72,1437,250,538,0,1,250,537,198,271,698
1992,Kevin Edwards,PG,26,MIA,81,1840,325,716,7,32,318,684,162,191,819
1992,Craig Ehlo,SG,30,CLE,63,2016,310,684,69,167,241,517,87,123,776
1992,Mario Elie,SG,28,GSW,79,1677,221,424,23,70,198,354,155,182,620
1992,Sean Elliott,SF,23,SAS,82,3120,514,1040,25,82,489,958,285,331,1338
1992,Dale Ellis,SF,31,MIL,81,2191,485,1034,138,329,347,705,164,212,1272
1992,LeRon Ellis,C,22,LAC,29,103,17,50,0,0,17,50,9,19,43
1992,Pervis Ellison,C,24,WSB,66,2511,547,1014,1,3,546,1011,227,312,1322
1992,A.J. English,SG,24,WSB,81,1665,366,846,6,34,360,812,148,176,886
1992,Patrick Ewing*,C,29,NYK,82,3150,796,1525,1,6,795,1519,377,511,1970
1992,Dave Feitl,C,29,NJN,34,175,33,77,0,0,33,77,16,19,82
1992,Duane Ferrell,SF,26,ATL,66,1598,331,632,11,33,320,599,166,218,839
1992,Danny Ferry,PF,25,CLE,68,937,134,328,17,48,117,280,61,73,346
1992,Vern Fleming,PG,29,IND,82,1737,294,610,6,27,288,583,132,179,726
1992,Sleepy Floyd,PG,31,HOU,82,1662,286,704,37,123,249,581,135,170,744
1992,Greg Foster,PF,23,WSB,49,548,89,193,0,1,89,192,35,49,213
1992,Rick Fox,SF,22,BOS,81,1535,241,525,23,70,218,455,139,184,644
1992,Tellis Frank,PF,26,MIN,10,140,18,33,0,0,18,33,10,15,46
1992,Anthony Frederick,SF,27,CHH,66,852,161,370,4,17,157,353,63,92,389
1992,Kevin Gamble,SF,26,BOS,82,2496,480,908,9,31,471,877,139,157,1108
1992,Winston Garland,PG,27,DEN,78,2209,333,750,9,28,324,722,171,199,846
1992,Tom Garrick,SG,25,TOT,40,549,59,143,1,4,58,139,18,26,137
1992,Tom Garrick,SG,25,SAS,19,374,44,93,0,1,44,92,10,16,98
1992,Tom Garrick,SG,25,MIN,15,112,11,33,1,2,10,31,6,8,29
1992,Tom Garrick,SG,25,DAL,6,63,4,17,0,1,4,16,2,2,10
1992,Chris Gatling,PF,24,GSW,54,612,117,206,0,4,117,202,72,109,306
1992,Kenny Gattison,PF,27,CHH,82,2223,423,799,0,2,423,797,196,285,1042
1992,Tate George,SG,23,NJN,70,1037,165,386,1,6,164,380,87,106,418
1992,Kendall Gill,SG,23,CHH,79,2906,666,1427,6,25,660,1402,284,381,1622
1992,Armen Gilliam,PF,27,PHI,81,2771,512,1001,0,2,512,999,343,425,1367
1992,Gerald Glass,SF,24,MIN,75,1822,383,871,16,54,367,817,77,125,859
1992,Mike Gminski,C,32,CHH,35,499,90,199,1,3,89,196,21,28,202
1992,Dan Godfread,C,24,HOU,1,2,0,0,0,0,0,0,0,0,0
1992,Paul Graham,SG,24,ATL,78,1718,305,682,55,141,250,541,126,170,791
1992,Ron Grandison,PF,27,CHH,3,25,2,4,0,0,2,4,6,10,10
1992,Gary Grant,PG,26,LAC,78,2049,275,595,15,51,260,544,44,54,609
1992,Greg Grant,PG,25,TOT,68,891,99,225,7,18,92,207,20,24,225
1992,Greg Grant,PG,25,CHH,13,57,0,8,0,0,0,8,1,2,1
1992,Greg Grant,PG,25,PHI,55,834,99,217,7,18,92,199,19,22,224
1992,Harvey Grant,SF,26,WSB,64,2388,489,1022,1,8,488,1014,176,220,1155
1992,Horace Grant,PF,26,CHI,81,2859,457,790,0,2,457,788,235,317,1149
1992,Jeff Grayer,SG,26,MIL,82,1659,309,689,19,66,290,623,102,153,739
1992,A.C. Green,PF,28,LAL,82,2902,382,803,12,56,370,747,340,457,1116
1992,Rickey Green,PG,37,BOS,26,367,46,103,1,4,45,99,13,18,106
1992,Sean Green,SG,21,IND,35,256,62,158,2,10,60,148,15,28,141
1992,Sidney Green,PF,31,SAS,80,1127,147,344,0,0,147,344,73,89,367
1992,Jack Haley,C,28,LAL,49,394,31,84,0,0,31,84,14,29,76
1992,Tom Hammonds,PF,24,WSB,37,984,195,400,0,1,195,399,50,82,440
1992,Bob Hansen,SG,31,TOT,68,809,79,178,7,27,72,151,8,22,173
1992,Bob Hansen,SG,31,SAC,2,40,4,9,0,2,4,7,0,0,8
1992,Bob Hansen,SG,31,CHI,66,769,75,169,7,25,68,144,8,22,165
1992,Tim Hardaway,PG,25,GSW,81,3332,734,1592,127,376,607,1216,298,389,1893
1992,Derek Harper,PG,30,DAL,65,2252,448,1011,58,186,390,825,198,261,1152
1992,Ron Harper,SG,28,LAC,82,3144,569,1292,64,211,505,1081,293,398,1495
1992,Scott Hastings,C,31,DEN,40,421,17,50,0,9,17,41,24,28,58
1992,Hersey Hawkins,SG,25,PHI,81,3013,521,1127,91,229,430,898,403,461,1536
1992,Gerald Henderson,PG,36,TOT,16,96,12,32,3,8,9,24,9,11,36
1992,Gerald Henderson,PG,36,HOU,8,34,4,11,0,3,4,8,4,6,12
1992,Gerald Henderson,PG,36,DET,8,62,8,21,3,5,5,16,5,5,24
1992,Steve Henson,PG,23,MIL,50,386,52,144,23,48,29,96,23,29,150
1992,Carl Herrera,PF,25,HOU,43,566,83,161,0,1,83,160,25,44,191
1992,Rod Higgins,SF,32,GSW,25,535,87,211,33,95,54,116,48,59,255
1992,Sean Higgins,PF-SF,23,TOT,38,616,127,277,6,25,121,252,31,36,291
1992,Sean Higgins,SF,23,SAS,6,36,4,15,0,1,4,14,7,7,15
1992,Sean Higgins,PF,23,ORL,32,580,123,262,6,24,117,238,24,29,276
1992,Tyrone Hill,C,23,GSW,82,1886,254,487,0,1,254,486,163,235,671
1992,Donald Hodge,PF,22,DAL,51,1058,163,328,0,0,163,328,100,150,426
1992,Craig Hodges,SG,31,CHI,56,555,93,242,36,96,57,146,16,17,238
1992,Dave Hoppen,C,27,PHI,11,40,2,7,0,0,2,7,5,10,9
1992,Dennis Hopson,SG,26,TOT,71,1314,276,593,12,47,264,546,179,253,743
1992,Dennis Hopson,SG,26,CHI,2,10,1,2,0,0,1,2,0,0,2
1992,Dennis Hopson,SG,26,SAC,69,1304,275,591,12,47,263,544,179,253,741
1992,Jeff Hornacek,SG,28,PHO,81,3078,635,1240,83,189,552,1051,279,315,1632
1992,Brian Howard,SF,24,DAL,27,318,54,104,1,2,53,102,22,31,131
1992,Jay Humphries,PG,29,MIL,71,2261,377,803,42,144,335,659,195,249,991
1992,Cedric Hunter,PG,27,CHH,1,1,0,0,0,0,0,0,0,0,0
1992,Mike Iuzzolino,PG,24,DAL,52,1280,160,355,59,136,101,219,107,128,486
1992,Jaren Jackson,SG,24,GSW,5,54,11,23,0,0,11,23,4,6,26
1992,Mark Jackson,PG,26,NYK,81,2461,367,747,11,43,356,704,171,222,916
1992,Dave Jamerson,SG,24,HOU,48,378,79,191,8,28,71,163,25,27,191
1992,Henry James,SF,26,CLE,65,866,164,403,29,90,135,313,61,76,418
1992,Les Jepsen,C,24,SAC,31,87,9,24,0,1,9,23,7,11,25
1992,Avery Johnson,PG,26,TOT,69,1235,158,330,4,15,154,315,66,101,386
1992,Avery Johnson,PG,26,SAS,20,463,55,108,1,5,54,103,24,32,135
1992,Avery Johnson,PG,26,HOU,49,772,103,222,3,10,100,212,42,69,251
1992,Buck Johnson,SF,28,HOU,80,2202,290,633,1,9,289,624,104,143,685
1992,Eddie Johnson,SF,32,SEA,81,2366,534,1164,27,107,507,1057,291,338,1386
1992,Kevin Johnson,PG,25,PHO,78,2899,539,1125,10,46,529,1079,448,555,1536
1992,Larry Johnson,PF,22,CHH,82,3047,616,1258,5,22,611,1236,339,409,1576
1992,Vinnie Johnson,SG,35,SAS,60,1350,202,499,19,60,183,439,55,85,478
1992,Charles Jones,C,34,WSB,75,1365,33,90,0,0,33,90,20,40,86
1992,Michael Jordan*,SG,28,CHI,80,3102,943,1818,27,100,916,1718,491,590,2404
1992,Shawn Kemp,PF,22,SEA,64,1808,362,718,0,3,362,715,270,361,994
1992,Steve Kerr,PG,26,CLE,48,847,121,237,32,74,89,163,45,54,319
1992,Jerome Kersey,SF,29,POR,77,2553,398,852,1,8,397,844,174,262,971
1992,Alec Kessler,PF,25,MIA,77,1197,158,383,0,0,158,383,94,115,410
1992,Bo Kimble,SG,25,LAC,34,277,44,111,4,13,40,98,20,31,112
1992,Albert King,SF,32,WSB,6,59,11,30,2,7,9,23,7,8,31
1992,Rich King,C,22,SEA,40,213,27,71,0,1,27,70,34,45,88
1992,Stacey King,PF,25,CHI,79,1268,215,425,2,5,213,420,119,158,551
1992,Greg Kite,C,30,ORL,72,1479,94,215,0,1,94,214,40,68,228
1992,Joe Kleine,C,30,BOS,70,991,144,293,4,8,140,285,34,48,326
1992,Negele Knight,PG,24,PHO,42,631,103,217,4,13,99,204,33,48,243
1992,Bart Kofoed,SG,27,SEA,44,239,25,53,1,7,24,46,15,26,66
1992,Jon Koncak,C,28,ATL,77,1489,111,284,0,12,111,272,19,29,241
1992,Larry Krystkowiak,PF,27,MIL,79,1848,293,660,0,5,293,655,128,169,714
1992,Bill Laimbeer,C,34,DET,81,2234,342,727,32,85,310,642,67,75,783
1992,Jerome Lane,PF,25,TOT,14,177,14,46,0,0,14,46,9,27,37
1992,Jerome Lane,PF,25,DEN,9,141,10,40,0,0,10,40,8,19,28
1992,Jerome Lane,PF,25,IND,3,30,3,5,0,0,3,5,0,6,6
1992,Jerome Lane,PF,25,MIL,2,6,1,1,0,0,1,1,1,2,3
1992,Andrew Lang,C,25,PHO,81,1965,248,475,0,1,248,474,126,164,622
1992,Eric Leckner,C,25,CHH,59,716,79,154,0,1,79,153,38,51,196
1992,Doug Lee,SG,27,NJN,46,307,50,116,10,37,40,79,10,19,120
1992,Gary Leonard,C,24,ATL,5,13,4,6,0,0,4,6,2,2,10
1992,Jim Les,PG,28,SAC,62,712,74,192,45,131,29,61,38,47,231
1992,Fat Lever,SG,31,DAL,31,884,135,349,17,52,118,297,60,80,347
1992,Cliff Levingston,PF,31,CHI,79,1020,125,251,1,6,124,245,60,96,311
1992,Reggie Lewis,SG,26,BOS,82,3070,703,1397,5,21,698,1376,292,343,1703
1992,Marcus Liberty,SF,23,DEN,75,1527,275,621,17,50,258,571,131,180,698
1992,Todd Lichti,SG,25,DEN,68,1176,173,376,1,9,172,367,99,118,446
1992,Alton Lister,C,33,GSW,26,293,44,79,0,0,44,79,14,33,102
1992,Brad Lohaus,PF,27,MIL,70,1081,162,360,57,144,105,216,27,41,408
1992,Grant Long,PF,25,MIA,82,3063,440,890,6,22,434,868,326,404,1212
1992,Luc Longley,C,23,MIN,66,991,114,249,0,0,114,249,53,80,281
1992,Kevin Lynch,SG,23,CHH,55,819,93,223,3,8,90,215,35,46,224
1992,Mark Macon,SG,22,DEN,76,2304,333,889,4,30,329,859,135,185,805
1992,Dan Majerle,SF,26,PHO,82,2853,551,1153,87,228,464,925,229,303,1418
1992,Jeff Malone,SG,30,UTA,81,2922,691,1353,1,12,690,1341,256,285,1639
1992,Karl Malone*,PF,28,UTA,81,3054,798,1516,3,17,795,1499,673,865,2272
1992,Moses Malone*,C,36,MIL,82,2511,440,929,3,8,437,921,396,504,1279
1992,Danny Manning,PF,25,LAC,82,2904,650,1199,0,5,650,1194,279,385,1579
1992,Sarunas Marciulionis*,SG,27,GSW,72,2117,491,912,3,10,488,902,376,477,1361
1992,Anthony Mason,PF,25,NYK,82,2198,203,399,0,0,203,399,167,260,573
1992,Tony Massenburg,PF,24,TOT,18,90,10,25,0,0,10,25,9,15,29
1992,Tony Massenburg,PF,24,SAS,1,9,1,5,0,0,1,5,0,0,2
1992,Tony Massenburg,PF,24,CHH,3,13,0,3,0,0,0,3,1,2,1
1992,Tony Massenburg,PF,24,BOS,7,46,4,9,0,0,4,9,2,4,10
1992,Tony Massenburg,PF,24,GSW,7,22,5,8,0,0,5,8,6,9,16
1992,Vernon Maxwell,SG,26,HOU,80,2700,502,1216,162,473,340,743,206,267,1372
1992,Tharon Mayes,SG,23,TOT,24,255,30,99,15,41,15,58,24,36,99
1992,Tharon Mayes,SG,23,PHI,21,215,28,94,14,39,14,55,20,30,90
1992,Tharon Mayes,SG,23,LAC,3,40,2,5,1,2,1,3,4,6,9
1992,Travis Mays,PG,23,ATL,2,32,6,14,3,6,3,8,2,2,17
1992,Bob McCann,SF,27,DET,26,129,13,33,0,1,13,32,4,13,30
1992,George McCloud,SF,24,IND,51,892,128,313,32,94,96,219,50,64,338
1992,Tim McCormick,C,29,NYK,22,108,14,33,0,0,14,33,14,21,42
1992,Rodney McCray,SF,30,DAL,75,2106,271,622,25,85,246,537,110,153,677
1992,Xavier McDaniel,SF,28,NYK,82,2344,488,1021,12,39,476,982,137,192,1125
1992,Kevin McHale*,PF,34,BOS,56,1398,323,634,0,13,323,621,134,163,780
1992,Derrick McKey,SF,25,SEA,52,1757,285,604,19,50,266,554,188,222,777
1992,Carlton McKinney,SG,27,NYK,2,9,2,9,0,0,2,9,0,0,4
1992,Nate McMillan,PG,27,SEA,72,1652,177,405,27,98,150,307,54,84,435
1992,Reggie Miller*,SG,26,IND,82,3120,562,1121,129,341,433,780,442,515,1695
1992,Terry Mills,PF,24,NJN,82,1714,310,670,8,23,302,647,114,152,742
1992,Sam Mitchell,PF,28,MIN,82,2151,307,725,2,11,305,714,209,266,825
1992,Rodney Monroe,SG,23,ATL,38,313,53,144,6,27,47,117,19,23,131
1992,Tracy Moore,SF,26,DAL,42,782,130,325,30,84,100,241,65,78,355
1992,Chris Morris,SF,26,NJN,77,2394,346,726,22,110,324,616,165,231,879
1992,John Morton,SF-SG,24,TOT,25,270,36,93,2,16,34,77,32,38,106
1992,John Morton,SG,24,CLE,4,54,3,12,0,1,3,11,8,9,14
1992,John Morton,SF,24,MIA,21,216,33,81,2,15,31,66,24,29,92
1992,Chris Mullin*,SF,28,GSW,81,3346,830,1584,64,175,766,1409,350,420,2074
1992,Eric Murdock,PG,23,UTA,50,478,76,183,5,26,71,157,46,61,203
1992,Tod Murphy,PF,28,MIN,47,429,39,80,1,2,38,78,19,34,98
1992,Jerrod Mustaf,PF,22,PHO,52,545,92,193,0,0,92,193,49,71,233
1992,Dikembe Mutombo*,C,25,DEN,71,2716,428,869,0,0,428,869,321,500,1177
1992,Larry Nance,PF,32,CLE,81,2880,556,1032,0,6,556,1026,263,320,1375
1992,Ed Nealy,PF,31,PHO,52,505,62,121,20,50,42,71,16,24,160
1992,Chuck Nevitt,C,32,CHI,4,9,1,3,0,0,1,3,0,0,2
1992,Johnny Newman,SF,28,CHH,55,1651,295,618,13,46,282,572,236,308,839
1992,Ken Norman,SF,27,LAC,77,2009,402,821,4,28,398,793,121,226,929
1992,Charles Oakley,PF,28,NYK,82,2309,210,402,0,3,210,399,86,117,506
1992,Alan Ogg,C,24,MIA,43,367,46,84,0,0,46,84,16,30,108
1992,Hakeem Olajuwon*,C,29,HOU,70,2636,591,1177,0,1,591,1176,328,428,1510
1992,Brian Oliver,SG,23,PHI,34,279,33,100,0,4,33,96,15,22,81
1992,Jimmy Oliver,SG,22,CLE,27,252,39,98,1,9,38,89,17,22,96
1992,Billy Owens,PF,22,GSW,80,2510,468,891,1,9,467,882,204,312,1141
1992,Keith Owens,SF,22,LAL,20,80,9,32,0,0,9,32,8,10,26
1992,Robert Pack,PG,22,POR,72,894,115,272,0,10,115,262,102,127,332
1992,Robert Parish*,C,38,BOS,79,2285,468,874,0,0,468,874,179,232,1115
1992,John Paxson,PG,31,CHI,79,1946,257,487,12,44,245,443,29,37,555
1992,Kenny Payne,SF,25,PHI,49,353,65,145,5,12,60,133,9,13,144
1992,Gary Payton*,PG,23,SEA,81,2549,331,734,3,23,328,711,99,148,764
1992,Will Perdue,C,26,CHI,77,1007,152,278,1,2,151,276,45,91,350
1992,Sam Perkins,PF,30,LAL,63,2332,361,803,15,69,346,734,304,372,1041
1992,Elliot Perry,PG,22,TOT,50,437,49,129,1,7,48,122,27,41,126
1992,Elliot Perry,PG,22,LAC,10,66,6,15,0,2,6,13,1,2,13
1992,Elliot Perry,PG,22,CHH,40,371,43,114,1,5,42,109,26,39,113
1992,Tim Perry,PF,26,PHO,80,2483,413,789,3,8,410,781,153,215,982
1992,Chuck Person,SF,27,IND,81,2923,616,1284,132,354,484,930,133,197,1497
1992,Jim Petersen,PF,29,GSW,27,169,18,40,0,2,18,38,7,10,43
1992,Drazen Petrovic*,SG,27,NJN,82,3027,668,1315,123,277,545,1038,232,287,1691
1992,Bobby Phills,SG,22,CLE,10,65,12,28,0,2,12,26,7,11,31
1992,Ricky Pierce,SG,32,SEA,78,2658,620,1306,33,123,587,1183,417,455,1690
1992,Ed Pinckney,PF,28,BOS,81,1917,203,378,0,1,203,377,207,255,613
1992,Scottie Pippen*,SF,26,CHI,82,3164,687,1359,16,80,671,1279,330,434,1720
1992,Olden Polynice,C,27,LAC,76,1834,244,470,0,1,244,469,125,201,613
1992,Dave Popson,PF,27,MIL,5,26,3,7,0,1,3,6,1,2,7
1992,Terry Porter,PG,28,POR,82,2784,521,1129,128,324,393,805,315,368,1485
1992,Paul Pressey,SG,33,SAS,56,759,60,161,3,21,57,140,28,41,151
1992,Mark Price,PG,27,CLE,72,2138,438,897,101,261,337,636,270,285,1247
1992,Kevin Pritchard,PG,24,BOS,11,136,16,34,0,3,16,31,14,18,46
1992,Brian Quinnett,SG,25,TOT,39,326,43,124,13,41,30,83,16,26,115
1992,Brian Quinnett,SG,25,NYK,24,190,28,73,10,26,18,47,8,14,74
1992,Brian Quinnett,SG,25,DAL,15,136,15,51,3,15,12,36,8,12,41
1992,Kurt Rambis,PF,33,PHO,28,381,38,82,0,0,38,82,14,18,90
1992,Mark Randall,PF,24,TOT,54,441,68,149,3,16,65,133,32,43,171
1992,Mark Randall,PF,24,CHI,15,67,10,22,0,2,10,20,6,8,26
1992,Mark Randall,PF,24,MIN,39,374,58,127,3,14,55,113,26,35,145
1992,Blair Rasmussen,C,29,ATL,81,1968,347,726,5,23,342,703,30,40,729
1992,J.R. Reid,C,23,CHH,51,1257,213,435,0,3,213,432,134,190,560
1992,Jerry Reynolds,SG,29,ORL,46,1159,197,518,3,24,194,494,158,189,555
1992,Glen Rice,SF,24,MIA,79,3007,672,1432,155,396,517,1036,266,318,1765
1992,Pooh Richardson,PG,25,MIN,82,2922,587,1261,53,155,534,1106,123,178,1350
1992,Mitch Richmond*,SG,26,SAC,80,3095,685,1465,103,268,582,1197,330,406,1803
1992,David Rivers,PG,27,LAC,15,122,10,30,0,1,10,29,10,11,30
1992,Doc Rivers,PG,30,LAC,59,1657,226,533,26,92,200,441,163,196,641
1992,Fred Roberts,PF,31,MIL,80,1746,311,645,19,37,292,608,128,171,769
1992,Stanley Roberts,C,21,ORL,55,1118,236,446,0,1,236,445,101,196,573
1992,Alvin Robertson,SG,29,MIL,82,2463,396,922,67,210,329,712,151,198,1010
1992,Cliff Robinson,PF,31,LAL,9,78,11,27,0,1,11,26,7,8,29
1992,Clifford Robinson,SF,25,POR,82,2124,398,854,1,11,397,843,219,330,1016
1992,David Robinson*,C,26,SAS,68,2564,592,1074,1,8,591,1066,393,561,1578
1992,Larry Robinson,SG,24,BOS,1,6,1,5,0,0,1,5,0,0,2
1992,Rumeal Robinson,PG,25,ATL,81,2220,423,928,34,104,389,824,175,275,1055
1992,Dennis Rodman*,PF,30,DET,82,3301,342,635,32,101,310,534,84,140,800
1992,Tree Rollins,C,36,HOU,59,697,46,86,0,0,46,86,26,30,118
1992,Donald Royal,SF,25,SAS,60,718,80,178,0,0,80,178,92,133,252
1992,Delaney Rudd,SG,29,UTA,65,538,75,188,11,47,64,141,32,42,193
1992,Jeff Ruland,C,33,PHI,13,209,20,38,0,0,20,38,11,16,51
1992,John Salley,PF,27,DET,72,1774,249,486,0,3,249,483,186,260,684
1992,Ralph Sampson*,C,31,WSB,10,108,9,29,0,2,9,27,4,6,22
1992,Jeff Sanders,SF,26,ATL,12,117,20,45,0,0,20,45,7,9,47
1992,Mike Sanders,SF,31,TOT,31,633,92,161,1,3,91,158,36,47,221
1992,Mike Sanders,SF,31,IND,10,81,11,22,0,0,11,22,5,6,27
1992,Mike Sanders,SF,31,CLE,21,552,81,139,1,3,80,136,31,41,194
1992,Danny Schayes,C,32,MIL,43,726,83,199,0,0,83,199,74,96,240
1992,Steve Scheffler,C,24,TOT,11,61,6,9,0,0,6,9,9,12,21
1992,Steve Scheffler,C,24,SAC,4,15,2,2,0,0,2,2,5,6,9
1992,Steve Scheffler,C,24,DEN,7,46,4,7,0,0,4,7,4,6,12
1992,Dwayne Schintzius,C,23,SAC,33,400,50,117,0,4,50,113,10,12,110
1992,Detlef Schrempf,PF,29,IND,80,2605,496,925,23,71,473,854,365,441,1380
1992,Byron Scott,SG,30,LAL,82,2679,460,1005,54,157,406,848,244,291,1218
1992,Dennis Scott,SF,23,ORL,18,608,133,331,29,89,104,242,64,71,359
1992,Rony Seikaly,C,26,MIA,79,2800,463,947,0,3,463,944,370,505,1296
1992,Brad Sellers,PF,29,DET,43,226,41,88,0,1,41,87,20,26,102
1992,Charles Shackleford,C,25,PHI,72,1399,205,422,0,1,205,421,63,95,473
1992,Brian Shaw,PG,25,TOT,63,1423,209,513,5,23,204,490,72,91,495
1992,Brian Shaw,PG,25,BOS,17,436,70,164,0,7,70,157,35,40,175
1992,Brian Shaw,PG,25,MIA,46,987,139,349,5,16,134,333,37,51,320
1992,Lionel Simmons,SF,23,SAC,78,2895,527,1162,1,5,526,1157,281,365,1336
1992,Scott Skiles,PG,27,ORL,75,2377,359,868,91,250,268,618,248,277,1057
1992,Charles Smith,SF,26,LAC,49,1310,251,539,0,6,251,533,212,270,714
1992,Doug Smith,PF,22,DAL,76,1707,291,702,0,11,291,691,89,121,671
1992,Kenny Smith,PG,26,HOU,81,2735,432,910,54,137,378,773,219,253,1137
1992,LaBradford Smith,SG,22,WSB,48,708,100,246,2,21,98,225,45,56,247
1992,Larry Smith,PF,34,HOU,45,800,50,92,0,1,50,91,4,11,104
1992,Otis Smith,SG,28,ORL,55,877,116,318,8,21,108,297,70,91,310
1992,Steve Smith,SG,22,MIA,61,1806,297,654,40,125,257,529,95,127,729
1992,Tony Smith,PG,23,LAL,63,820,113,283,0,11,113,272,49,75,275
1992,Rik Smits,C,25,IND,74,1772,436,855,0,2,436,853,152,193,1024
1992,Mike Smrek,C,29,GSW,2,3,0,0,0,0,0,0,0,0,0
1992,Rory Sparrow,PG,33,TOT,46,489,58,151,3,15,55,136,8,13,127
1992,Rory Sparrow,PG,33,CHI,4,18,1,8,1,2,0,6,0,0,3
1992,Rory Sparrow,PG,33,LAL,42,471,57,143,2,13,55,130,8,13,124
1992,Felton Spencer,C,24,MIN,61,1481,141,331,0,0,141,331,123,178,405
1992,John Starks,SG,26,NYK,82,2118,405,902,94,270,311,632,235,302,1139
1992,Larry Stewart,PF,23,WSB,76,2229,303,590,0,3,303,587,188,233,794
1992,John Stockton*,PG,29,UTA,82,3002,453,939,83,204,370,735,308,366,1297
1992,Rod Strickland,PG,25,SAS,57,2053,300,659,5,15,295,644,182,265,787
1992,Derek Strong,PF,23,WSB,1,12,0,4,0,0,0,4,3,4,3
1992,Lamont Strothers,SG,23,POR,4,17,4,12,0,2,4,10,2,4,10
1992,Jon Sundvold,PG,30,MIA,3,8,1,3,1,1,0,2,0,0,3
1992,Greg Sutton,PG,24,SAS,67,601,93,240,26,89,67,151,34,45,246
1992,Terry Teagle,SG,31,LAL,82,1602,364,805,1,4,363,801,151,197,880
1992,Carl Thomas,SG,22,SAC,1,31,5,12,1,2,4,10,1,2,12
1992,Charles Thomas,SG,22,DET,36,156,18,51,2,17,16,34,10,15,48
1992,Isiah Thomas*,PG,30,DET,78,2918,564,1264,25,86,539,1178,292,378,1445
1992,Billy Thompson,SF,28,GSW,1,1,0,0,0,0,0,0,0,0,0
1992,LaSalle Thompson,C,30,IND,80,1299,168,359,0,2,168,357,58,71,394
1992,Stephen Thompson,SG,23,TOT,19,91,14,37,0,1,14,36,3,8,31
1992,Stephen Thompson,SG,23,ORL,1,15,1,3,0,0,1,3,0,0,2
1992,Stephen Thompson,SG,23,SAC,18,76,13,34,0,1,13,33,3,8,29
1992,Bob Thornton,PF,29,UTA,2,6,1,7,0,0,1,7,2,2,4
1992,Otis Thorpe,PF,29,HOU,82,3056,558,943,0,7,558,936,304,463,1420
1992,Sedale Threatt,PG,30,LAL,82,3070,509,1041,20,62,489,979,202,243,1240
1992,Wayman Tisdale,PF,27,SAC,72,2521,522,1043,0,2,522,1041,151,198,1195
1992,Tom Tolbert,PF,26,GSW,35,310,33,86,2,8,31,78,22,40,90
1992,Trent Tucker,SG,32,SAS,24,415,60,129,19,48,41,81,16,20,155
1992,Andre Turner,PG,27,WSB,70,871,111,261,1,16,110,245,61,77,284
1992,Jeff Turner,SF,29,ORL,75,1591,225,499,1,8,224,491,79,114,530
1992,John Turner,SF,24,HOU,42,345,43,98,0,0,43,98,31,59,117
1992,Kiki Vandeweghe,SF,33,NYK,67,956,188,383,26,66,162,317,65,81,467
1992,Loy Vaught,PF,23,LAC,79,1687,271,551,4,5,267,546,55,69,601
1992,Joao Vianna,SF,25,DAL,1,9,1,2,0,0,1,2,0,0,2
1992,Sam Vincent,PG,28,ORL,39,885,150,349,1,13,149,336,110,130,411
1992,Alexander Volkov,C,27,ATL,77,1516,251,569,35,110,216,459,125,198,662
1992,Stojko Vrankovic,C,28,BOS,19,110,15,32,0,0,15,32,7,12,37
1992,Darrell Walker,SG,30,DET,74,1541,161,381,0,10,161,371,65,105,387
1992,Spud Webb,PG,28,SAC,77,2724,448,1006,73,199,375,807,262,305,1231
1992,Doug West,SG,24,MIN,80,2540,463,894,4,23,459,871,186,231,1116
1992,Mark West,C,31,PHO,82,1436,196,310,0,0,196,310,109,171,501
1992,Ennis Whatley,PG,29,POR,23,209,21,51,0,4,21,47,27,31,69
1992,Randy White,PF,24,DAL,65,1021,145,382,4,27,141,355,124,162,418
1992,Mitchell Wiggins,SG,32,PHI,49,569,88,229,0,1,88,228,35,51,211
1992,Morlon Wiley,PG,25,TOT,53,870,83,193,14,42,69,151,24,35,204
1992,Morlon Wiley,PG,25,ORL,9,90,9,28,0,4,9,24,3,5,21
1992,Morlon Wiley,PG,25,SAS,3,13,3,5,0,0,3,5,0,0,6
1992,Morlon Wiley,PG,25,ATL,41,767,71,160,14,38,57,122,21,30,177
1992,Dominique Wilkins*,SF,32,ATL,42,1601,424,914,37,128,387,786,294,352,1179
1992,Gerald Wilkins,SG,28,NYK,82,2344,431,964,38,108,393,856,116,159,1016
1992,Buck Williams,PF,31,POR,80,2519,340,563,0,1,340,562,221,293,901
1992,Herb Williams,C,33,DAL,75,2040,367,851,1,6,366,845,124,171,859
1992,Hot Rod,C,29,CLE,80,2432,341,678,0,4,341,674,270,359,952
1992,Jayson Williams,PF,23,PHI,50,646,75,206,0,0,75,206,56,88,206
1992,Kenny Williams,SF,22,IND,60,565,113,218,0,4,113,214,26,43,252
1992,Micheal Williams,PG,25,IND,79,2750,404,824,8,33,396,791,372,427,1188
1992,Reggie Williams,SF,27,DEN,81,2623,601,1277,56,156,545,1121,216,269,1474
1992,Scott Williams,PF,23,CHI,63,690,83,172,0,3,83,169,48,74,214
1992,Kevin Willis,PF,29,ATL,81,2962,591,1224,6,37,585,1187,292,363,1480
1992,Kennard Winchester,SF-SG,25,TOT,19,81,13,30,1,2,12,28,8,10,35
1992,Kennard Winchester,SG,25,HOU,4,17,1,3,0,0,1,3,0,0,2
1992,Kennard Winchester,SF,25,NYK,15,64,12,27,1,2,11,25,8,10,33
1992,David Wingate,SG,28,WSB,81,2127,266,572,1,18,265,554,105,146,638
1992,Randy Wittman,SG,32,IND,24,115,8,19,0,0,8,19,1,2,17
1992,Joe Wolf,C,27,DEN,67,1160,100,277,1,11,99,266,53,66,254
1992,Orlando Woolridge,SF,32,DET,82,2113,452,907,1,9,451,898,241,353,1146
1992,James Worthy*,SF,30,LAL,54,2108,450,1007,9,43,441,964,166,204,1075
1992,Danny Young,PG,29,TOT,62,1023,100,255,23,70,77,185,57,67,280
1992,Danny Young,PG,29,POR,18,134,16,40,3,10,13,30,10,14,45
1992,Danny Young,PG,29,LAC,44,889,84,215,20,60,64,155,47,53,235
,,,,,,,,,,,,,,,
1993,Alaa Abdelnaby,PF,24,TOT,75,1311,245,473,0,1,245,472,88,116,578
1993,Alaa Abdelnaby,PF,24,MIL,12,159,26,56,0,1,26,55,12,16,64
1993,Alaa Abdelnaby,PF,24,BOS,63,1152,219,417,0,0,219,417,76,100,514
1993,Mahmoud Abdul-Rauf,PG,23,DEN,81,2710,633,1407,70,197,563,1210,217,232,1553
1993,Mark Acres,C,30,TOT,18,269,26,49,1,2,25,47,11,16,64
1993,Mark Acres,C,30,HOU,6,23,2,9,1,2,1,7,1,2,6
1993,Mark Acres,C,30,WSB,12,246,24,40,0,0,24,40,10,14,58
1993,Michael Adams,PG,30,WSB,70,2499,365,831,68,212,297,619,237,277,1035
1993,Rafael Addison,SF,28,NJN,68,1164,182,411,7,34,175,377,57,70,428
1993,Mark Aguirre,SF,33,DET,51,1056,187,422,30,83,157,339,99,129,503
1993,Danny Ainge,SG,33,PHO,80,2163,337,730,150,372,187,358,123,145,947
1993,Victor Alexander,C,23,GSW,72,1753,344,667,10,22,334,645,111,162,809
1993,Eric Anderson,PF,22,NYK,16,44,5,18,0,0,5,18,11,13,21
1993,Kenny Anderson,PG,22,NJN,55,2010,370,850,7,25,363,825,180,232,927
1993,Nick Anderson,SG,25,ORL,79,2920,594,1324,88,249,506,1075,298,402,1574
1993,Ron Anderson,SF,34,PHI,69,1263,225,544,39,120,186,424,72,89,561
1993,Willie Anderson,SG,26,SAS,38,560,80,186,1,8,79,178,22,28,183
1993,Greg Anthony,PG,25,NYK,70,1699,174,419,4,30,170,389,107,159,459
1993,B.J. Armstrong,PG,25,CHI,82,2492,408,818,63,139,345,679,130,151,1009
1993,Vincent Askew,SG,26,TOT,73,1129,152,309,2,6,150,303,105,149,411
1993,Vincent Askew,SG,26,SAC,9,76,8,17,0,0,8,17,11,15,27
1993,Vincent Askew,SG,26,SEA,64,1053,144,292,2,6,142,286,94,134,384
1993,Keith Askins,SF,25,MIA,69,935,88,213,22,65,66,148,29,40,227
1993,Stacey Augmon,SG,24,ATL,73,2112,397,792,0,4,397,788,227,307,1021
1993,Isaac Austin,C,23,UTA,46,306,50,112,0,1,50,111,29,44,129
1993,Anthony Avent,PF,23,MIL,82,2285,347,802,0,2,347,800,112,172,806
1993,John Bagley,PG,32,BOS,10,97,9,25,0,1,9,24,5,6,23
1993,Thurl Bailey,PF,31,MIN,70,1276,203,446,0,0,203,446,119,142,525
1993,Steve Bardo,SG,24,DAL,23,175,19,62,1,6,18,56,12,17,51
1993,Charles Barkley*,PF,29,PHO,76,2859,716,1376,67,220,649,1156,445,582,1944
1993,Dana Barros,PG,25,SEA,69,1243,214,474,64,169,150,305,49,59,541
1993,Jon Barry,SG,23,MIL,47,552,76,206,21,63,55,143,33,49,206
1993,John Battle,SG,30,CLE,41,497,83,200,1,6,82,194,56,72,223
1993,Kenny Battle,SG,28,BOS,3,29,6,13,0,1,6,12,2,2,14
1993,William Bedford,C,29,SAS,16,66,9,27,1,1,8,26,6,12,25
1993,Benoit Benjamin,C,28,TOT,59,754,133,271,0,0,133,271,69,104,335
1993,Benoit Benjamin,C,28,SEA,31,448,81,163,0,0,81,163,47,67,209
1993,Benoit Benjamin,C,28,LAL,28,306,52,108,0,0,52,108,22,37,126
1993,Tony Bennett,PG,23,CHH,75,857,110,260,26,80,84,180,30,41,276
1993,David Benoit,SF,24,UTA,82,1712,258,592,34,98,224,494,114,152,664
1993,Rolando Blackman,SG,33,NYK,60,1434,239,539,31,73,208,466,71,90,580
1993,Alex Blackwell,SF,22,LAL,27,109,14,42,0,3,14,39,6,8,34
1993,Lance Blanks,SG,26,MIN,61,642,65,150,11,43,54,107,20,32,161
1993,Ricky Blanton,SF,26,CHI,2,13,3,7,0,0,3,7,0,0,6
1993,Mookie Blaylock,PG,25,ATL,80,2820,414,964,118,315,296,649,123,169,1069
1993,Muggsy Bogues,PG,28,CHH,81,2833,331,730,6,26,325,704,140,168,808
1993,Manute Bol,C,30,PHI,58,855,52,127,10,32,42,95,12,19,126
1993,Walter Bond,SG,23,DAL,74,1578,227,565,7,42,220,523,129,167,590
1993,Anthony Bonner,PF,24,SAC,70,1764,229,497,0,7,229,490,143,241,601
1993,Anthony Bowie,SG,29,ORL,77,1761,268,569,15,48,253,521,67,84,618
1993,Sam Bowie,C,31,NJN,79,2092,287,638,2,6,285,632,141,181,717
1993,Terrell Brandon,PG,22,CLE,82,1622,297,621,13,42,284,579,118,143,725
1993,Randy Breuer,C,32,ATL,12,107,15,31,0,0,15,31,2,5,32
1993,Frank Brickowski,C,33,MIL,66,2075,456,836,8,26,448,810,195,268,1115
1993,Kevin Brooks,SF,23,DEN,55,571,93,233,6,26,87,207,35,40,227
1993,Scott Brooks,PG,27,HOU,82,1516,183,385,41,99,142,286,112,135,519
1993,Chucky Brown,SF,24,NJN,77,1186,160,331,0,5,160,326,71,98,391
1993,Dee Brown,PG,24,BOS,80,2254,328,701,26,82,302,619,192,242,874
1993,Mike Brown,C,29,UTA,82,1551,176,409,0,1,176,408,113,164,465
1993,Randy Brown,PG,24,SAC,75,1726,225,486,2,6,223,480,115,157,567
1993,Mark Bryant,C,27,POR,80,1396,186,370,0,1,186,369,104,148,476
1993,Jud Buechler,SF,24,GSW,70,1287,176,403,20,59,156,344,65,87,437
1993,Matt Bullard,PF,25,HOU,79,1356,213,494,91,243,122,251,58,74,575
1993,Willie Burton,SF,24,MIA,26,451,54,141,5,15,49,126,91,127,204
1993,Steve Burtt,SG,30,WSB,4,35,10,26,1,3,9,23,8,10,29
1993,Michael Cage,C,31,SEA,82,2156,219,416,0,1,219,415,61,130,499
1993,Dexter Cambridge,SF,23,DAL,53,885,151,312,0,4,151,308,68,99,370
1993,Elden Campbell,PF,24,LAL,79,1551,238,520,0,3,238,517,130,204,606
1993,Tony Campbell,SF,30,NYK,58,1062,194,396,2,5,192,391,59,87,449
1993,Antoine Carr,PF,31,SAS,71,1947,379,705,0,5,379,700,174,224,932
1993,Bill Cartwright,C,35,CHI,63,1253,141,343,0,0,141,343,72,98,354
1993,Terry Catledge,PF,29,ORL,21,262,36,73,0,0,36,73,27,34,99
1993,Duane Causwell,C,24,SAC,55,1211,175,321,0,1,175,320,103,165,453
1993,Cedric Ceballos,SF,23,PHO,74,1607,381,662,0,2,381,660,187,258,949
1993,Tom Chambers,PF,33,PHO,73,1723,320,716,11,28,309,688,241,288,892
1993,Rex Chapman,SG,25,WSB,60,1300,287,602,43,116,244,486,132,163,749
1993,Maurice Cheeks,PG,36,NJN,35,510,51,93,0,2,51,91,24,27,126
1993,Pete Chilcutt,PF,24,SAC,59,834,165,340,0,0,165,340,32,46,362
1993,Doug Christie,SG,22,LAL,23,332,45,106,2,12,43,94,50,66,142
1993,Derrick Coleman,PF,25,NJN,76,2759,564,1226,23,99,541,1127,421,521,1572
1993,Bimbo Coles,PG,24,MIA,81,2232,318,686,42,137,276,549,177,220,855
1993,Marty Conlon,C,25,SAC,46,467,81,171,0,4,81,167,57,81,219
1993,Lester Conner,PG,33,LAC,31,422,28,62,0,0,28,62,18,19,74
1993,Duane Cooper,PG,23,LAL,65,645,62,158,7,30,55,128,25,35,156
1993,Tyrone Corbin,SF,30,UTA,82,2555,385,766,0,5,385,761,180,218,950
1993,Chris Corchiani,PG,24,TOT,10,105,14,24,0,3,14,21,16,21,44
1993,Chris Corchiani,PG,24,ORL,9,102,13,23,0,3,13,20,16,21,42
1993,Chris Corchiani,PG,24,WSB,1,3,1,1,0,0,1,1,0,0,2
1993,Joe Courtney,PF,23,TOT,12,104,13,32,0,0,13,32,7,9,33
1993,Joe Courtney,PF,23,CHI,5,34,4,9,0,0,4,9,3,4,11
1993,Joe Courtney,PF,23,GSW,7,70,9,23,0,0,9,23,4,5,22
1993,John Crotty,PG,23,UTA,40,243,37,72,2,14,35,58,26,38,102
1993,Terry Cummings,PF,31,SAS,8,76,11,29,0,0,11,29,5,10,27
1993,Radisav Curcic,C,27,DAL,20,166,16,41,0,0,16,41,26,36,58
1993,Dell Curry,SG,28,CHH,80,2094,498,1102,95,237,403,865,136,157,1227
1993,Lloyd Daniels,SG,25,SAS,77,1573,285,644,59,177,226,467,72,99,701
1993,Brad Daugherty,C,27,CLE,71,2691,520,911,1,2,519,909,391,492,1432
1993,Dale Davis,PF,23,IND,82,2264,304,535,0,0,304,535,119,225,727
1993,Hubert Davis,SG,22,NYK,50,815,110,251,6,19,104,232,43,54,269
1993,Terry Davis,PF,25,DAL,75,2462,393,863,2,8,391,855,167,281,955
1993,Johnny Dawkins,PG,29,PHI,74,1598,258,590,26,84,232,506,113,142,655
1993,Todd Day,SG,23,MIL,71,1931,358,828,54,184,304,644,213,297,983
1993,Vinny Del,PG,26,SAS,73,1526,218,430,6,24,212,406,101,117,543
1993,Bison Dele,PF,23,ORL,21,240,40,78,0,1,40,77,16,20,96
1993,Vlade Divac,C,24,LAL,82,2525,397,819,21,75,376,744,235,341,1050
1993,James Donaldson,C,35,UTA,6,94,8,14,0,0,8,14,5,9,21
1993,Sherman Douglas,PG,26,BOS,79,1932,264,530,6,29,258,501,84,150,618
1993,Greg Dreiling,C,30,IND,43,239,19,58,0,4,19,54,8,15,46
1993,Clyde Drexler*,SG,30,POR,49,1671,350,816,31,133,319,683,245,292,976
1993,Kevin Duckworth,C,28,POR,74,1762,301,688,0,2,301,686,127,174,729
1993,Chris Dudley,C,27,NJN,71,1398,94,266,0,0,94,266,57,110,245
1993,Joe Dumars*,SG,29,DET,77,3094,677,1454,112,299,565,1155,343,397,1809
1993,Richard Dumas,SF,23,PHO,48,1320,302,576,1,3,301,573,152,215,757
1993,Pat Durham,SF,25,GSW,5,78,6,25,0,0,6,25,9,12,21
1993,Mark Eaton,C,36,UTA,64,1104,71,130,0,0,71,130,35,50,177
1993,Blue Edwards,SF,27,MIL,82,2729,554,1083,37,106,517,977,237,300,1382
1993,James Edwards,C,37,LAL,52,617,122,270,0,0,122,270,84,118,328
1993,Kevin Edwards,SG,27,MIA,40,1134,216,462,5,17,211,445,119,141,556
1993,Craig Ehlo,SG,31,CLE,82,2559,385,785,93,244,292,541,86,120,949
1993,Mario Elie,SF,29,POR,82,1757,240,524,45,129,195,395,183,214,708
1993,Sean Elliott,SF,24,SAS,70,2604,451,918,37,104,414,814,268,337,1207
1993,Dale Ellis,SG,32,SAS,82,2731,545,1092,119,297,426,795,157,197,1366
1993,LaPhonso Ellis,PF,22,DEN,82,2749,483,958,2,13,481,945,237,317,1205
1993,Pervis Ellison,C,25,WSB,49,1701,341,655,0,4,341,651,170,242,852
1993,Jo Jo,SG,22,CHI,6,31,3,10,0,3,3,7,0,2,6
1993,Patrick Ewing*,C,30,NYK,81,3003,779,1550,1,7,778,1543,400,556,1959
1993,Duane Ferrell,SF,27,ATL,82,1736,327,696,9,36,318,660,176,226,839
1993,Danny Ferry,PF,26,CLE,76,1461,220,459,34,82,186,377,99,113,573
1993,Vern Fleming,PG,30,IND,75,1503,280,554,7,36,273,518,143,197,710
1993,Sleepy Floyd,PG,32,HOU,52,867,124,305,16,56,108,249,81,102,345
1993,Greg Foster,PF,24,TOT,43,298,55,120,0,4,55,116,15,21,125
1993,Greg Foster,PF,24,WSB,10,93,11,25,0,0,11,25,2,3,24
1993,Greg Foster,PF,24,ATL,33,205,44,95,0,4,44,91,13,18,101
1993,Rick Fox,SF,23,BOS,71,1082,184,380,4,23,180,357,81,101,453
1993,Kevin Gamble,SF,27,BOS,82,2541,459,906,52,139,407,767,123,149,1093
1993,Winston Garland,PG,28,HOU,66,1004,152,343,6,13,146,330,81,89,391
1993,Chris Gatling,PF,25,GSW,70,1248,249,462,0,6,249,456,150,207,648
1993,Kenny Gattison,PF,28,CHH,75,1475,203,384,0,3,203,381,102,169,508
1993,Matt Geiger,C,23,MIA,48,554,76,145,0,4,76,141,62,92,214
1993,Tate George,PG,24,NJN,48,380,51,135,0,5,51,130,20,24,122
1993,Kendall Gill,SG,24,CHH,69,2430,463,1032,17,62,446,970,224,290,1167
1993,Armen Gilliam,PF,28,PHI,80,1742,359,774,0,1,359,773,274,325,992
1993,Gerald Glass,SF,25,TOT,60,848,142,339,7,33,135,306,25,39,316
1993,Gerald Glass,SF,25,MIN,4,71,8,27,0,2,8,25,4,6,20
1993,Gerald Glass,SF,25,DET,56,777,134,312,7,31,127,281,21,33,296
1993,Mike Gminski,C,33,CHH,34,251,42,83,0,0,42,83,9,10,93
1993,Paul Graham,SG,25,ATL,80,1508,256,560,42,141,214,419,96,131,650
1993,Gary Grant,PG,27,LAC,74,1624,210,476,11,42,199,434,55,74,486
1993,Greg Grant,PG,26,PHI,72,996,77,220,20,68,57,152,20,31,194
1993,Harvey Grant,SF,27,WSB,72,2667,560,1149,1,10,559,1139,218,300,1339
1993,Horace Grant,PF,27,CHI,77,2745,421,829,1,5,420,824,174,281,1017
1993,Jeff Grayer,SG,27,GSW,48,1025,165,353,2,14,163,339,91,136,423
1993,A.C. Green,PF,29,LAL,82,2819,379,706,16,46,363,660,277,375,1051
1993,Litterial Green,PG,22,ORL,52,626,87,198,1,10,86,188,60,96,235
1993,Sean Green,SG,22,IND,13,81,28,55,3,10,25,45,3,4,62
1993,Sidney Green,PF,32,TOT,39,329,34,89,0,2,34,87,25,31,93
1993,Sidney Green,PF,32,SAS,15,202,20,49,0,0,20,49,13,15,53
1993,Sidney Green,PF,32,CHH,24,127,14,40,0,2,14,38,12,16,40
1993,Tom Gugliotta,PF,23,WSB,81,2795,484,1135,38,135,446,1000,181,281,1187
1993,Jay Guidinger,C,23,CLE,32,215,19,55,0,0,19,55,13,25,51
1993,Tom Hammonds,PF,25,TOT,54,713,105,221,0,1,105,220,38,62,248
1993,Tom Hammonds,PF,25,CHH,19,142,19,45,0,0,19,45,5,8,43
1993,Tom Hammonds,PF,25,DEN,35,571,86,176,0,1,86,175,33,54,205
1993,Tim Hardaway,PG,26,GSW,66,2609,522,1168,102,309,420,859,273,367,1419
1993,Derek Harper,SG,31,DAL,62,2108,393,939,101,257,292,682,239,316,1126
1993,Ron Harper,SG,29,LAC,80,2970,542,1203,52,186,490,1017,307,399,1443
1993,Scott Hastings,C,32,DEN,76,670,57,112,2,8,55,104,40,55,156
1993,Hersey Hawkins,SG,26,PHI,81,2977,551,1172,122,307,429,865,419,487,1643
1993,Steve Henson,PG,24,ATL,53,719,71,182,37,80,34,102,34,40,213
1993,Carl Herrera,PF,26,HOU,81,1800,240,444,0,2,240,442,125,176,605
1993,Rod Higgins,SF,33,SAC,69,1425,199,483,43,133,156,350,130,151,571
1993,Sean Higgins,SF,24,GSW,29,591,96,215,13,37,83,178,35,47,240
1993,Tyrone Hill,C,24,GSW,74,2070,251,494,0,4,251,490,138,221,640
1993,Donald Hodge,C,23,DAL,79,1267,161,400,0,0,161,400,71,104,393
1993,Dave Hoppen,C,28,NJN,2,10,1,1,0,0,1,1,0,2,2
1993,Jeff Hornacek,PG,29,PHI,79,2860,582,1239,97,249,485,990,250,289,1511
1993,Robert Horry,SF,22,HOU,79,2330,323,682,12,47,311,635,143,200,801
1993,Byron Houston,PF,23,GSW,79,1274,145,325,2,7,143,318,129,194,421
1993,Brian Howard,SF,25,DAL,68,1295,183,414,1,7,182,407,72,94,439
1993,Stephen Howard,SF,22,UTA,49,260,35,93,0,0,35,93,34,53,104
1993,Jay Humphries,SG,30,UTA,78,2034,287,659,15,75,272,584,101,130,690
1993,Byron Irvin,SG,26,WSB,4,45,9,18,1,1,8,17,3,6,22
1993,Mike Iuzzolino,PG,25,DAL,70,1769,221,478,54,144,167,334,114,149,610
1993,Jaren Jackson,SG,25,LAC,34,350,53,128,2,5,51,123,23,27,131
1993,Jim Jackson,SF,22,DAL,28,938,184,466,21,73,163,393,68,92,457
1993,Mark Jackson,PG,27,LAC,82,3117,459,945,22,82,437,863,241,300,1181
1993,Henry James,PF,27,TOT,10,88,21,51,3,13,18,38,22,26,67
1993,Henry James,PF,27,SAC,8,79,20,45,3,10,17,35,17,20,60
1993,Henry James,PF,27,UTA,2,9,1,6,0,3,1,3,5,6,7
1993,Keith Jennings,PG,24,GSW,8,136,25,42,5,9,20,33,14,18,69
1993,Avery Johnson,PG,27,SAS,75,2030,256,510,0,8,256,502,144,182,656
1993,Buck Johnson,SF,29,WSB,73,1287,193,403,0,3,193,400,92,126,478
1993,Dave Johnson,SG,22,POR,42,356,57,149,3,14,54,135,40,59,157
1993,Eddie Johnson,SF,33,SEA,82,1869,463,991,17,56,446,935,234,257,1177
1993,Frank Johnson,PG,34,PHO,77,1122,136,312,1,12,135,300,59,76,332
1993,Kevin Johnson,PG,26,PHO,49,1643,282,565,1,8,281,557,226,276,791
1993,Larry Johnson,PF,23,CHH,82,3323,728,1385,18,71,710,1314,336,438,1810
1993,Charles Jones,C,35,WSB,67,1206,33,63,0,1,33,62,22,38,88
1993,Michael Jordan*,SG,29,CHI,78,3067,992,2003,81,230,911,1773,476,569,2541
1993,Thomas Jordan,PF,24,PHI,4,106,18,41,0,0,18,41,8,17,44
1993,Adam Keefe,PF,22,ATL,82,1549,188,376,0,1,188,375,166,237,542
1993,Shawn Kemp,PF,23,SEA,78,2582,515,1047,0,4,515,1043,358,503,1388
1993,Tim Kempton,PF,29,PHO,30,167,19,48,0,0,19,48,18,31,56
1993,Steve Kerr,SG-PG,27,TOT,52,481,53,122,6,26,47,96,22,24,134
1993,Steve Kerr,PG,27,CLE,5,41,5,10,0,2,5,8,2,2,12
1993,Steve Kerr,SG,27,ORL,47,440,48,112,6,24,42,88,20,22,122
1993,Jerome Kersey,SF,30,POR,65,1719,281,642,8,28,273,614,116,183,686
1993,Alec Kessler,PF,26,MIA,40,415,57,122,5,11,52,111,36,47,155
1993,Bo Kimble,SG,26,NYK,9,55,14,33,2,8,12,25,3,8,33
1993,Stan Kimbrough,PG,26,SAC,3,15,2,6,1,2,1,4,0,0,5
1993,Bernard King*,SF,36,NJN,32,430,91,177,2,7,89,170,39,57,223
1993,Rich King,C,23,SEA,3,12,2,5,0,0,2,5,2,2,6
1993,Stacey King,C,26,CHI,76,1059,160,340,2,6,158,334,86,122,408
1993,Greg Kite,C,31,ORL,64,640,38,84,0,1,38,83,13,24,89
1993,Joe Kleine,C,31,BOS,78,1129,108,267,0,6,108,261,41,58,257
1993,Negele Knight,PG,25,PHO,52,888,124,317,0,7,124,310,67,86,315
1993,Bart Kofoed,SG,28,BOS,7,41,3,13,0,1,3,12,11,14,17
1993,Jon Koncak,C,29,ATL,78,1975,124,267,3,8,121,259,24,50,275
1993,Larry Krystkowiak,PF,28,UTA,71,1362,198,425,0,1,198,424,117,147,513
1993,Christian Laettner,PF,23,MIN,81,2823,503,1061,4,40,499,1021,462,553,1472
1993,Bill Laimbeer,C,35,DET,79,1933,292,574,10,27,282,547,93,104,687
1993,Jerome Lane,PF,26,CLE,21,149,27,54,0,0,27,54,5,20,59
1993,Andrew Lang,C,26,PHI,73,1861,149,351,1,5,148,346,87,114,386
1993,Doug Lee,SG,28,NJN,5,33,2,7,1,3,1,4,0,0,5
1993,Tim Legler,SG,26,TOT,33,635,105,241,22,65,83,176,57,71,289
1993,Tim Legler,SG,26,UTA,3,5,1,3,0,0,1,3,0,0,2
1993,Tim Legler,SG,26,DAL,30,630,104,238,22,65,82,173,57,71,287
1993,Jim Les,PG,29,SAC,73,881,110,259,66,154,44,105,42,50,328
1993,Reggie Lewis,SG,27,BOS,80,3144,663,1410,14,60,649,1350,326,376,1666
1993,Marcus Liberty,SF,24,DEN,78,1585,252,620,22,59,230,561,102,156,628
1993,Todd Lichti,SG,26,DEN,48,752,124,276,2,6,122,270,81,102,331
1993,Alton Lister,C,34,GSW,20,174,19,42,0,0,19,42,7,13,45
1993,Brad Lohaus,PF,28,MIL,80,1766,283,614,85,230,198,384,73,101,724
1993,Grant Long,PF,26,MIA,76,2728,397,847,6,26,391,821,261,341,1061
1993,Luc Longley,C,24,MIN,55,1045,133,292,0,0,133,292,53,74,319
1993,Kevin Lynch,SG,24,CHH,40,324,30,59,0,1,30,58,26,38,86
1993,Sam Mack,SF,22,SAS,40,267,47,118,3,22,44,96,45,58,142
1993,Don MacLean,PF,23,WSB,62,674,157,361,3,6,154,355,90,111,407
1993,Mark Macon,PG,23,DEN,48,1141,158,381,0,6,158,375,42,60,358
1993,Rick Mahorn,PF,34,NJN,74,1077,101,214,1,3,100,211,88,110,291
1993,Dan Majerle,SG,27,PHO,82,3199,509,1096,167,438,342,658,203,261,1388
1993,Jeff Malone,SG,31,UTA,79,2558,595,1205,3,9,592,1196,236,277,1429
1993,Karl Malone*,PF,29,UTA,82,3099,797,1443,4,20,793,1423,619,836,2217
1993,Moses Malone*,C,37,MIL,11,104,13,42,0,0,13,42,24,31,50
1993,Danny Manning,PF,26,LAC,79,2761,702,1379,8,30,694,1349,388,484,1800
1993,Sarunas Marciulionis*,SF,28,GSW,30,836,178,328,3,15,175,313,162,213,521
1993,Anthony Mason,PF,26,NYK,81,2482,316,629,0,0,316,629,199,292,831
1993,Marlon Maxey,PF,23,MIN,43,520,93,169,0,1,93,168,45,70,231
1993,Vernon Maxwell,SG,27,HOU,71,2251,349,858,120,361,229,497,164,228,982
1993,Lee Mayberry,PG,22,MIL,82,1503,171,375,43,110,128,265,39,68,424
1993,Travis Mays,PG,24,ATL,49,787,129,309,29,84,100,225,54,82,341
1993,Bob McCann,SF,28,MIN,79,1536,200,410,0,2,200,408,95,152,495
1993,George McCloud,SF,25,IND,78,1500,216,525,58,181,158,344,75,102,565
1993,Rodney McCray,SF,31,CHI,64,1019,92,204,2,5,90,199,36,52,222
1993,Xavier McDaniel,PF,29,BOS,82,2215,457,924,6,22,451,902,191,241,1111
1993,Kevin McHale*,PF,35,BOS,71,1656,298,649,2,18,296,631,164,195,762
1993,Derrick McKey,SF,26,SEA,77,2439,387,780,40,112,347,668,220,297,1034
1993,Nate McMillan,PG,28,SEA,73,1977,213,459,25,65,188,394,95,134,546
1993,Oliver Miller,C,22,PHO,56,1069,121,255,0,3,121,252,71,100,313
1993,Reggie Miller*,SG,27,IND,82,2954,571,1193,167,419,404,774,427,485,1736
1993,Terry Mills,PF,25,DET,81,2183,494,1072,10,36,484,1036,201,254,1199
1993,Harold Miner,SG,21,MIA,73,1383,292,615,3,9,289,606,163,214,750
1993,Sam Mitchell,SF,29,IND,81,1402,215,483,4,23,211,460,150,185,584
1993,Tracy Moore,SG,27,DAL,39,510,103,249,23,67,80,182,53,61,282
1993,Chris Morris,SF,27,NJN,77,2302,436,907,17,76,419,831,197,248,1086
1993,Isaiah Morris,SF,23,DET,25,102,26,57,0,0,26,57,3,4,55
1993,Alonzo Mourning*,C,22,CHH,78,2644,572,1119,0,3,572,1116,495,634,1639
1993,Chris Mullin*,SF,29,GSW,46,1902,474,930,60,133,414,797,183,226,1191
1993,Eric Murdock,PG,24,MIL,79,2437,438,936,31,119,407,817,231,296,1138
1993,Tracy Murray,SF,21,POR,48,495,108,260,21,70,87,190,35,40,272
1993,Jerrod Mustaf,PF,23,PHO,32,336,57,130,0,1,57,129,33,53,147
1993,Dikembe Mutombo*,C,26,DEN,82,3029,398,781,0,0,398,781,335,492,1131
1993,Larry Nance,PF,33,CLE,77,2753,533,971,0,4,533,967,202,247,1268
1993,Ed Nealy,PF,32,TOT,41,308,26,69,8,27,18,42,9,12,69
1993,Ed Nealy,PF,32,GSW,30,229,16,46,7,22,9,24,7,10,46
1993,Ed Nealy,PF,32,CHI,11,79,10,23,1,5,9,18,2,2,23
1993,Melvin Newbern,SG,25,DET,33,311,42,113,1,8,41,105,34,60,119
1993,Johnny Newman,SF,29,CHH,64,1471,279,534,12,45,267,489,194,240,764
1993,Ken Norman,SF,28,LAC,76,2477,498,975,10,38,488,937,131,220,1137
1993,Shaquille O'Neal*,C,20,ORL,81,3071,733,1304,0,2,733,1302,427,721,1893
1993,Dan O'Sullivan,C,24,TOT,6,17,3,5,0,0,3,5,3,4,9
1993,Dan O'Sullivan,C,24,NJN,3,10,2,3,0,0,2,3,0,0,4
1993,Dan O'Sullivan,C,24,MIL,3,7,1,2,0,0,1,2,3,4,5
1993,Charles Oakley,PF,29,NYK,82,2230,219,431,0,1,219,430,127,176,565
1993,Alan Ogg,C,25,TOT,6,29,5,13,0,0,5,13,3,4,13
1993,Alan Ogg,C,25,MIL,3,26,3,9,0,0,3,9,2,2,8
1993,Alan Ogg,C,25,WSB,3,3,2,4,0,0,2,4,1,2,5
1993,Hakeem Olajuwon*,C,30,HOU,82,3242,848,1603,0,8,848,1595,444,570,2140
1993,Matt Othick,PG,23,SAS,4,39,3,5,2,4,1,1,0,2,8
1993,Doug Overton,PG,23,WSB,45,990,152,323,3,13,149,310,59,81,366
1993,Billy Owens,PF,23,GSW,37,1201,247,493,1,11,246,482,117,183,612
1993,Robert Pack,PG,23,DEN,77,1579,285,606,1,8,284,598,239,311,810
1993,Gerald Paddio,SF,27,SEA,41,307,71,159,2,8,69,151,14,21,158
1993,Walter Palmer,C,24,DAL,20,124,27,57,0,0,27,57,6,9,60
1993,Robert Parish*,C,39,BOS,79,2146,416,777,0,0,416,777,162,235,994
1993,John Paxson,PG,32,CHI,59,1030,105,233,19,41,86,192,17,20,246
1993,Kenny Payne,SF,26,PHI,13,154,38,90,4,18,34,72,4,4,84
1993,Gary Payton*,PG,24,SEA,82,2548,476,963,7,34,469,929,151,196,1110
1993,Anthony Peeler,SG,23,LAL,77,1656,297,634,46,118,251,516,162,206,802
1993,Will Perdue,C,27,CHI,72,998,137,246,0,1,137,245,67,111,341
1993,Sam Perkins,PF,31,TOT,79,2351,381,799,24,71,357,728,250,305,1036
1993,Sam Perkins,PF,31,LAL,49,1589,242,527,5,29,237,498,184,222,673
1993,Sam Perkins,PF,31,SEA,30,762,139,272,19,42,120,230,66,83,363
1993,Tim Perry,PF,27,PHI,81,2104,287,613,10,49,277,564,147,207,731
1993,Chuck Person,SF,28,MIN,78,2985,541,1248,118,332,423,916,109,168,1309
1993,Drazen Petrovic*,SG,28,NJN,70,2660,587,1134,75,167,512,967,315,362,1564
1993,Bobby Phills,SG,23,CLE,31,139,38,82,2,5,36,77,15,25,93
1993,Ricky Pierce,SG,33,SEA,77,2218,524,1071,42,113,482,958,313,352,1403
1993,Ed Pinckney,PF,29,BOS,7,151,10,24,0,0,10,24,12,13,32
1993,Scottie Pippen*,SF,27,CHI,81,3123,628,1327,22,93,606,1234,232,350,1510
1993,Gary Plummer,PF,30,DEN,60,737,106,228,0,3,106,225,69,95,281
1993,Olden Polynice,C,28,DET,67,1299,210,429,0,1,210,428,66,142,486
1993,Terry Porter,PG,29,POR,81,2883,503,1108,143,345,360,763,327,388,1476
1993,Paul Pressey,SG,34,GSW,18,268,29,66,0,4,29,62,21,27,79
1993,Brent Price,PG,24,WSB,68,859,100,279,8,48,92,231,54,68,262
1993,Mark Price,PG,28,CLE,75,2380,477,986,122,293,355,693,289,305,1365
1993,Anthony Pullard,PF,26,MIL,8,37,8,18,0,0,8,18,1,3,17
1993,Kurt Rambis,PF,34,TOT,72,822,67,129,0,2,67,127,43,65,177
1993,Kurt Rambis,PF,34,PHO,5,41,4,7,0,0,4,7,1,2,9
1993,Kurt Rambis,PF,34,SAC,67,781,63,122,0,2,63,120,42,63,168
1993,Mark Randall,PF,25,TOT,37,248,40,80,1,8,39,72,16,26,97
1993,Mark Randall,PF,25,MIN,2,8,0,1,0,1,0,0,0,0,0
1993,Mark Randall,PF,25,DET,35,240,40,79,1,7,39,72,16,26,97
1993,Blair Rasmussen,C,30,ATL,22,283,30,80,2,6,28,74,9,13,71
1993,J.R. Reid,PF,24,TOT,83,1887,283,595,0,5,283,590,214,280,780
1993,J.R. Reid,PF,24,CHH,17,295,42,98,0,1,42,97,43,58,127
1993,J.R. Reid,PF,24,SAS,66,1592,241,497,0,4,241,493,171,222,653
1993,Glen Rice,SF,25,MIA,82,3082,582,1324,148,386,434,938,242,295,1554
1993,Pooh Richardson,PG,26,IND,74,2396,337,703,3,29,334,674,92,124,769
1993,Mitch Richmond*,SG,27,SAC,45,1728,371,782,48,130,323,652,197,233,987
1993,Doc Rivers,PG,31,NYK,77,1886,216,494,39,123,177,371,133,162,604
1993,Fred Roberts,C,32,MIL,79,1488,226,428,12,29,214,399,135,169,599
1993,Stanley Roberts,C,22,LAC,77,1816,375,711,0,0,375,711,120,246,870
1993,Alvin Robertson,SG,30,TOT,69,2006,247,539,40,122,207,417,84,128,618
1993,Alvin Robertson,SG,30,MIL,39,1065,139,290,17,55,122,235,44,70,339
1993,Alvin Robertson,SG,30,DET,30,941,108,249,23,67,85,182,40,58,279
1993,Clifford Robinson,PF,26,POR,82,2575,632,1336,19,77,613,1259,287,416,1570
1993,David Robinson*,C,27,SAS,82,3211,676,1348,3,17,673,1331,561,766,1916
1993,Larry Robinson,SG,25,WSB,4,33,6,16,0,1,6,15,3,5,15
1993,Rumeal Robinson,PG,26,NJN,80,1585,270,638,20,56,250,582,112,195,672
1993,Dennis Rodman*,PF,31,DET,62,2410,183,429,15,73,168,356,87,163,468
1993,Tree Rollins,C,37,HOU,42,247,11,41,0,2,11,39,9,12,31
1993,Sean Rooks,C,23,DAL,72,2087,368,747,0,2,368,745,234,389,970
1993,Donald Royal,SF,26,ORL,77,1636,194,391,0,3,194,388,318,390,706
1993,Delaney Rudd,PG,30,POR,15,95,7,36,1,11,6,25,11,14,26
1993,Jeff Ruland,C,34,DET,11,55,5,11,0,0,5,11,2,4,12
1993,John Salley,PF,28,MIA,51,1422,154,307,0,0,154,307,115,144,423
1993,Jeff Sanders,PF,27,ATL,9,120,10,25,0,0,10,25,4,8,24
1993,Mike Sanders,SF,32,CLE,53,1189,197,396,1,4,196,392,59,78,454
1993,Danny Schayes,C,33,MIL,70,1124,105,263,0,3,105,260,112,137,322
1993,Steve Scheffler,C,25,SEA,29,166,25,48,0,0,25,48,16,24,66
1993,Dwayne Schintzius,C,24,NJN,5,35,2,7,0,0,2,7,3,3,7
1993,Detlef Schrempf,PF,30,IND,82,3098,517,1085,8,52,509,1033,525,653,1567
1993,Byron Scott,SG,31,LAL,58,1677,296,659,44,135,252,524,156,184,792
1993,Dennis Scott,SF,24,ORL,54,1759,329,763,108,268,221,495,92,117,858
1993,Malik Sealy,SF,22,IND,58,672,136,319,7,31,129,288,51,74,330
1993,Rony Seikaly,C,27,MIA,72,2456,417,868,1,8,416,860,397,540,1232
1993,Brad Sellers,PF,30,MIN,54,533,49,130,0,1,49,129,37,39,135
1993,Charles Shackleford,C,26,PHI,48,568,80,164,0,2,80,162,31,49,191
1993,Brian Shaw,PG,26,MIA,68,1603,197,501,43,130,154,371,61,78,498
1993,Lionel Simmons,SF,24,SAC,69,2502,468,1055,1,11,467,1044,298,364,1235
1993,Scott Skiles,PG,28,ORL,78,3086,416,891,80,235,336,656,289,324,1201
1993,Charles Smith,SF,27,NYK,81,2172,358,764,0,2,358,762,287,367,1003
1993,Chris Smith,SG,22,MIN,80,1266,125,289,2,14,123,275,95,120,347
1993,Doug Smith,PF,23,DAL,61,1524,289,666,0,4,289,662,56,74,634
1993,Kenny Smith,PG,27,HOU,82,2422,387,744,96,219,291,525,195,222,1065
1993,LaBradford Smith,SG,23,WSB,69,1546,261,570,8,23,253,547,109,127,639
1993,Larry Smith,PF,35,SAS,66,833,38,87,0,0,38,87,9,22,85
1993,Reggie Smith,C,22,POR,23,68,10,27,0,1,10,26,3,14,23
1993,Steve Smith,SG,23,MIA,48,1610,279,619,53,132,226,487,155,197,766
1993,Tony Smith,SG,24,LAL,55,752,133,275,2,11,131,264,62,82,330
1993,Rik Smits,C,26,IND,81,2072,494,1017,0,0,494,1017,167,228,1155
1993,Andre Spencer,SF,28,TOT,20,422,73,163,0,2,73,161,41,54,187
1993,Andre Spencer,SF,28,ATL,3,15,0,3,0,0,0,3,0,0,0
1993,Andre Spencer,SF,28,GSW,17,407,73,160,0,2,73,158,41,54,187
1993,Elmore Spencer,C,23,LAC,44,280,44,82,0,0,44,82,16,32,104
1993,Felton Spencer,C,25,MIN,71,1296,105,226,0,0,105,226,83,127,293
1993,Latrell Sprewell,SG,22,GSW,77,2741,449,968,73,198,376,770,211,283,1182
1993,John Starks,SG,27,NYK,80,2477,513,1199,108,336,405,863,263,331,1397
1993,Barry Stevens,SF,30,GSW,2,6,1,2,0,0,1,2,0,0,2
1993,Larry Stewart,SF,24,WSB,81,1823,306,564,0,2,306,562,184,253,796
1993,Bryant Stith,SG,22,DEN,39,865,124,278,0,4,124,274,99,119,347
1993,Alex Stivrins,PF-SF,30,TOT,19,76,19,39,0,2,19,37,3,4,41
1993,Alex Stivrins,PF,30,PHO,10,35,11,18,0,1,11,17,0,0,22
1993,Alex Stivrins,SF,30,LAC,1,1,0,1,0,0,0,1,0,0,0
1993,Alex Stivrins,SF,30,MIL,3,25,4,11,0,0,4,11,3,4,11
1993,Alex Stivrins,PF,30,ATL,5,15,4,9,0,1,4,8,0,0,8
1993,John Stockton*,PG,30,UTA,82,2863,437,899,72,187,365,712,293,367,1239
1993,Rod Strickland,SG,26,POR,78,2474,396,816,4,30,392,786,273,381,1069
1993,Derek Strong,PF,24,MIL,23,339,42,92,4,8,38,84,68,85,156
1993,Lamont Strothers,SG,24,DAL,9,138,20,61,2,13,18,48,8,10,50
1993,Terry Teagle,SG,32,HOU,2,25,2,7,0,0,2,7,1,2,5
1993,Isiah Thomas*,PG,31,DET,79,2922,526,1258,61,198,465,1060,278,377,1391
1993,LaSalle Thompson,C,31,IND,63,730,104,213,0,1,104,212,29,39,237
1993,Otis Thorpe,PF,30,HOU,72,2357,385,690,0,2,385,688,153,256,923
1993,Sedale Threatt,PG,31,LAL,82,2893,522,1028,14,53,508,975,177,215,1235
1993,Wayman Tisdale,PF,28,SAC,76,2283,544,1068,0,2,544,1066,175,231,1263
1993,Tom Tolbert,PF,27,ORL,72,1838,226,454,9,28,217,426,122,168,583
1993,Trent Tucker,SG,33,CHI,69,909,143,295,52,131,91,164,18,22,356
1993,Jeff Turner,PF,30,ORL,75,1479,231,437,10,17,221,420,56,70,528
1993,Kiki Vandeweghe,SF,34,LAC,41,494,92,203,12,37,80,166,58,66,254
1993,Loy Vaught,PF,24,LAC,79,1653,313,616,1,4,312,612,116,155,743
1993,Gundars Vetra,SF,25,MIN,13,89,19,40,3,3,16,37,4,6,45
1993,Darrell Walker,PG-SG,31,TOT,37,511,34,96,0,1,34,95,12,26,80
1993,Darrell Walker,SG,31,DET,9,144,3,19,0,1,3,18,2,6,8
1993,Darrell Walker,PG,31,CHI,28,367,31,77,0,0,31,77,10,20,72
1993,Duane Washington,SG,28,LAC,4,28,0,5,0,0,0,5,0,0,0
1993,Clarence Weatherspoon,SF,22,PHI,82,2654,494,1053,1,4,493,1049,291,408,1280
1993,Marcus Webb,PF,22,BOS,9,51,13,25,0,1,13,24,13,21,39
1993,Spud Webb,PG,29,SAC,69,2335,342,789,37,135,305,654,279,328,1000
1993,Robert Werdann,C,22,DEN,28,149,18,59,0,1,18,58,17,31,53
1993,Doug West,SG,25,MIN,80,3104,646,1249,2,23,644,1226,249,296,1543
1993,Mark West,C,32,PHO,82,1558,175,285,0,0,175,285,86,166,436
1993,Randy White,PF,25,DAL,64,1433,235,540,10,42,225,498,138,184,618
1993,Morlon Wiley,PG,26,TOT,58,995,96,254,54,154,42,100,17,26,263
1993,Morlon Wiley,PG,26,ATL,25,354,26,81,15,51,11,30,5,8,72
1993,Morlon Wiley,PG,26,DAL,33,641,70,173,39,103,31,70,12,18,191
1993,Dominique Wilkins*,SF,33,ATL,71,2647,741,1584,120,316,621,1268,519,627,2121
1993,Eddie Lee,PF,30,PHI,26,192,55,97,0,2,55,95,48,78,158
1993,Gerald Wilkins,SF,29,CLE,80,2079,361,797,16,58,345,739,152,181,890
1993,Buck Williams,PF,32,POR,82,2498,270,528,0,1,270,527,138,214,678
1993,Corey Williams,PG,22,CHI,35,242,31,85,1,3,30,82,18,22,81
1993,Herb Williams,C,34,NYK,55,571,72,175,0,0,72,175,14,21,158
1993,Hot Rod,C,30,CLE,67,2055,263,560,0,0,263,560,212,296,738
1993,Jayson Williams,PF,24,NJN,12,139,21,46,0,0,21,46,7,18,49
1993,John Williams,SF,26,LAC,74,1638,205,477,12,53,193,424,70,129,492
1993,Kenny Williams,SF,23,IND,57,844,150,282,0,3,150,279,48,68,348
1993,Lorenzo Williams,PF-C,23,TOT,27,179,17,36,0,0,17,36,2,7,36
1993,Lorenzo Williams,C,23,CHH,2,18,1,3,0,0,1,3,0,0,2
1993,Lorenzo Williams,PF,23,ORL,3,10,0,2,0,0,0,2,0,0,0
1993,Lorenzo Williams,PF,23,BOS,22,151,16,31,0,0,16,31,2,7,34
1993,Micheal Williams,PG,26,MIN,76,2661,353,791,26,107,327,684,419,462,1151
1993,Reggie Williams,SF,28,DEN,79,2722,535,1167,33,122,502,1045,238,296,1341
1993,Scott Williams,PF,24,CHI,71,1369,166,356,0,7,166,349,90,126,422
1993,Walt Williams,SF,22,SAC,59,1673,358,823,61,191,297,632,224,302,1001
1993,Kevin Willis,PF,30,ATL,80,2878,616,1218,7,29,609,1189,196,300,1435
1993,Kennard Winchester,SG,26,HOU,39,340,61,139,4,19,57,120,17,22,143
1993,David Wingate,SF,29,CHH,72,1471,180,336,1,6,179,330,79,107,440
1993,Joe Wolf,C,28,TOT,23,165,20,44,0,1,20,43,13,16,53
1993,Joe Wolf,C,28,BOS,2,9,0,1,0,0,0,1,1,2,1
1993,Joe Wolf,C,28,POR,21,156,20,43,0,1,20,42,12,14,52
1993,David Wood,PF,28,SAS,64,598,52,117,5,21,47,96,46,55,155
1993,Randy Woods,PG,22,LAC,41,174,23,66,3,14,20,52,19,26,68
1993,Orlando Woolridge,SF,33,TOT,58,1555,289,599,0,9,289,590,120,177,698
1993,Orlando Woolridge,SF,33,DET,50,1477,271,566,0,9,271,557,113,168,655
1993,Orlando Woolridge,SF,33,MIL,8,78,18,33,0,0,18,33,7,9,43
1993,James Worthy*,SF,31,LAL,82,2359,510,1142,30,111,480,1031,171,211,1221
1993,Howard Wright,PF,25,ORL,4,10,4,5,0,0,4,5,0,2,8
1993,Danny Young,PG,30,DET,65,836,69,167,22,68,47,99,28,32,188
,,,,,,,,,,,,,,,
1994,Alaa Abdelnaby,PF,25,BOS,13,159,24,55,0,0,24,55,16,25,64
1994,Mahmoud Abdul-Rauf,PG,24,DEN,80,2617,588,1279,42,133,546,1146,219,229,1437
1994,Michael Adams,PG,31,WSB,70,2337,285,698,55,191,230,507,224,270,849
1994,Mark Aguirre,SF,34,LAC,39,859,163,348,37,93,126,255,50,72,413
1994,Danny Ainge,SG,34,PHO,68,1555,224,537,80,244,144,293,78,94,606
1994,Gary Alexander,PF,24,TOT,11,55,8,14,0,0,8,14,3,9,19
1994,Gary Alexander,PF,24,MIA,4,12,1,2,0,0,1,2,0,2,2
1994,Gary Alexander,PF,24,CLE,7,43,7,12,0,0,7,12,3,7,17
1994,Victor Alexander,C,24,GSW,69,1318,266,502,2,13,264,489,68,129,602
1994,Eric Anderson,PF,23,NYK,11,39,7,17,2,2,5,15,5,14,21
1994,Greg Anderson,PF,29,DET,77,1624,201,370,1,3,200,367,88,154,491
1994,Kenny Anderson,PG,23,NJN,82,3135,576,1381,40,132,536,1249,346,423,1538
1994,Nick Anderson,SG,26,ORL,81,2811,504,1054,101,314,403,740,168,250,1277
1994,Ron Anderson,SF,35,TOT,21,356,35,86,7,26,28,60,19,23,96
1994,Ron Anderson,SF,35,NJN,11,176,15,43,4,12,11,31,10,12,44
1994,Ron Anderson,SF,35,WSB,10,180,20,43,3,14,17,29,9,11,52
1994,Willie Anderson,SG,27,SAS,80,2488,394,837,22,68,372,769,145,171,955
1994,Greg Anthony,PG,26,NYK,80,1994,225,571,48,160,177,411,130,168,628
1994,B.J. Armstrong,PG,26,CHI,82,2770,479,1007,60,135,419,872,194,227,1212
1994,Vincent Askew,SG,27,SEA,80,1690,273,567,6,31,267,536,175,211,727
1994,Keith Askins,SF,26,MIA,37,319,36,88,4,21,32,67,9,10,85
1994,Stacey Augmon,SG,25,ATL,82,2605,439,861,1,7,438,854,333,436,1212
1994,Isaac Austin,C,24,PHI,14,201,29,66,0,1,29,65,14,23,72
1994,Anthony Avent,PF,24,TOT,74,1371,150,398,0,0,150,398,89,123,389
1994,Anthony Avent,PF,24,MIL,33,695,92,228,0,0,92,228,61,79,245
1994,Anthony Avent,PF,24,ORL,41,676,58,170,0,0,58,170,28,44,144
1994,John Bagley,PG,33,ATL,3,13,0,2,0,0,0,2,2,2,2
1994,Thurl Bailey,PF,32,MIN,79,1297,232,455,0,2,232,453,119,149,583
1994,Vin Baker,C,22,MIL,82,2560,435,869,1,5,434,864,234,411,1105
1994,Charles Barkley*,PF,30,PHO,65,2298,518,1046,48,178,470,868,318,452,1402
1994,Dana Barros,PG,26,PHI,81,2519,412,878,135,354,277,524,116,145,1075
1994,Jon Barry,SG,24,MIL,72,1242,158,382,32,115,126,267,97,122,445
1994,John Battle,SG,31,CLE,51,814,130,273,5,19,125,254,73,97,338
1994,Benoit Benjamin,C,29,NJN,77,1817,283,589,0,0,283,589,152,214,718
1994,Tony Bennett,PG,24,CHH,74,983,105,263,27,75,78,188,11,15,248
1994,David Benoit,SF,25,UTA,55,1070,139,361,12,59,127,302,68,88,358
1994,Rolando Blackman,SG,34,NYK,55,969,161,369,30,84,131,285,48,53,400
1994,Mookie Blaylock,PG,26,ATL,81,2915,444,1079,114,341,330,738,116,159,1118
1994,Corie Blount,PF,25,CHI,67,690,76,174,0,0,76,174,46,75,198
1994,Muggsy Bogues,PG,29,CHH,77,2746,354,751,2,12,352,739,125,155,835
1994,Manute Bol,C,31,TOT,14,116,4,19,0,3,4,16,0,0,8
1994,Manute Bol,C,31,MIA,8,61,1,12,0,3,1,9,0,0,2
1994,Manute Bol,C,31,WSB,2,6,0,0,0,0,0,0,0,0,0
1994,Manute Bol,C,31,PHI,4,49,3,7,0,0,3,7,0,0,6
1994,Walter Bond,SG,24,UTA,56,559,63,156,19,54,44,102,31,40,176
1994,Anthony Bonner,SF,25,NYK,73,1402,162,288,0,0,162,288,50,105,374
1994,Anthony Bowie,SG,30,ORL,70,948,139,289,1,18,138,271,41,49,320
1994,Sam Bowie,C,32,LAL,25,556,75,172,1,4,74,168,72,83,223
1994,Shawn Bradley,C,21,PHI,49,1385,201,491,0,3,201,488,102,168,504
1994,Terrell Brandon,PG,23,CLE,73,1548,230,548,7,32,223,516,139,162,606
1994,Randy Breuer,C,33,SAC,26,247,8,26,0,1,8,25,3,14,19
1994,Frank Brickowski,C,34,TOT,71,2094,368,754,4,20,364,734,195,254,935
1994,Frank Brickowski,C,34,MIL,43,1441,251,521,3,18,248,503,148,191,653
1994,Frank Brickowski,C,34,CHH,28,653,117,233,1,2,116,231,47,63,282
1994,Kevin Brooks,SF,24,DEN,34,190,36,99,4,23,32,76,9,10,85
1994,Scott Brooks,PG,28,HOU,73,1225,142,289,23,61,119,228,74,85,381
1994,Chucky Brown,SF,25,DAL,1,10,1,1,0,0,1,1,1,1,3
1994,Dee Brown,SG,25,BOS,77,2867,490,1021,30,96,460,925,182,219,1192
1994,Mike Brown,C,30,MIN,82,1921,111,260,0,2,111,258,77,118,299
1994,P.J. Brown,C,24,NJN,79,1950,167,402,1,6,166,396,115,152,450
1994,Randy Brown,PG,25,SAC,61,1041,110,251,0,4,110,247,53,87,273
1994,Mark Bryant,C,28,POR,79,1441,185,384,0,1,185,383,72,104,442
1994,Jud Buechler,SF,25,GSW,36,218,42,84,12,29,30,55,10,20,106
1994,Matt Bullard,PF,26,HOU,65,725,78,226,50,154,28,72,20,26,226
1994,Evers Burns,PF,22,SAC,23,143,22,55,0,0,22,55,12,23,56
1994,Scott Burrell,SF,23,CHH,51,767,98,234,2,6,96,228,46,70,244
1994,Willie Burton,SF,25,MIA,53,697,124,283,3,15,121,268,120,158,371
1994,Mitchell Butler,SG,23,WSB,75,1321,207,418,0,5,207,413,104,180,518
1994,Michael Cage,C,32,SEA,82,1708,171,314,0,1,171,313,36,74,378
1994,Elden Campbell,PF,25,LAL,76,2253,373,808,0,2,373,806,188,273,934
1994,Tony Campbell,SF,31,TOT,63,1214,227,512,7,28,220,484,94,120,555
1994,Tony Campbell,SF,31,NYK,22,379,63,128,1,3,62,125,30,37,157
1994,Tony Campbell,SF,31,DAL,41,835,164,384,6,25,158,359,64,83,398
1994,Antoine Carr,PF,32,SAS,34,465,78,160,0,1,78,159,42,58,198
1994,Bill Cartwright,C,36,CHI,42,780,98,191,0,0,98,191,39,57,235
1994,Sam Cassell,PG,24,HOU,66,1122,162,388,26,88,136,300,90,107,440
1994,Duane Causwell,C,25,SAC,41,674,71,137,0,0,71,137,40,68,182
1994,Cedric Ceballos,SF,24,PHO,53,1602,425,795,0,9,425,786,160,221,1010
1994,Tom Chambers,PF,34,UTA,80,1838,329,748,14,45,315,703,221,281,893
1994,Rex Chapman,SG,26,WSB,60,2025,431,865,64,165,367,700,168,206,1094
1994,Calbert Cheaney,SG,22,WSB,65,1604,327,696,1,23,326,673,124,161,779
1994,Pete Chilcutt,PF,25,TOT,76,1365,203,448,3,15,200,433,41,65,450
1994,Pete Chilcutt,PF,25,SAC,46,974,152,328,0,1,152,327,31,52,335
1994,Pete Chilcutt,PF,25,DET,30,391,51,120,3,14,48,106,10,13,115
1994,Doug Christie,SG,23,LAL,65,1515,244,562,39,119,205,443,145,208,672
1994,Ben Coleman,PF,32,DET,9,77,12,25,0,0,12,25,4,8,28
1994,Derrick Coleman,PF,26,NJN,77,2778,541,1209,38,121,503,1088,439,567,1559
1994,Bimbo Coles,PG,25,MIA,76,1726,233,519,20,99,213,420,102,131,588
1994,Marty Conlon,C,26,TOT,30,579,95,165,0,2,95,163,43,53,233
1994,Marty Conlon,C,26,CHH,16,378,66,109,0,1,66,108,31,38,163
1994,Marty Conlon,C,26,WSB,14,201,29,56,0,1,29,55,12,15,70
1994,Lester Conner,PG,34,IND,11,169,14,38,0,3,14,35,3,6,31
1994,Anthony Cook,PF,26,TOT,25,203,26,54,0,1,26,53,10,25,62
1994,Anthony Cook,PF,26,ORL,2,2,0,1,0,0,0,1,0,0,0
1994,Anthony Cook,PF,26,MIL,23,201,26,53,0,1,26,52,10,25,62
1994,Duane Cooper,PG,24,PHO,23,136,18,41,1,7,17,34,11,15,48
1994,Tyrone Corbin,SF,31,UTA,82,2149,268,588,6,29,262,559,117,144,659
1994,Chris Corchiani,PG,25,BOS,51,467,40,94,11,38,29,56,26,38,117
1994,Joe Courtney,PF,24,TOT,52,345,67,148,2,3,65,145,32,47,168
1994,Joe Courtney,PF,24,PHO,33,168,40,78,0,0,40,78,23,32,103
1994,Joe Courtney,PF,24,MIL,19,177,27,70,2,3,25,67,9,15,65
1994,John Crotty,PG,24,UTA,45,313,45,99,11,24,34,75,31,36,132
1994,Terry Cummings,PF,32,SAS,59,1133,183,428,0,2,183,426,63,107,429
1994,Earl Cureton,PF,36,HOU,2,30,2,8,0,0,2,8,0,2,4
1994,Dell Curry,SG,29,CHH,82,2173,533,1171,152,378,381,793,117,134,1335
1994,Michael Curry,SG,25,PHI,10,43,3,14,0,2,3,12,3,4,9
1994,Lloyd Daniels,SG,26,SAS,65,980,140,372,44,125,96,247,46,64,370
1994,Brad Daugherty,C,28,CLE,50,1838,296,606,0,0,296,606,256,326,848
1994,Antonio Davis,PF,25,IND,81,1732,216,425,0,1,216,424,194,302,626
1994,Brian Davis,SF,23,MIN,68,374,40,126,1,3,39,123,50,68,131
1994,Dale Davis,PF,24,IND,66,2292,308,582,0,1,308,581,155,294,771
1994,Hubert Davis,SG,23,NYK,56,1333,238,505,53,132,185,373,85,103,614
1994,Terry Davis,PF,26,DAL,15,286,24,59,0,0,24,59,8,12,56
1994,Johnny Dawkins,PG,30,PHI,72,1343,177,423,37,105,140,318,84,100,475
1994,Todd Day,SG,24,MIL,76,2127,351,845,33,148,318,697,231,331,966
1994,Terry Dehere,PG,22,LAC,64,759,129,342,23,57,106,285,61,81,342
1994,Vinny Del,SG,27,SAS,77,1949,309,634,15,43,294,591,140,170,773
1994,Bison Dele,C,24,DEN,80,1507,251,464,0,3,251,461,137,211,639
1994,Dell Demps,PG,23,GSW,2,11,2,6,0,0,2,6,0,2,4
1994,Vlade Divac,C,25,LAL,79,2685,453,895,9,47,444,848,208,303,1123
1994,Sherman Douglas,PG,27,BOS,78,2789,425,919,13,56,412,863,177,276,1040
1994,Greg Dreiling,C,31,DAL,54,685,52,104,1,1,51,103,27,38,132
1994,Clyde Drexler*,SG,31,POR,68,2334,473,1105,71,219,402,886,286,368,1303
1994,Kevin Duckworth,C,29,WSB,69,1485,184,441,0,0,184,441,88,132,456
1994,Chris Dudley,C,28,POR,6,86,6,25,0,0,6,25,2,4,14
1994,Joe Dumars*,SG,30,DET,69,2591,505,1118,124,320,381,798,276,330,1410
1994,Acie Earl,C,23,BOS,74,1149,151,372,0,1,151,371,108,160,410
1994,Bill Edwards,PF,22,PHI,3,44,2,18,0,5,2,13,2,5,6
1994,Blue Edwards,SF,28,MIL,82,2322,382,800,38,106,344,694,151,189,953
1994,Doug Edwards,PF,23,ATL,16,107,17,49,0,1,17,48,9,16,43
1994,James Edwards,C,38,LAL,45,469,78,168,0,0,78,168,54,79,210
1994,Kevin Edwards,SG,28,NJN,82,2727,471,1028,35,99,436,929,167,217,1144
1994,Craig Ehlo,SG,32,ATL,82,2147,316,708,77,221,239,487,112,154,821
1994,Mario Elie,SF,30,HOU,67,1606,208,466,56,167,152,299,154,179,626
1994,Sean Elliott,SF,25,DET,73,2409,360,791,26,87,334,704,139,173,885
1994,Dale Ellis,SF,33,SAS,77,2590,478,967,131,332,347,635,83,107,1170
1994,Harold Ellis,SF,23,LAC,49,923,159,292,0,4,159,288,106,149,424
1994,LaPhonso Ellis,PF,23,DEN,79,2699,483,963,7,23,476,940,242,359,1215
1994,LeRon Ellis,C,24,CHH,50,680,88,182,0,0,88,182,45,68,221
1994,Pervis Ellison,C,26,WSB,47,1178,137,292,0,3,137,289,70,97,344
1994,Jo Jo,SG,23,CHI,36,419,56,129,8,17,48,112,10,21,130
1994,Patrick Ewing*,C,31,NYK,79,2972,745,1503,4,14,741,1489,445,582,1939
1994,Jim Farmer,SG,29,DEN,4,29,2,6,0,2,2,4,0,0,4
1994,Duane Ferrell,SF,28,ATL,72,1155,184,379,1,9,183,370,144,184,513
1994,Danny Ferry,PF,27,CLE,70,965,149,334,14,51,135,283,38,43,350
1994,Vern Fleming,PG,31,IND,55,1053,147,318,0,4,147,314,64,87,358
1994,Sleepy Floyd,PG,33,SAS,53,737,70,209,8,36,62,173,52,78,200
1994,Alphonso Ford,PG,22,SEA,6,16,7,13,1,1,6,12,1,2,16
1994,Greg Foster,PF,25,MIL,3,19,4,7,0,0,4,7,2,2,10
1994,Rick Fox,SF,24,BOS,82,2096,340,728,33,100,307,628,174,230,887
1994,Tellis Frank,PF,28,MIN,67,959,67,160,0,2,67,158,54,76,188
1994,Corey Gaines,SG,28,NYK,18,78,9,20,2,5,7,15,13,15,33
1994,Chad Gallagher,C,24,UTA,2,3,3,3,0,0,3,3,0,0,6
1994,Kevin Gamble,SF,28,BOS,75,1880,368,804,25,103,343,701,103,126,864
1994,Chris Gatling,C,26,GSW,82,1296,271,461,0,1,271,460,129,208,671
1994,Kenny Gattison,PF,29,CHH,77,1644,233,445,0,0,233,445,126,195,592
1994,Andrew Gaze,SG,28,WSB,7,70,8,17,4,8,4,9,2,2,22
1994,Matt Geiger,C,24,MIA,72,1199,202,352,1,5,201,347,116,149,521
1994,Kendall Gill,SG,25,SEA,79,2435,429,969,38,120,391,849,215,275,1111
1994,Armen Gilliam,PF,29,NJN,82,1969,348,682,0,1,348,681,274,361,970
1994,Mike Gminski,C,34,TOT,29,309,36,103,0,0,36,103,14,18,86
1994,Mike Gminski,C,34,CHH,21,255,31,79,0,0,31,79,11,14,73
1994,Mike Gminski,C,34,MIL,8,54,5,24,0,0,5,24,3,4,13
1994,Ricky Grace,PG,26,ATL,3,8,2,3,0,0,2,3,0,2,4
1994,Greg Graham,SG,23,PHI,70,889,122,305,2,25,120,280,92,110,338
1994,Paul Graham,SG,26,ATL,21,128,21,57,3,13,18,44,13,17,58
1994,Gary Grant,PG,28,LAC,78,1533,253,563,17,62,236,501,65,76,588
1994,Harvey Grant,SF,28,POR,77,2112,356,774,2,7,354,767,84,131,798
1994,Horace Grant,PF,28,CHI,70,2570,460,878,0,6,460,872,137,230,1057
1994,Josh Grant,PF,26,GSW,53,382,59,146,17,61,42,85,22,29,157
1994,Jeff Grayer,SG,28,GSW,67,1096,191,363,2,12,189,351,71,118,455
1994,A.C. Green,PF,30,PHO,82,2825,465,926,8,35,457,891,266,362,1204
1994,Litterial Green,PG,23,ORL,29,126,22,57,1,4,21,53,28,37,73
1994,Sean Green,SG,23,TOT,36,334,63,183,10,41,53,142,13,18,149
1994,Sean Green,SG,23,PHI,35,332,63,182,10,41,53,141,13,18,149
1994,Sean Green,SG,23,UTA,1,2,0,1,0,0,0,1,0,0,0
1994,Tom Gugliotta,PF,24,WSB,78,2795,540,1159,40,148,500,1011,213,311,1333
1994,Andres Guibert,C,25,MIN,5,33,6,20,0,0,6,20,3,6,15
1994,Jay Guidinger,C,24,CLE,32,131,16,32,0,0,16,32,15,21,47
1994,Jack Haley,PF,30,SAS,28,94,21,48,0,0,21,48,17,21,59
1994,Geert Hammink,C,24,ORL,1,3,1,3,0,0,1,3,0,0,2
1994,Tom Hammonds,PF,26,DEN,74,877,115,230,0,0,115,230,71,104,301
1994,Anfernee Hardaway,PG,22,ORL,82,3015,509,1092,50,187,459,905,245,330,1313
1994,Derek Harper,PG,32,TOT,82,2204,303,744,73,203,230,541,112,163,791
1994,Derek Harper,PG,32,DAL,28,893,130,342,37,105,93,237,28,50,325
1994,Derek Harper,PG,32,NYK,54,1311,173,402,36,98,137,304,84,113,466
1994,Ron Harper,SG,30,LAC,75,2856,569,1335,71,236,498,1099,299,418,1508
1994,Lucious Harris,SG,23,DAL,77,1165,162,385,7,33,155,352,87,119,418
1994,Tony Harris,SG,26,BOS,5,88,9,31,3,9,6,22,23,25,44
1994,Antonio Harvey,PF,23,LAL,27,247,29,79,0,0,29,79,12,26,70
1994,Scott Haskin,C,23,IND,27,186,21,45,0,0,21,45,13,19,55
1994,Hersey Hawkins,SG,27,CHH,82,2648,395,859,78,235,317,624,312,362,1180
1994,Skeeter Henry,SG,26,PHO,4,15,1,5,0,2,1,3,2,4,4
1994,Steve Henson,PG,25,CHH,3,17,1,2,1,1,0,1,0,0,3
1994,Carl Herrera,PF,27,HOU,75,1292,142,310,0,0,142,310,69,97,353
1994,Rod Higgins,SF,34,CLE,36,547,71,163,22,50,49,113,31,42,195
1994,Tyrone Hill,PF,25,CLE,57,1447,216,398,0,2,216,396,171,256,603
1994,Donald Hodge,C,24,DAL,50,428,46,101,0,0,46,101,44,52,136
1994,Tito Horford,C,28,WSB,3,28,0,2,0,0,0,2,0,0,0
1994,Jeff Hornacek,SG,30,TOT,80,2820,472,1004,70,208,402,796,260,296,1274
1994,Jeff Hornacek,SG,30,PHI,53,1994,325,715,52,166,273,549,178,204,880
1994,Jeff Hornacek,SG,30,UTA,27,826,147,289,18,42,129,247,82,92,394
1994,Robert Horry,SF,23,HOU,81,2370,322,702,44,136,278,566,115,157,803
1994,Allan Houston,SG,22,DET,79,1519,272,671,35,117,237,554,89,108,668
1994,Byron Houston,PF,24,GSW,71,866,81,177,1,7,80,170,33,54,196
1994,Stephen Howard,SF,23,UTA,9,53,10,17,0,0,10,17,11,16,31
1994,Jay Humphries,SG,31,UTA,75,1619,233,535,38,96,195,439,57,76,561
1994,Lindsey Hunter,PG,23,DET,82,2172,335,893,69,207,266,686,104,142,843
1994,Bobby Hurley,PG,22,SAC,19,499,54,146,2,16,52,130,24,30,134
1994,Jaren Jackson,SG,26,POR,29,187,34,87,0,6,34,81,12,14,80
1994,Jim Jackson,SG,23,DAL,82,3066,637,1432,17,60,620,1372,285,347,1576
1994,Mark Jackson,PG,28,LAC,79,2711,331,732,36,127,295,605,167,211,865
1994,Stanley Jackson,SG,23,MIN,17,92,17,33,1,5,16,28,3,3,38
1994,Dave Jamerson,SG,26,TOT,5,14,0,7,0,0,0,7,2,3,2
1994,Dave Jamerson,SG,26,UTA,1,4,0,2,0,0,0,2,1,1,1
1994,Dave Jamerson,SG,26,NJN,4,10,0,5,0,0,0,5,1,2,1
1994,Henry James,PF,28,LAC,12,75,16,42,4,18,12,24,5,5,41
1994,Keith Jennings,PG,25,GSW,76,1097,138,342,56,151,82,191,100,120,432
1994,Chris Jent,SF,24,HOU,3,78,13,26,4,11,9,15,1,2,31
1994,Avery Johnson,PG,28,GSW,82,2332,356,724,0,12,356,712,178,253,890
1994,Dave Johnson,SG,23,CHI,17,119,17,54,0,1,17,53,13,21,47
1994,Eddie Johnson,SF,34,CHH,73,1460,339,738,59,150,280,588,99,127,836
1994,Ervin Johnson,C,26,SEA,45,280,44,106,0,0,44,106,29,46,117
1994,Frank Johnson,PG,35,PHO,70,875,134,299,2,12,132,287,54,69,324
1994,Kevin Johnson,PG,27,PHO,67,2449,477,980,6,27,471,953,380,464,1340
1994,Larry Johnson,PF,24,CHH,51,1757,346,672,5,21,341,651,137,197,834
1994,Charles Jones,C,36,DET,42,877,36,78,0,1,36,77,19,34,91
1994,Popeye Jones,PF,23,DAL,81,1773,195,407,0,1,195,406,78,107,468
1994,Adonis Jordan,PG,23,DEN,6,79,6,23,3,10,3,13,0,0,15
1994,Reggie Jordan,SG,26,LAL,23,259,44,103,2,4,42,99,35,51,125
1994,Adam Keefe,PF,23,ATL,63,763,96,213,0,0,96,213,81,111,273
1994,Shawn Kemp,PF,24,SEA,79,2597,533,990,1,4,532,986,364,491,1431
1994,Tim Kempton,PF,30,TOT,13,136,15,38,0,0,15,38,9,16,39
1994,Tim Kempton,PF,30,CHH,9,103,9,26,0,0,9,26,7,10,25
1994,Tim Kempton,PF,30,CLE,4,33,6,12,0,0,6,12,2,6,14
1994,Steve Kerr,PG,28,CHI,82,2036,287,577,52,124,235,453,83,97,709
1994,Jerome Kersey,SF,31,POR,78,1276,203,469,1,8,202,461,101,135,508
1994,Alec Kessler,PF,27,MIA,15,66,11,25,5,9,6,16,6,8,33
1994,Warren Kidd,PF,23,PHI,68,884,100,169,0,0,100,169,47,86,247
1994,Chris King,SF,24,SEA,15,86,19,48,2,7,17,41,15,26,55
1994,Rich King,C,24,SEA,27,78,15,34,0,1,15,33,11,22,41
1994,Stacey King,C,27,TOT,49,1053,146,341,0,2,146,339,93,136,385
1994,Stacey King,C,27,CHI,31,537,68,171,0,2,68,169,36,53,172
1994,Stacey King,C,27,MIN,18,516,78,170,0,0,78,170,57,83,213
1994,Greg Kite,C,32,ORL,29,309,13,35,0,0,13,35,8,22,34
1994,Joe Kleine,C,32,PHO,74,848,125,256,5,11,120,245,30,39,285
1994,Negele Knight,PG,26,TOT,65,1438,225,475,4,21,221,454,141,174,595
1994,Negele Knight,PG,26,PHO,1,8,1,4,0,0,1,4,0,0,2
1994,Negele Knight,PG,26,SAS,64,1430,224,471,4,21,220,450,141,174,593
1994,Jon Koncak,C,30,ATL,82,1823,159,369,0,3,159,366,24,36,342
1994,Larry Krystkowiak,PF,29,ORL,34,682,71,148,0,1,71,147,31,39,173
1994,Toni Kukoc,SF,25,CHI,75,1808,313,726,32,118,281,608,156,210,814
1994,Christian Laettner,PF,24,MIN,70,2428,396,883,6,25,390,858,375,479,1173
1994,Bill Laimbeer,C,36,DET,11,248,47,90,3,9,44,81,11,13,108
1994,Andrew Lang,C,27,ATL,82,1608,215,458,1,4,214,454,73,106,504
1994,Eric Leckner,C,27,PHI,71,1163,139,286,0,2,139,284,84,130,362
1994,Tim Legler,PG,27,DAL,79,1322,231,528,52,139,179,389,142,169,656
1994,Jim Les,PG,30,SAC,18,169,13,34,8,18,5,16,11,13,45
1994,Fat Lever,PG,33,DAL,81,1947,227,557,26,74,201,483,75,98,555
1994,Marcus Liberty,SF,25,TOT,38,285,40,123,10,28,30,95,19,39,109
1994,Marcus Liberty,SF,25,DEN,3,11,4,7,0,1,4,6,1,2,9
1994,Marcus Liberty,SF,25,DET,35,274,36,116,10,27,26,89,18,37,100
1994,Todd Lichti,SG,27,TOT,13,126,20,51,2,2,18,49,16,25,58
1994,Todd Lichti,SG,27,ORL,4,20,4,9,0,0,4,9,0,0,8
1994,Todd Lichti,SG,27,GSW,5,58,10,28,2,2,8,26,9,11,31
1994,Todd Lichti,SG,27,BOS,4,48,6,14,0,0,6,14,7,14,19
1994,Brad Lohaus,PF,29,MIL,67,962,102,281,46,134,56,147,20,29,270
1994,Grant Long,PF,27,MIA,69,2201,300,672,1,6,299,666,187,238,788
1994,Luc Longley,C,25,TOT,76,1502,219,465,0,1,219,464,90,125,528
1994,Luc Longley,C,25,MIN,49,989,134,289,0,1,134,288,56,80,324
1994,Luc Longley,C,25,CHI,27,513,85,176,0,0,85,176,34,45,204
1994,George Lynch,SF,23,LAL,71,1762,291,573,0,5,291,568,99,166,681
1994,Malcolm Mackey,C,23,PHO,22,69,14,37,0,2,14,35,4,8,32
1994,Don MacLean,SF,24,WSB,75,2487,517,1030,3,21,514,1009,328,398,1365
1994,Mark Macon,SG,24,TOT,42,496,69,184,2,10,67,174,23,34,163
1994,Mark Macon,SG,24,DEN,7,126,14,45,0,3,14,42,8,10,36
1994,Mark Macon,SG,24,DET,35,370,55,139,2,7,53,132,15,24,127
1994,Gerald Madkins,SG,24,CLE,22,149,11,31,5,15,6,16,8,10,35
1994,Rick Mahorn,PF,35,NJN,28,226,23,47,0,1,23,46,13,20,59
1994,Dan Majerle,SG,28,PHO,80,3207,476,1138,192,503,284,635,176,238,1320
1994,Jeff Malone,SG,32,TOT,77,2560,525,1081,7,12,518,1069,205,247,1262
1994,Jeff Malone,SG,32,UTA,50,1657,338,692,3,6,335,686,129,153,808
1994,Jeff Malone,SG,32,PHI,27,903,187,389,4,6,183,383,76,94,454
1994,Karl Malone*,PF,30,UTA,82,3329,772,1552,8,32,764,1520,511,736,2063
1994,Moses Malone*,C,38,PHI,55,618,102,232,0,1,102,231,90,117,294
1994,Danny Manning,PF,27,TOT,68,2520,586,1201,3,17,583,1184,228,341,1403
1994,Danny Manning,PF,27,LAC,42,1595,409,829,2,14,407,815,174,258,994
1994,Danny Manning,PF,27,ATL,26,925,177,372,1,3,176,369,54,83,409
1994,Roy Marble,SF,27,DEN,5,32,2,12,0,0,2,12,0,3,4
1994,Bob Martin,C,24,LAC,53,535,40,88,0,0,40,88,31,51,111
1994,Jamal Mashburn,SF,21,DAL,79,2896,561,1382,85,299,476,1083,306,438,1513
1994,Anthony Mason,PF,27,NYK,73,1903,206,433,0,1,206,432,116,161,528
1994,Marlon Maxey,PF,24,MIN,55,626,89,167,0,2,89,165,70,98,248
1994,Vernon Maxwell,SG,28,HOU,75,2571,380,976,120,403,260,573,143,191,1023
1994,Lee Mayberry,PG,23,MIL,82,1472,167,402,41,119,126,283,58,84,433
1994,Xavier McDaniel,SF,30,BOS,82,1971,387,839,10,41,377,798,144,213,928
1994,Derrick McKey,SF,27,IND,76,2613,355,710,9,31,346,679,192,254,911
1994,Nate McMillan,PG,29,SEA,73,1887,177,396,52,133,125,263,31,55,437
1994,Darnell Mee,SG,22,DEN,38,285,28,88,5,24,23,64,12,27,73
1994,Oliver Miller,C,23,PHO,69,1786,277,455,2,9,275,446,80,137,636
1994,Reggie Miller*,SG,28,IND,79,2638,524,1042,123,292,401,750,403,444,1574
1994,Chris Mills,SF,24,CLE,79,2022,284,677,38,122,246,555,137,176,743
1994,Terry Mills,PF,26,DET,80,2773,588,1151,24,73,564,1078,181,227,1381
1994,Harold Miner,SG,22,MIA,63,1358,254,532,4,6,250,526,149,180,661
1994,Sam Mitchell,PF,30,IND,75,1084,140,306,0,5,140,301,82,110,362
1994,Tracy Moore,SG,28,DET,3,10,2,3,0,0,2,3,2,2,6
1994,Darren Morningstar,C,24,TOT,23,367,39,82,0,0,39,82,18,30,96
1994,Darren Morningstar,C,24,DAL,22,363,38,81,0,0,38,81,18,30,94
1994,Darren Morningstar,C,24,UTA,1,4,1,1,0,0,1,1,0,0,2
1994,Chris Morris,SF,28,NJN,50,1349,203,454,53,147,150,307,85,118,544
1994,Alonzo Mourning*,C,23,CHH,60,2018,427,845,0,2,427,843,433,568,1287
1994,Chris Mullin*,SF,30,GSW,62,2324,410,869,55,151,355,718,165,219,1040
1994,Eric Murdock,PG,25,MIL,82,2533,477,1019,69,168,408,851,234,288,1257
1994,Gheorghe Muresan,C,22,WSB,54,650,128,235,0,0,128,235,48,71,304
1994,Tod Murphy,PF,30,TOT,9,67,6,12,0,0,6,12,3,6,15
1994,Tod Murphy,PF,30,DET,7,57,6,12,0,0,6,12,3,6,15
1994,Tod Murphy,PF,30,GSW,2,10,0,0,0,0,0,0,0,0,0
1994,Tracy Murray,SF,22,POR,66,820,167,355,50,109,117,246,50,72,434
1994,Jerrod Mustaf,PF,24,PHO,33,196,30,84,0,0,30,84,13,22,73
1994,Dikembe Mutombo*,C,27,DEN,82,2853,365,642,0,1,365,641,256,439,986
1994,Pete Myers,SG,30,CHI,82,2030,253,556,8,29,245,527,136,194,650
1994,Larry Nance,PF,34,CLE,33,909,153,314,0,0,153,314,64,85,370
1994,Chuck Nevitt,C,34,SAS,1,1,0,0,0,0,0,0,3,6,3
1994,Johnny Newman,SF,30,TOT,81,1697,313,664,24,90,289,574,182,225,832
1994,Johnny Newman,SF,30,CHH,18,429,91,174,4,16,87,158,48,59,234
1994,Johnny Newman,SF,30,NJN,63,1268,222,490,20,74,202,416,134,166,598
1994,Ken Norman,SF,29,MIL,82,2539,412,919,63,189,349,730,92,183,979
1994,Shaquille O'Neal*,C,21,ORL,81,3224,953,1591,0,2,953,1589,471,850,2377
1994,Dan O'Sullivan,C,25,DET,13,56,4,12,0,0,4,12,9,12,17
1994,Charles Oakley,PF,30,NYK,82,2932,363,760,0,3,363,757,243,313,969
1994,Hakeem Olajuwon*,C,31,HOU,80,3277,894,1694,8,19,886,1675,388,542,2184
1994,Jimmy Oliver,SG,24,BOS,44,540,89,214,13,32,76,182,25,33,216
1994,Bo Outlaw,SF,22,LAC,37,871,98,167,0,2,98,165,61,103,257
1994,Doug Overton,PG,24,WSB,61,749,87,216,1,11,86,205,43,52,218
1994,Billy Owens,PF,24,GSW,79,2738,492,971,3,15,489,956,199,326,1186
1994,Robert Pack,PG,24,DEN,66,1382,223,503,6,29,217,474,179,236,631
1994,Gerald Paddio,SF,28,TOT,18,137,22,60,0,1,22,59,9,16,53
1994,Gerald Paddio,SF,28,IND,7,55,9,23,0,0,9,23,1,2,19
1994,Gerald Paddio,SF,28,NYK,3,8,2,5,0,0,2,5,0,0,4
1994,Gerald Paddio,SF,28,WSB,8,74,11,32,0,1,11,31,8,14,30
1994,Robert Parish*,C,40,BOS,74,1987,356,725,0,0,356,725,154,208,866
1994,John Paxson,PG,33,CHI,27,343,30,68,9,22,21,46,1,2,70
1994,Gary Payton*,PG,25,SEA,82,2881,584,1159,15,54,569,1105,166,279,1349
1994,Anthony Peeler,SG,24,LAL,30,923,176,409,14,63,162,346,57,71,423
1994,Mike Peplowski,C,23,SAC,55,667,76,141,0,1,76,140,24,44,176
1994,Will Perdue,C,28,CHI,43,397,47,112,0,1,47,111,23,32,117
1994,Sam Perkins,PF,32,SEA,81,2170,341,779,99,270,242,509,218,272,999
1994,Elliot Perry,PG,24,PHO,27,432,42,113,0,3,42,110,21,28,105
1994,Tim Perry,PF,28,PHI,80,2336,272,625,73,200,199,425,102,176,719
1994,Chuck Person,SF,29,MIN,77,2029,356,843,100,272,256,571,82,108,894
1994,Richard Petruska,C,25,HOU,22,92,20,46,7,15,13,31,6,8,53
1994,Bobby Phills,SG,24,CLE,72,1531,242,514,1,12,241,502,113,157,598
1994,Ricky Pierce,SG,34,SEA,51,1022,272,577,6,32,266,545,189,211,739
1994,Ed Pinckney,PF,30,BOS,76,1524,151,289,0,0,151,289,92,125,394
1994,Scottie Pippen*,SF,28,CHI,72,2759,627,1278,63,197,564,1081,270,409,1587
1994,Olden Polynice,C,29,TOT,68,2402,346,662,0,2,346,660,97,191,789
1994,Olden Polynice,C,29,DET,37,1350,222,406,0,1,222,405,42,92,486
1994,Olden Polynice,C,29,SAC,31,1052,124,256,0,1,124,255,55,99,303
1994,Terry Porter,PG,30,POR,77,2074,348,836,110,282,238,554,204,234,1010
1994,Brent Price,PG,25,WSB,65,1035,141,326,50,150,91,176,68,87,400
1994,Mark Price,PG,29,CLE,76,2386,480,1005,118,297,362,708,238,268,1316
1994,Dino Radja,PF,26,BOS,80,2303,491,942,0,1,491,941,226,301,1208
1994,Kurt Rambis,PF,35,LAL,50,635,59,114,0,1,59,113,46,71,164
1994,Mark Randall,PF,26,DEN,28,155,17,50,2,14,15,36,22,28,58
1994,J.R. Reid,PF,25,SAS,70,1344,260,530,0,3,260,527,107,153,627
1994,Glen Rice,SF,26,MIA,81,2999,663,1421,132,346,531,1075,250,284,1708
1994,Pooh Richardson,PG,27,IND,37,1022,160,354,3,12,157,342,47,77,370
1994,Mitch Richmond*,SG,28,SAC,78,2897,635,1428,127,312,508,1116,426,511,1823
1994,Isaiah Rider,SG,22,MIN,79,2415,522,1115,54,150,468,965,215,265,1313
1994,Eric Riley,C,23,HOU,47,219,34,70,0,1,34,69,20,37,88
1994,Doc Rivers,PG,32,NYK,19,499,55,127,19,52,36,75,14,22,143
1994,Stanley Roberts,C,23,LAC,14,350,43,100,0,0,43,100,18,44,104
1994,Clifford Robinson,C,27,POR,82,2853,641,1404,13,53,628,1351,352,460,1647
1994,David Robinson*,C,28,SAS,80,3241,840,1658,10,29,830,1629,693,925,2383
1994,James Robinson,PG,23,POR,58,673,104,285,23,73,81,212,45,67,276
1994,Larry Robinson,SG,26,HOU,6,55,10,20,2,8,8,12,3,8,25
1994,Rumeal Robinson,PG,27,TOT,31,396,55,152,8,20,47,132,13,29,131
1994,Rumeal Robinson,PG,27,NJN,17,301,42,119,7,15,35,104,10,20,101
1994,Rumeal Robinson,PG,27,CHH,14,95,13,33,1,5,12,28,3,9,30
1994,Dennis Rodman*,PF,32,SAS,79,2989,156,292,5,24,151,268,53,102,370
1994,Rodney Rogers,SF,22,DEN,79,1406,239,545,35,92,204,453,127,189,640
1994,Tree Rollins,C,38,ORL,45,384,29,53,0,0,29,53,18,30,76
1994,Sean Rooks,C,24,DAL,47,1255,193,393,0,1,193,392,150,210,536
1994,Donald Royal,SF,27,ORL,74,1357,174,347,0,2,174,345,199,269,547
1994,Bryon Russell,SF,23,UTA,67,1121,135,279,2,22,133,257,62,101,334
1994,John Salley,PF,29,MIA,76,1910,208,436,2,3,206,433,164,225,582
1994,Danny Schayes,C,34,TOT,36,363,28,84,0,0,28,84,29,32,85
1994,Danny Schayes,C,34,MIL,23,230,14,46,0,0,14,46,21,22,49
1994,Danny Schayes,C,34,LAL,13,133,14,38,0,0,14,38,8,10,36
1994,Steve Scheffler,C,26,SEA,35,152,28,46,0,0,28,46,19,20,75
1994,Dwayne Schintzius,C,25,NJN,30,319,29,84,0,0,29,84,10,17,68
1994,Detlef Schrempf,SF,31,SEA,81,2728,445,903,22,68,423,835,300,390,1212
1994,Byron Scott,SG,32,IND,67,1197,256,548,27,74,229,474,157,195,696
1994,Dennis Scott,SF,25,ORL,82,2283,384,949,155,388,229,561,123,159,1046
1994,Malik Sealy,SF,23,IND,43,623,111,274,4,16,107,258,59,87,285
1994,Rony Seikaly,C,28,MIA,72,2410,392,803,0,2,392,801,304,422,1088
1994,Brian Shaw,SG,27,MIA,77,2037,278,667,73,216,205,451,64,89,693
1994,Lionel Simmons,SF,25,SAC,75,2702,436,996,6,17,430,979,251,323,1129
1994,Scott Skiles,PG,29,ORL,82,2303,276,644,68,165,208,479,195,222,815
1994,Charles Smith,SF,28,NYK,43,1105,176,397,8,16,168,381,87,121,447
1994,Chris Smith,PG,23,MIN,80,1617,184,423,10,39,174,384,95,141,473
1994,Doug Smith,PF,24,DAL,79,1684,295,678,2,9,293,669,106,127,698
1994,Kenny Smith,PG,28,HOU,78,2209,341,711,89,220,252,491,135,155,906
1994,LaBradford Smith,SG,24,TOT,66,877,124,306,21,60,103,246,63,84,332
1994,LaBradford Smith,SG,24,WSB,7,48,8,18,0,0,8,18,15,20,31
1994,LaBradford Smith,SG,24,SAC,59,829,116,288,21,60,95,228,48,64,301
1994,Reggie Smith,PF,23,POR,43,316,29,72,0,0,29,72,18,38,76
1994,Steve Smith,SG,24,MIA,78,2776,491,1076,91,262,400,814,273,327,1346
1994,Tony Smith,SG,25,LAL,73,1617,272,617,16,50,256,567,85,119,645
1994,Rik Smits,C,27,IND,78,2113,493,923,0,1,493,922,238,300,1224
1994,Andre Spencer,SF,29,TOT,28,349,52,118,0,0,52,118,55,77,159
1994,Andre Spencer,SF,29,GSW,5,63,9,18,0,0,9,18,3,4,21
1994,Andre Spencer,SF,29,SAC,23,286,43,100,0,0,43,100,52,73,138
1994,Elmore Spencer,C,24,LAC,76,1930,288,540,0,2,288,538,97,162,673
1994,Felton Spencer,C,26,UTA,79,2210,256,507,0,0,256,507,165,272,677
1994,Latrell Sprewell,SG,23,GSW,82,3533,613,1417,141,391,472,1026,353,456,1720
1994,John Starks,SG,28,NYK,59,2057,410,977,113,337,297,640,187,248,1120
1994,Larry Stewart,SF,25,WSB,3,35,3,8,0,0,3,8,7,10,13
1994,Bryant Stith,SG,23,DEN,82,2853,365,811,2,9,363,802,291,351,1023
1994,John Stockton*,PG,31,UTA,82,2969,458,868,48,149,410,719,272,338,1236
1994,Rod Strickland,PG,27,POR,82,2889,528,1093,2,10,526,1083,353,471,1411
1994,Derek Strong,PF,25,MIL,67,1131,141,341,3,13,138,328,159,206,444
1994,Isiah Thomas*,PG,32,DET,58,1750,318,763,39,126,279,637,181,258,856
1994,Kevin Thompson,C,22,POR,14,58,6,14,0,1,6,13,1,2,13
1994,LaSalle Thompson,C,32,IND,30,282,27,77,0,0,27,77,16,30,70
1994,Otis Thorpe,PF,31,HOU,82,2909,449,801,0,2,449,799,251,382,1149
1994,Sedale Threatt,PG,32,LAL,81,2278,411,852,5,33,406,819,138,155,965
1994,Wayman Tisdale,PF,29,SAC,79,2557,552,1102,0,0,552,1102,215,266,1319
1994,Tom Tolbert,SF,28,LAC,49,640,74,177,6,16,68,161,33,45,187
1994,Sedric Toney,PG,31,CLE,12,64,2,12,0,1,2,11,2,2,6
1994,Keith Tower,C,23,ORL,11,32,4,9,0,0,4,9,0,0,8
1994,Jeff Turner,PF,31,ORL,68,1536,199,426,18,55,181,371,35,45,451
1994,Nick Van,PG,22,LAL,81,2700,413,1049,123,364,290,685,150,192,1099
1994,Loy Vaught,PF,25,LAC,75,2118,373,695,0,5,373,690,131,182,877
1994,Kenny Walker,SF,29,WSB,73,1397,132,274,0,3,132,271,87,125,351
1994,Rex Walters,SG,23,NJN,48,386,60,115,14,28,46,87,28,34,162
1994,Clarence Weatherspoon,SF,23,PHI,82,3147,602,1246,4,17,598,1229,298,430,1506
1994,Spud Webb,PG,30,SAC,79,2567,373,810,55,164,318,646,204,251,1005
1994,Chris Webber,C,20,GSW,76,2438,572,1037,0,14,572,1023,189,355,1333
1994,Bill Wennington,C,30,CHI,76,1371,235,482,0,2,235,480,72,88,542
1994,Matt Wenstrom,C,23,BOS,11,37,6,10,0,0,6,10,6,10,18
1994,David Wesley,PG,23,NJN,60,542,64,174,11,47,53,127,44,53,183
1994,Doug West,SG,26,MIN,72,2182,434,891,1,8,433,883,187,231,1056
1994,Mark West,C,33,PHO,82,1236,162,286,0,0,162,286,58,116,382
1994,Ennis Whatley,PG,31,ATL,82,1004,120,236,0,6,120,230,52,66,292
1994,Randy White,PF,26,DAL,18,320,45,112,6,20,39,92,19,33,115
1994,Chris Whitney,PG,22,SAS,40,339,25,82,10,30,15,52,12,15,72
1994,Morlon Wiley,PG,27,TOT,16,158,9,29,3,10,6,19,0,0,21
1994,Morlon Wiley,PG,27,MIA,4,34,3,8,1,4,2,4,0,0,7
1994,Morlon Wiley,PG,27,DAL,12,124,6,21,2,6,4,15,0,0,14
1994,Dominique Wilkins*,SF,34,TOT,74,2635,698,1588,85,295,613,1293,442,522,1923
1994,Dominique Wilkins*,SF,34,ATL,49,1687,430,996,61,198,369,798,275,322,1196
1994,Dominique Wilkins*,SF,34,LAC,25,948,268,592,24,97,244,495,167,200,727
1994,Gerald Wilkins,SG,30,CLE,82,2768,446,975,84,212,362,763,194,250,1170
1994,Aaron Williams,PF,22,UTA,6,12,2,8,0,0,2,8,0,1,4
1994,Buck Williams,PF,33,POR,81,2636,291,524,0,1,291,523,201,296,783
1994,Corey Williams,PG,23,MIN,4,46,5,13,0,1,5,12,1,1,11
1994,Herb Williams,C,35,NYK,70,774,103,233,0,1,103,232,27,42,233
1994,Hot Rod,PF,31,CLE,76,2660,394,825,0,0,394,825,252,346,1040
1994,Jayson Williams,PF,25,NJN,70,877,125,293,0,0,125,293,72,119,322
1994,John Williams,SF,27,LAC,34,725,81,188,5,20,76,168,24,36,191
1994,Kenny Williams,SF,24,IND,68,982,191,391,0,4,191,387,45,64,427
1994,Lorenzo Williams,PF,24,TOT,38,716,49,110,0,1,49,109,12,28,110
1994,Lorenzo Williams,PF,24,ORL,3,19,1,6,0,1,1,5,0,0,2
1994,Lorenzo Williams,PF,24,CHH,1,19,0,1,0,0,0,1,0,0,0
1994,Lorenzo Williams,PF,24,DAL,34,678,48,103,0,0,48,103,12,28,108
1994,Micheal Williams,PG,27,MIN,71,2206,314,687,10,45,304,642,333,397,971
1994,Reggie Williams,SF,29,DEN,82,2654,418,1014,64,230,354,784,165,225,1065
1994,Scott Williams,C,25,CHI,38,638,114,236,1,5,113,231,60,98,289
1994,Walt Williams,SF,23,SAC,57,1356,226,580,38,132,188,448,148,233,638
1994,Kevin Willis,PF,31,ATL,80,2867,627,1257,9,24,618,1233,268,376,1531
1994,Trevor Wilson,PF,25,TOT,57,1221,187,388,0,2,187,386,92,166,466
1994,Trevor Wilson,PF,25,LAL,5,126,19,39,0,0,19,39,13,25,51
1994,Trevor Wilson,PF,25,SAC,52,1095,168,349,0,2,168,347,79,141,415
1994,David Wingate,SG,30,CHH,50,1005,136,283,4,12,132,271,34,51,310
1994,David Wood,PF,29,DET,78,1182,119,259,22,49,97,210,62,82,322
1994,Randy Woods,PG,23,LAC,40,352,49,133,27,78,22,55,20,35,145
1994,Orlando Woolridge,SF,34,PHI,74,1955,364,773,1,14,363,759,208,302,937
1994,Haywoode Workman,PG,28,IND,65,1714,195,460,18,56,177,404,93,116,501
1994,James Worthy*,SF,32,LAL,80,1597,340,838,32,111,308,727,100,135,812
1994,Luther Wright,C,22,UTA,15,92,8,23,0,1,8,22,3,4,19
,,,,,,,,,,,,,,,
1995,Alaa Abdelnaby,PF,26,TOT,54,506,118,231,0,2,118,229,20,35,256
1995,Alaa Abdelnaby,PF,26,SAC,51,476,117,220,0,2,117,218,20,35,254
1995,Alaa Abdelnaby,PF,26,PHI,3,30,1,11,0,0,1,11,0,0,2
1995,Mahmoud Abdul-Rauf,PG,25,DEN,73,2082,472,1005,83,215,389,790,138,156,1165
1995,Michael Adams,PG,32,CHH,29,443,67,148,29,81,38,67,25,30,188
1995,Rafael Addison,SF,30,DET,79,1776,279,586,24,83,255,503,74,99,656
1995,Danny Ainge,SG,35,PHO,74,1374,194,422,78,214,116,208,105,130,571
1995,Victor Alexander,C,25,GSW,50,1237,230,447,6,25,224,422,36,60,502
1995,Derrick Alston,C,22,PHI,64,1032,120,258,0,4,120,254,59,120,299
1995,Greg Anderson,PF,30,ATL,51,622,57,104,0,0,57,104,34,71,148
1995,Kenny Anderson,PG,24,NJN,72,2689,411,1031,97,294,314,737,348,414,1267
1995,Nick Anderson,SG,27,ORL,76,2588,439,923,179,431,260,492,143,203,1200
1995,Willie Anderson,SG,28,SAS,38,556,76,162,3,19,73,143,30,41,185
1995,Greg Anthony,PG,27,NYK,61,943,128,293,56,155,72,138,60,76,372
1995,B.J. Armstrong,PG,27,CHI,82,2577,418,894,108,253,310,641,206,233,1150
1995,Darrell Armstrong,PG,26,ORL,3,8,3,8,2,6,1,2,2,2,10
1995,Vincent Askew,SG,28,SEA,71,1721,248,504,31,94,217,410,176,238,703
1995,Keith Askins,SF,27,MIA,50,854,81,207,21,78,60,129,46,57,229
1995,Stacey Augmon,SG,26,ATL,76,2362,397,876,7,26,390,850,252,346,1053
1995,Anthony Avent,PF,25,ORL,71,1066,105,244,0,0,105,244,48,75,258
1995,Vin Baker,PF,23,MIL,82,3361,594,1229,7,24,587,1205,256,432,1451
1995,Charles Barkley*,PF,31,PHO,68,2382,554,1141,74,219,480,922,379,507,1561
1995,Dana Barros,PG,27,PHI,82,3318,571,1165,197,425,374,740,347,386,1686
1995,Jon Barry,SG,25,MIL,52,602,57,134,16,48,41,86,61,80,191
1995,John Battle,SG,32,CLE,28,280,43,114,11,31,32,83,19,26,116
1995,Sergei Bazarevich,PG,29,ATL,10,74,11,22,1,6,10,16,7,9,30
1995,Benoit Benjamin,C,30,NJN,61,1598,271,531,0,0,271,531,133,175,675
1995,Elmer Bennett,PG,24,CLE,4,18,6,11,0,2,6,9,3,4,15
1995,Tony Bennett,PG,25,CHH,3,46,6,13,2,9,4,4,0,0,14
1995,David Benoit,SF,26,UTA,71,1841,285,587,38,115,247,472,132,157,740
1995,James Blackwell,PG,26,TOT,13,80,8,13,0,0,8,13,2,3,18
1995,James Blackwell,PG,26,CHH,4,19,2,3,0,0,2,3,0,0,4
1995,James Blackwell,PG,26,BOS,9,61,6,10,0,0,6,10,2,3,14
1995,Mookie Blaylock,PG,27,ATL,80,3069,509,1198,199,555,310,643,156,214,1373
1995,Corie Blount,PF,26,CHI,68,889,100,210,0,2,100,208,38,67,238
1995,Muggsy Bogues,PG,30,CHH,78,2629,348,730,6,30,342,700,160,180,862
1995,Manute Bol,C,32,GSW,5,81,6,10,3,5,3,5,0,0,15
1995,Walter Bond,SG,25,TOT,23,290,39,84,15,41,24,43,14,20,107
1995,Walter Bond,SG,25,DET,5,51,3,12,1,4,2,8,3,4,10
1995,Walter Bond,SG,25,UTA,18,239,36,72,14,37,22,35,11,16,97
1995,Anthony Bonner,PF,26,NYK,58,1126,88,193,1,5,87,188,44,67,221
1995,Anthony Bowie,SG,31,ORL,77,1261,177,369,12,40,165,329,61,73,427
1995,Sam Bowie,C,33,LAL,67,1225,118,267,2,11,116,256,68,89,306
1995,Shawn Bradley,C,22,PHI,82,2365,315,693,0,3,315,690,148,232,778
1995,Terrell Brandon,PG,24,CLE,67,1961,341,762,48,121,293,641,159,186,889
1995,Tim Breaux,SF,24,HOU,42,340,45,121,6,25,39,96,32,49,128
1995,Scott Brooks,PG,29,TOT,59,808,126,275,25,69,101,206,64,79,341
1995,Scott Brooks,PG,29,HOU,28,186,35,65,8,17,27,48,18,21,96
1995,Scott Brooks,PG,29,DAL,31,622,91,210,17,52,74,158,46,58,245
1995,Chucky Brown,SF,26,HOU,41,814,105,174,1,3,104,171,38,62,249
1995,Dee Brown,SG,26,BOS,79,2792,437,977,126,327,311,650,236,277,1236
1995,Mike Brown,C,31,MIN,27,213,10,40,0,1,10,39,15,27,35
1995,P.J. Brown,C,25,NJN,80,2466,254,570,4,24,250,546,139,207,651
1995,Randy Brown,PG,26,SAC,67,1086,124,287,14,47,110,240,55,82,317
1995,Mark Bryant,PF,29,POR,49,658,101,192,1,2,100,190,41,63,244
1995,Jud Buechler,SF,26,CHI,57,605,90,183,15,48,75,135,22,39,217
1995,Scott Burrell,SF,24,CHH,65,2014,277,593,96,235,181,358,100,144,750
1995,Willie Burton,SF,26,PHI,53,1564,243,606,106,275,137,331,220,267,812
1995,Mitchell Butler,SG,24,WSB,76,1554,214,508,46,141,168,367,123,185,597
1995,Michael Cage,C,33,CLE,82,2040,177,340,0,2,177,338,53,88,407
1995,Adrian Caldwell,PF,28,HOU,7,30,1,4,0,0,1,4,3,6,5
1995,Elden Campbell,PF,26,LAL,73,2076,360,785,0,1,360,784,193,290,913
1995,Tony Campbell,SF,32,CLE,78,1128,161,392,15,42,146,350,132,159,469
1995,Antoine Carr,C,33,UTA,78,1677,290,546,1,4,289,542,165,201,746
1995,Bill Cartwright,C,37,SEA,29,430,27,69,0,0,27,69,15,24,69
1995,Sam Cassell,PG,25,HOU,82,1882,253,593,63,191,190,402,214,254,783
1995,Duane Causwell,C,26,SAC,58,820,76,147,0,1,76,146,57,98,209
1995,Cedric Ceballos,SF,25,LAL,58,2029,497,977,58,146,439,831,209,292,1261
1995,Tom Chambers,PF,35,UTA,81,1240,195,427,4,24,191,403,109,135,503
1995,Rex Chapman,SG,27,WSB,45,1468,254,639,86,274,168,365,137,159,731
1995,Calbert Cheaney,SG,23,WSB,78,2651,512,1129,96,283,416,846,173,213,1293
1995,Pete Chilcutt,PF,26,HOU,68,1347,146,328,35,86,111,242,31,42,358
1995,Chris Childs,PG,27,NJN,53,1021,106,279,41,125,65,154,55,73,308
1995,Doug Christie,SG,24,NYK,12,79,5,22,1,7,4,15,4,5,15
1995,Derrick Coleman,PF,27,NJN,56,2103,371,875,28,120,343,755,376,490,1146
1995,Bimbo Coles,PG,26,MIA,68,2207,261,607,16,76,245,531,141,174,679
1995,Steve Colter,PG,32,CLE,57,752,67,169,8,35,59,134,54,71,196
1995,Marty Conlon,C,27,MIL,82,2064,344,647,8,29,336,618,119,194,815
1995,Lester Conner,SG,35,LAL,2,5,0,0,0,0,0,0,2,2,2
1995,Tyrone Corbin,SF,32,ATL,81,1389,205,464,14,56,191,408,78,114,502
1995,John Crotty,PG,25,UTA,80,1019,93,231,11,36,82,195,98,121,295
1995,Corey Crowder,SF,25,SAS,7,29,2,10,0,4,2,6,2,6,6
1995,Terry Cummings,PF,33,SAS,76,1273,224,464,0,0,224,464,72,123,520
1995,Bill Curley,PF,22,DET,53,595,58,134,0,0,58,134,27,36,143
1995,Dell Curry,SG,30,CHH,69,1718,343,778,154,361,189,417,95,111,935
1995,Lloyd Daniels,SG,27,TOT,30,604,80,209,26,100,54,109,22,27,208
1995,Lloyd Daniels,SG,27,PHI,5,63,9,27,3,14,6,13,2,2,23
1995,Lloyd Daniels,SG,27,LAL,25,541,71,182,23,86,48,96,20,25,185
1995,Yinka Dare,C,22,NJN,1,3,0,1,0,0,0,1,0,0,0
1995,Antonio Davis,PF,26,IND,44,1030,109,245,0,0,109,245,117,174,335
1995,Dale Davis,PF,25,IND,74,2346,324,576,0,1,324,575,138,259,786
1995,Hubert Davis,SG,24,NYK,82,1697,296,617,131,288,165,329,97,120,820
1995,Terry Davis,PF,27,DAL,46,580,49,113,0,2,49,111,42,66,140
1995,Johnny Dawkins,PG,31,DET,50,1170,125,270,25,73,100,197,50,55,325
1995,Tony Dawson,SF,27,BOS,2,13,3,8,1,3,2,5,1,1,8
1995,Todd Day,SG,25,MIL,82,2717,445,1049,163,418,282,631,257,341,1310
1995,Terry Dehere,PG,23,LAC,80,1774,279,685,48,163,231,522,229,292,835
1995,Vinny Del,SG,28,SAS,75,2360,372,766,66,162,306,604,128,162,938
1995,Bison Dele,C,25,DEN,63,1261,196,333,0,0,196,333,106,162,498
1995,Vlade Divac,C,26,LAL,80,2807,485,957,10,53,475,904,297,382,1277
1995,James Donaldson,C,37,UTA,43,613,44,74,0,0,44,74,22,31,110
1995,Sherman Douglas,PG,28,BOS,65,2048,365,769,20,82,345,687,204,296,954
1995,Greg Dreiling,C,32,CLE,58,483,42,102,0,0,42,102,26,41,110
1995,Clyde Drexler*,SG,32,TOT,76,2728,571,1238,147,408,424,830,364,442,1653
1995,Clyde Drexler*,SG,32,POR,41,1428,305,712,87,240,218,472,207,248,904
1995,Clyde Drexler*,SG,32,HOU,35,1300,266,526,60,168,206,358,157,194,749
1995,Kevin Duckworth,C,30,WSB,40,818,118,267,2,10,116,257,45,70,283
1995,Chris Dudley,C,29,POR,82,2245,181,446,0,1,181,445,85,183,447
1995,Joe Dumars*,SG,31,DET,67,2544,417,970,103,338,314,632,277,344,1214
1995,Richard Dumas,SF,25,PHO,15,167,37,73,0,1,37,72,8,16,82
1995,Tony Dumas,SG,22,DAL,58,613,96,250,22,73,74,177,50,77,264
1995,Pat Durham,SF,27,MIN,59,852,117,237,5,26,112,211,63,96,302
1995,Ledell Eackles,SG,28,MIA,54,898,143,326,18,41,125,285,91,126,395
1995,Acie Earl,C,24,BOS,30,208,26,68,0,0,26,68,14,29,66
1995,Blue Edwards,SF,29,TOT,67,1112,181,393,22,75,159,318,75,90,459
1995,Blue Edwards,SF,29,BOS,31,507,83,195,11,43,72,152,43,48,220
1995,Blue Edwards,SF,29,UTA,36,605,98,198,11,32,87,166,32,42,239
1995,Doug Edwards,PF,24,ATL,38,212,22,48,0,1,22,47,23,32,67
1995,James Edwards,C,39,POR,28,266,32,83,0,0,32,83,11,17,75
1995,Kevin Edwards,SG,29,NJN,14,466,69,154,18,45,51,109,40,42,196
1995,Craig Ehlo,SG,33,ATL,49,1166,191,422,51,134,140,288,44,71,477
1995,Howard Eisley,PG,22,TOT,49,552,40,122,9,37,31,85,31,40,120
1995,Howard Eisley,PG,22,MIN,34,496,37,105,8,32,29,73,31,40,113
1995,Howard Eisley,PG,22,SAS,15,56,3,17,1,5,2,12,0,0,7
1995,Mario Elie,SF,31,HOU,81,1896,243,487,80,201,163,286,144,171,710
1995,Sean Elliott,SF,26,SAS,81,2858,502,1072,136,333,366,739,326,404,1466
1995,Dale Ellis,SF,34,DEN,81,1996,351,774,106,263,245,511,110,127,918
1995,Harold Ellis,SF,24,LAC,69,656,91,189,1,13,90,176,69,117,252
1995,LaPhonso Ellis,PF,24,DEN,6,58,9,25,0,0,9,25,6,6,24
1995,Pervis Ellison,C,27,BOS,55,1083,152,300,0,2,152,298,71,99,375
1995,Jo Jo,SG,24,CHI,8,127,15,39,3,12,12,27,10,13,43
1995,Patrick Ewing*,C,32,NYK,79,2920,730,1452,6,21,724,1431,420,560,1886
1995,Duane Ferrell,SF,29,IND,56,607,83,173,1,6,82,167,64,85,231
1995,Danny Ferry,PF,28,CLE,82,1290,223,500,94,233,129,267,74,84,614
1995,Matt Fish,C,25,LAC,26,370,49,103,0,1,49,102,25,37,123
1995,Vern Fleming,PG,32,IND,55,686,93,188,0,7,93,181,65,90,251
1995,Sleepy Floyd,SG,34,NJN,48,831,71,212,25,88,46,124,30,43,197
1995,Alphonso Ford,SG,23,PHI,5,98,9,39,0,9,9,30,1,2,19
1995,Greg Foster,PF,26,TOT,78,1144,150,318,7,23,143,295,78,111,385
1995,Greg Foster,PF,26,CHI,17,299,41,86,0,0,41,86,22,31,104
1995,Greg Foster,PF,26,MIN,61,845,109,232,7,23,102,209,56,80,281
1995,Rick Fox,SF,25,BOS,53,1039,169,351,31,75,138,276,95,123,464
1995,Corey Gaines,SG,29,PHI,11,280,24,51,2,15,22,36,5,11,55
1995,Kevin Gamble,SF,29,MIA,77,1223,220,450,39,98,181,352,87,111,566
1995,Winston Garland,PG,30,MIN,73,1931,170,410,19,75,151,335,89,112,448
1995,Chris Gatling,PF,27,GSW,58,1470,324,512,0,1,324,511,148,250,796
1995,Kenny Gattison,PF,30,CHH,21,409,47,100,0,1,47,99,31,51,125
1995,Matt Geiger,C,25,MIA,74,1712,260,485,4,10,256,475,93,143,617
1995,Tate George,SG,26,MIL,3,8,1,3,0,1,1,2,2,2,4
1995,Kendall Gill,SG,26,SEA,73,2125,392,858,63,171,329,687,155,209,1002
1995,Armen Gilliam,PF,30,NJN,82,2472,455,905,0,2,455,903,302,392,1212
1995,Greg Graham,SG,24,PHI,50,775,95,223,6,28,89,195,55,73,251
1995,Ron Grandison,PF,30,NYK,2,8,1,4,0,0,1,4,0,0,2
1995,Brian Grant,PF,22,SAC,80,2289,413,809,1,4,412,805,231,363,1058
1995,Gary Grant,PG,29,LAC,33,470,78,166,4,16,74,150,45,55,205
1995,Greg Grant,PG,28,DEN,14,151,10,33,2,7,8,26,9,12,31
1995,Harvey Grant,PF,29,POR,75,1771,286,621,8,26,278,595,103,146,683
1995,Horace Grant,PF,29,ORL,74,2693,401,707,0,8,401,699,146,211,948
1995,Jeff Grayer,SG,29,PHI,47,1098,163,381,5,15,158,366,58,83,389
1995,A.C. Green,SF,31,PHO,82,2687,311,617,43,127,268,490,251,343,916
1995,Tom Gugliotta,SF-PF,25,TOT,77,2568,371,837,60,186,311,651,174,252,976
1995,Tom Gugliotta,PF,25,WSB,6,226,33,83,4,8,29,75,26,33,96
1995,Tom Gugliotta,PF,25,GSW,40,1324,176,397,28,90,148,307,55,97,435
1995,Tom Gugliotta,SF,25,MIN,31,1018,162,357,28,88,134,269,93,122,445
1995,Andres Guibert,PF,26,MIN,17,167,16,47,0,4,16,43,13,19,45
1995,Jack Haley,PF,31,SAS,31,117,26,61,0,1,26,60,21,32,73
1995,Geert Hammink,C,25,ORL,1,7,1,3,0,0,1,3,2,2,4
1995,Tom Hammonds,PF,27,DEN,70,956,139,260,0,1,139,259,132,177,410
1995,Darrin Hancock,SF,23,CHH,46,424,68,121,1,3,67,118,16,39,153
1995,Anfernee Hardaway,PG,23,ORL,77,2901,585,1142,87,249,498,893,356,463,1613
1995,Tim Hardaway,PG,28,GSW,62,2321,430,1007,168,444,262,563,219,288,1247
1995,Jerome Harmon,SG,25,PHI,10,158,21,53,1,1,20,52,3,6,46
1995,Derek Harper,PG,33,NYK,80,2716,337,756,106,292,231,464,139,192,919
1995,Ron Harper,SG,31,CHI,77,1536,209,491,31,110,178,381,81,131,530
1995,Lucious Harris,SG,24,DAL,79,1695,280,610,55,142,225,468,136,170,751
1995,Tony Harris,SG,27,BOS,3,18,3,8,0,1,3,7,8,9,14
1995,Antonio Harvey,PF,24,LAL,59,572,77,176,1,1,76,175,24,45,179
1995,Hersey Hawkins,SG,28,CHH,82,2731,390,809,131,298,259,511,261,301,1172
1995,Steve Henson,PG,26,POR,37,380,37,86,23,52,14,34,22,25,119
1995,Carl Herrera,PF,28,HOU,61,1331,171,327,0,2,171,325,73,117,415
1995,Rod Higgins,SF,35,GSW,5,46,3,12,1,6,2,6,3,4,10
1995,Sean Higgins,SF,26,NJN,57,735,105,273,23,78,82,195,35,40,268
1995,Grant Hill,SF,22,DET,70,2678,508,1064,4,27,504,1037,374,511,1394
1995,Tyrone Hill,C,26,CLE,70,2397,350,694,0,1,350,693,263,397,963
1995,Donald Hodge,C,25,DAL,54,633,83,204,4,14,79,190,39,51,209
1995,Jeff Hornacek,SG,31,UTA,81,2696,482,937,89,219,393,718,284,322,1337
1995,Robert Horry,PF,24,HOU,64,2074,240,537,86,227,154,310,86,113,652
1995,Allan Houston,SG,23,DET,76,1996,398,859,158,373,240,486,147,171,1101
1995,Byron Houston,PF,25,SEA,39,258,49,107,6,22,43,85,28,38,132
1995,Tom Hovasse,SF,28,ATL,2,4,0,1,0,1,0,0,0,0,0
1995,Juwan Howard,PF,21,WSB,65,2348,455,931,0,7,455,924,194,292,1104
1995,Jay Humphries,SG-PG,32,TOT,18,201,8,34,2,4,6,30,2,4,20
1995,Jay Humphries,SG,32,UTA,12,149,4,25,2,3,2,22,0,0,10
1995,Jay Humphries,PG,32,BOS,6,52,4,9,0,1,4,8,2,4,10
1995,Lindsey Hunter,PG,24,DET,42,944,119,318,36,108,83,210,40,55,314
1995,Bobby Hurley,PG,23,SAC,68,1105,103,284,21,76,82,208,58,76,285
1995,Jaren Jackson,SG,27,PHI,21,257,25,68,4,15,21,53,16,24,70
1995,Jim Jackson,SG,24,DAL,51,1982,484,1026,35,110,449,916,306,380,1309
1995,Mark Jackson,PG,29,IND,82,2402,239,566,27,87,212,479,119,153,624
1995,Keith Jennings,PG,26,GSW,80,1722,190,425,75,204,115,221,134,153,589
1995,Avery Johnson,PG,29,SAS,82,3011,448,863,3,22,445,841,202,295,1101
1995,Ervin Johnson,C,27,SEA,64,907,85,192,0,1,85,191,29,46,199
1995,Kevin Johnson,PG,28,PHO,47,1352,246,523,4,26,242,497,234,289,730
1995,Larry Johnson,PF,25,CHH,81,3234,585,1219,81,210,504,1009,274,354,1525
1995,Askia Jones,SG,23,MIN,11,139,15,44,2,12,13,32,13,16,45
1995,Charles Jones,PF,37,HOU,3,36,1,3,0,0,1,3,1,2,3
1995,Eddie Jones,SG,23,LAL,64,1981,342,744,91,246,251,498,122,169,897
1995,Popeye Jones,PF,24,DAL,80,2385,372,839,1,12,371,827,80,124,825
1995,Michael Jordan*,SG,31,CHI,17,668,166,404,16,32,150,372,109,136,457
1995,Adam Keefe,SF,24,UTA,75,1270,172,298,0,0,172,298,117,173,461
1995,Shawn Kemp,PF,25,SEA,82,2679,545,997,2,7,543,990,438,585,1530
1995,Steve Kerr,PG,29,CHI,82,1839,261,495,89,170,172,325,63,81,674
1995,Jerome Kersey,SF,32,POR,63,1143,203,489,7,27,196,462,95,124,508
1995,Randolph Keys,SF,28,LAL,6,83,9,26,0,9,9,17,2,2,20
1995,Jason Kidd,PG,21,DAL,79,2668,330,857,70,257,260,600,192,275,922
1995,Rich King,C,25,SEA,2,6,0,2,0,0,0,2,0,2,0
1995,Stacey King,PF,28,MIN,50,792,99,212,0,1,99,211,68,102,266
1995,Greg Kite,C,33,TOT,11,77,3,17,0,0,3,17,2,10,8
1995,Greg Kite,C,33,NYK,2,16,0,3,0,0,0,3,0,0,0
1995,Greg Kite,C,33,IND,9,61,3,14,0,0,3,14,2,10,8
1995,Joe Kleine,C,33,PHO,75,968,119,265,0,2,119,263,42,49,280
1995,Negele Knight,PG,27,TOT,47,708,85,214,11,28,74,186,18,25,199
1995,Negele Knight,PG,27,POR,3,43,7,15,0,0,7,15,4,4,18
1995,Negele Knight,PG,27,DET,44,665,78,199,11,28,67,171,14,21,181
1995,Jon Koncak,C,31,ATL,62,943,77,187,12,36,65,151,13,24,179
1995,Larry Krystkowiak,PF,30,CHI,19,287,28,72,0,0,28,72,27,30,83
1995,Toni Kukoc,SF,26,CHI,81,2584,487,967,62,198,425,769,235,314,1271
1995,Christian Laettner,C,25,MIN,81,2770,450,920,13,40,437,880,409,500,1322
1995,Andrew Lang,C,28,ATL,82,2340,320,677,2,3,318,674,152,188,794
1995,Antonio Lang,SF,22,PHO,12,53,4,10,0,0,4,10,3,4,11
1995,Eric Leckner,C,28,DET,57,623,87,165,0,2,87,163,51,72,225
1995,Doug Lee,SG,30,SAC,22,75,9,25,7,18,2,7,18,21,43
1995,Tim Legler,SG,28,GSW,24,371,60,115,26,50,34,65,30,34,176
1995,Jim Les,PG,31,ATL,24,188,11,38,5,23,6,15,23,27,50
1995,Cliff Levingston,PF,34,DEN,57,469,55,130,0,1,55,129,19,45,129
1995,Alton Lister,C,36,MIL,60,776,66,134,0,1,66,133,35,70,167
1995,Brad Lohaus,PF,30,MIA,61,730,97,231,63,155,34,76,10,15,267
1995,Grant Long,PF,28,TOT,81,2641,342,716,11,31,331,685,244,325,939
1995,Grant Long,PF,28,MIA,2,62,5,12,0,0,5,12,6,10,16
1995,Grant Long,PF,28,ATL,79,2579,337,704,11,31,326,673,238,315,923
1995,Luc Longley,C,26,CHI,55,1001,135,302,0,2,135,300,88,107,358
1995,Ryan Lorthridge,SG,22,GSW,37,672,106,223,3,14,103,209,57,88,272
1995,George Lynch,SF,24,LAL,56,953,138,295,3,21,135,274,62,86,341
1995,Don MacLean,PF,25,WSB,39,1052,158,361,10,40,148,321,104,136,430
1995,Mark Macon,SG,25,DET,55,721,101,265,20,62,81,203,54,68,276
1995,Gerald Madkins,SG,25,CLE,7,28,2,6,1,2,1,4,3,4,8
1995,Rick Mahorn,PF,36,NJN,58,630,79,151,1,3,78,148,39,49,198
1995,Dan Majerle,SF,29,PHO,82,3091,438,1031,199,548,239,483,206,282,1281
1995,Jeff Malone,SG,33,PHI,19,660,144,284,11,28,133,256,51,59,350
1995,Karl Malone*,PF,31,UTA,82,3126,830,1548,11,41,819,1507,516,695,2187
1995,Moses Malone*,C,39,SAS,17,149,13,35,1,2,12,33,22,32,49
1995,Danny Manning,PF,28,PHO,46,1510,340,622,6,21,334,601,136,202,822
1995,Sarunas Marciulionis*,SG,30,SEA,66,1194,216,457,35,87,181,370,145,198,612
1995,Donyell Marshall,SF,21,TOT,72,2086,345,876,69,243,276,633,147,222,906
1995,Donyell Marshall,SF,21,MIN,40,1036,158,423,32,106,126,317,83,122,431
1995,Donyell Marshall,SF,21,GSW,32,1050,187,453,37,137,150,316,64,100,475
1995,Bob Martin,C,25,LAC,1,14,1,5,0,0,1,5,0,0,2
1995,Darrick Martin,PG,23,MIN,34,803,95,233,7,38,88,195,57,65,254
1995,Jamal Mashburn,SF,22,DAL,80,2980,683,1566,113,344,570,1222,447,605,1926
1995,Anthony Mason,PF,28,NYK,77,2496,287,507,0,1,287,506,191,298,765
1995,Tony Massenburg,C,27,LAC,80,2127,282,601,0,3,282,598,177,235,741
1995,Vernon Maxwell,SG,29,HOU,64,2038,306,777,143,441,163,336,99,144,854
1995,Lee Mayberry,PG,24,MIL,82,1744,172,408,72,177,100,231,58,83,474
1995,George McCloud,SF,27,DAL,42,802,144,328,34,89,110,239,80,96,402
1995,Xavier McDaniel,SF,31,BOS,68,1430,246,546,6,21,240,525,89,125,587
1995,Jim McIlvaine,C,22,WSB,55,534,34,71,0,0,34,71,28,41,96
1995,Derrick McKey,SF,28,IND,81,2805,411,833,32,89,379,744,221,297,1075
1995,Aaron McKie,SG,22,POR,45,827,116,261,11,28,105,233,50,73,293
1995,Nate McMillan,PG,30,SEA,80,2070,166,397,53,155,113,242,34,58,419
1995,Darnell Mee,SG,23,DEN,2,8,1,5,1,3,0,2,0,0,3
1995,Anthony Miller,PF,23,LAL,46,527,70,132,2,5,68,127,47,76,189
1995,Oliver Miller,PF,24,DET,64,1558,232,418,3,13,229,405,78,124,545
1995,Reggie Miller*,SG,29,IND,81,2665,505,1092,195,470,310,622,383,427,1588
1995,Chris Mills,SF,25,CLE,80,2814,359,855,94,240,265,615,174,213,986
1995,Terry Mills,PF,27,DET,72,2514,417,933,109,285,308,648,175,219,1118
1995,Harold Miner,PG,23,MIA,45,871,123,305,14,49,109,256,69,95,329
1995,Greg Minor,SG,23,BOS,63,945,155,301,2,12,153,289,65,78,377
1995,Sam Mitchell,SF,31,IND,81,1377,201,413,1,10,200,403,126,174,529
1995,Eric Mobley,C,24,MIL,46,587,78,132,2,2,76,130,22,45,180
1995,Eric Montross,C,23,BOS,78,2315,307,575,0,1,307,574,167,263,781
1995,Chris Morris,SF,29,NJN,71,2131,351,856,106,317,245,539,142,195,950
1995,Dwayne Morton,PG,23,GSW,41,395,50,129,9,25,41,104,58,85,167
1995,Alonzo Mourning*,C,24,CHH,77,2941,571,1101,11,34,560,1067,490,644,1643
1995,Chris Mullin*,SF,31,GSW,25,890,170,348,42,93,128,255,94,107,476
1995,Eric Murdock,PG,26,MIL,75,2158,338,814,90,240,248,574,211,267,977
1995,Gheorghe Muresan,C,23,WSB,73,1720,303,541,0,0,303,541,124,175,730
1995,Lamond Murray,SF,21,LAC,81,2556,439,1093,65,218,374,875,199,264,1142
1995,Tracy Murray,SF,23,TOT,54,516,95,233,35,86,60,147,33,42,258
1995,Tracy Murray,SF,23,POR,29,313,63,153,16,41,47,112,28,34,170
1995,Tracy Murray,SF,23,HOU,25,203,32,80,19,45,13,35,5,8,88
1995,Dikembe Mutombo*,C,28,DEN,82,3100,349,628,0,0,349,628,248,379,946
1995,Pete Myers,SG,31,CHI,71,1270,119,287,10,39,109,248,70,114,318
1995,Ivano Newbill,SF,24,DET,34,331,16,45,0,0,16,45,8,22,40
1995,Johnny Newman,SF,31,MIL,82,1896,226,488,45,128,181,360,137,171,634
1995,Ken Norman,SF,30,ATL,74,1879,388,856,98,285,290,571,64,140,938
1995,Julius Nwosu,C,23,SAS,23,84,9,28,0,0,9,28,13,17,31
1995,Shaquille O'Neal*,C,22,ORL,79,2923,930,1594,0,5,930,1589,455,854,2315
1995,Charles Oakley,PF,31,NYK,50,1567,192,393,3,12,189,381,119,150,506
1995,Hakeem Olajuwon*,C,32,HOU,72,2853,798,1545,3,16,795,1529,406,537,2005
1995,Brian Oliver,SG,26,WSB,6,42,4,9,0,0,4,9,6,8,14
1995,Bo Outlaw,PF,23,LAC,81,1655,170,325,0,5,170,320,82,186,422
1995,Doug Overton,PG,25,WSB,82,1704,207,498,53,125,154,373,109,125,576
1995,Billy Owens,SG,25,MIA,70,2296,403,820,2,22,401,798,194,313,1002
1995,Robert Pack,PG,25,DEN,42,1144,170,395,30,72,140,323,137,175,507
1995,Robert Parish*,C,41,CHH,81,1352,159,372,0,0,159,372,71,101,389
1995,Gary Payton*,PG,26,SEA,82,3015,685,1345,70,232,615,1113,249,348,1689
1995,Anthony Peeler,SG,25,LAL,73,1559,285,659,84,216,201,443,102,128,756
1995,Mike Peplowski,C,24,DET,6,21,5,5,0,0,5,5,1,2,11
1995,Will Perdue,C,29,CHI,78,1592,254,459,0,1,254,458,113,194,621
1995,Sam Perkins,C,33,SEA,82,2356,346,742,136,343,210,399,215,269,1043
1995,Elliot Perry,PG,25,PHO,82,1977,306,588,25,60,281,528,158,195,795
1995,Tim Perry,PF,29,PHI,42,446,27,78,0,14,27,64,22,40,76
1995,Chuck Person,SF,30,SAS,81,2033,317,750,172,445,145,305,66,102,872
1995,Wesley Person,SG,23,PHO,78,1800,309,638,116,266,193,372,80,101,814
1995,Derrick Phelps,PG,22,SAC,3,5,0,1,0,0,0,1,0,2,0
1995,Bobby Phills,SG,25,CLE,80,2500,338,816,19,55,319,761,183,235,878
1995,Eric Piatkowski,SG,24,LAC,81,1208,201,456,74,198,127,258,90,115,566
1995,Ricky Pierce,PG,35,GSW,27,673,111,254,23,70,88,184,93,106,338
1995,Ed Pinckney,PF,31,MIL,62,835,48,97,0,0,48,97,44,62,140
1995,Scottie Pippen*,SF,29,CHI,79,3014,634,1320,109,316,525,1004,315,440,1692
1995,Olden Polynice,C,30,SAC,81,2534,376,691,1,1,375,690,124,194,877
1995,Terry Porter,PG,31,POR,35,770,105,267,44,114,61,153,58,82,312
1995,Mark Price,PG,30,CLE,48,1375,253,612,103,253,150,359,148,162,757
1995,Kevin Pritchard,PG,27,TOT,19,194,13,32,2,8,11,24,16,21,44
1995,Kevin Pritchard,PG,27,PHI,5,36,0,3,0,3,0,0,1,4,1
1995,Kevin Pritchard,PG,27,MIA,14,158,13,29,2,5,11,24,15,17,43
1995,Dino Radja,PF,27,BOS,66,2147,450,919,0,1,450,918,233,307,1133
1995,Kurt Rambis,PF,36,LAL,26,195,18,35,0,0,18,35,8,12,44
1995,Mark Randall,PF,27,DEN,8,39,3,10,0,1,3,9,0,0,6
1995,Eldridge Recasner,SG,27,DEN,3,13,1,6,0,1,1,5,4,4,6
1995,Khalid Reeves,PG,22,MIA,67,1462,206,465,67,171,139,294,140,196,619
1995,J.R. Reid,PF,26,SAS,81,1566,201,396,1,2,200,394,160,233,563
1995,Glen Rice,SF,27,MIA,82,3014,667,1403,185,451,482,952,312,365,1831
1995,Pooh Richardson,PG,28,LAC,80,2864,353,897,87,244,266,653,81,125,874
1995,Mitch Richmond*,SG,29,SAC,82,3172,668,1497,156,424,512,1073,375,445,1867
1995,Isaiah Rider,SG,23,MIN,75,2645,558,1249,139,396,419,853,277,339,1532
1995,Eric Riley,C,24,LAC,40,434,65,145,0,1,65,144,47,64,177
1995,Doc Rivers,PG,33,TOT,63,989,108,302,45,127,63,175,60,82,321
1995,Doc Rivers,PG,33,NYK,3,47,4,13,3,5,1,8,8,11,19
1995,Doc Rivers,PG,33,SAS,60,942,104,289,42,122,62,167,52,71,302
1995,Fred Roberts,SF,34,CLE,21,223,28,72,4,11,24,61,20,26,80
1995,Clifford Robinson,SF,28,POR,75,2725,597,1320,142,383,455,937,265,382,1601
1995,David Robinson*,C,29,SAS,81,3074,788,1487,6,20,782,1467,656,847,2238
1995,Glenn Robinson,SF,22,MIL,80,2958,636,1410,86,268,550,1142,397,499,1755
1995,James Robinson,PG,24,POR,71,1539,255,624,76,223,179,401,65,110,651
1995,Dennis Rodman*,PF,33,SAS,49,1568,137,240,0,2,137,238,75,111,349
1995,Carlos Rogers,C,23,GSW,49,1017,180,340,2,14,178,326,76,146,438
1995,Rodney Rogers,PF,23,DEN,80,2142,375,769,50,148,325,621,179,275,979
1995,Tree Rollins,C,39,ORL,51,478,20,42,0,0,20,42,21,31,61
1995,Sean Rooks,C,25,MIN,80,2405,289,615,0,5,289,610,290,381,868
1995,Jalen Rose,SF,22,DEN,81,1798,227,500,36,114,191,386,173,234,663
1995,Donald Royal,SF,28,ORL,70,1841,206,434,0,4,206,430,223,299,635
1995,Clifford Rozier,C,22,GSW,66,1494,189,390,2,7,187,383,68,152,448
1995,Trevor Ruffin,PG,24,PHO,49,319,84,197,38,99,46,98,27,38,233
1995,Bryon Russell,SF,24,UTA,63,860,104,238,13,44,91,194,62,93,283
1995,John Salley,C,30,MIA,75,1955,197,395,0,0,197,395,153,207,547
1995,Danny Schayes,C,35,PHO,69,823,126,248,1,1,125,247,50,69,303
1995,Steve Scheffler,C,27,SEA,18,102,12,23,0,0,12,23,15,18,39
1995,Dwayne Schintzius,C,26,NJN,43,318,41,108,0,0,41,108,6,11,88
1995,Detlef Schrempf,SF,32,SEA,82,2886,521,997,93,181,428,816,437,521,1572
1995,Byron Scott,PG,33,IND,80,1528,265,583,79,203,186,380,193,227,802
1995,Dennis Scott,SF,26,ORL,62,1499,283,645,150,352,133,293,86,114,802
1995,Malik Sealy,SG,24,LAC,60,1604,291,669,22,73,269,596,174,223,778
1995,Rony Seikaly,C,29,GSW,36,1035,162,314,0,0,162,314,111,160,435
1995,Charles Shackleford,PF,28,MIN,21,239,39,65,0,0,39,65,16,20,94
1995,Brian Shaw,PG,28,ORL,78,1836,192,494,48,184,144,310,70,95,502
1995,Lionel Simmons,SF,26,SAC,58,1064,131,312,6,16,125,296,59,84,327
1995,Dickey Simpkins,PF,22,CHI,59,586,78,184,0,0,78,184,50,72,206
1995,Scott Skiles,PG,30,WSB,62,2077,265,583,96,228,169,355,179,202,805
1995,Reggie Slater,PF,24,DEN,25,236,40,81,0,0,40,81,40,55,120
1995,Charles Smith,SF,29,NYK,76,2150,352,747,7,31,345,716,255,322,966
1995,Chris Smith,SG,24,MIN,64,1073,116,264,47,108,69,156,41,63,320
1995,Doug Smith,PF,25,DAL,63,826,131,314,1,12,130,302,57,75,320
1995,Kenny Smith,PG,29,HOU,81,2030,287,593,142,331,145,262,126,148,842
1995,Michael Smith,PF,29,LAC,29,319,63,134,1,8,62,126,26,30,153
1995,Michael Smith,PF,22,SAC,82,1736,220,406,0,2,220,404,127,262,567
1995,Steve Smith,SG,25,TOT,80,2665,428,1005,137,416,291,589,312,371,1305
1995,Steve Smith,SG,25,MIA,2,62,11,29,2,12,9,17,17,22,41
1995,Steve Smith,SG,25,ATL,78,2603,417,976,135,404,282,572,295,349,1264
1995,Tony Smith,SG,26,LAL,61,1024,132,309,32,91,100,218,44,63,340
1995,Rik Smits,C,28,IND,78,2381,558,1060,0,2,558,1058,284,377,1400
1995,Elmore Spencer,C,25,LAC,19,368,52,118,0,1,52,117,28,50,132
1995,Felton Spencer,C,27,UTA,34,905,105,215,0,0,105,215,107,135,317
1995,Latrell Sprewell,SG,24,GSW,69,2771,490,1171,90,326,400,845,350,448,1420
1995,John Starks,SG,29,NYK,80,2725,419,1062,217,611,202,451,168,228,1223
1995,Larry Stewart,SF,26,WSB,40,346,41,89,0,2,41,87,20,30,102
1995,Bryant Stith,SG,24,DEN,81,2329,312,661,20,68,292,593,267,324,911
1995,John Stockton*,PG,32,UTA,82,2867,429,791,102,227,327,564,246,306,1206
1995,Mark Strickland,PF,24,IND,4,9,1,3,0,0,1,3,1,2,3
1995,Rod Strickland,PG,28,POR,64,2267,441,946,46,123,395,823,283,380,1211
1995,Derek Strong,PF,26,BOS,70,1344,149,329,2,7,147,322,141,172,441
1995,Greg Sutton,PG,27,CHH,53,690,94,230,43,115,51,115,32,45,263
1995,Aaron Swinson,SF,24,PHO,9,51,10,18,0,0,10,18,4,5,24
1995,Zan Tabak,C,24,HOU,37,182,24,53,0,1,24,52,27,44,75
1995,Roy Tarpley,C,30,DAL,55,1354,292,610,5,18,287,592,102,122,691
1995,Brooks Thompson,PG,24,ORL,38,246,45,114,18,58,27,56,8,12,116
1995,LaSalle Thompson,C,33,IND,38,453,49,118,0,0,49,118,14,16,112
1995,Otis Thorpe,PF,32,TOT,70,2096,385,681,0,7,385,674,167,281,937
1995,Otis Thorpe,PF,32,HOU,36,1188,206,366,0,3,206,363,67,127,479
1995,Otis Thorpe,PF,32,POR,34,908,179,315,0,4,179,311,100,154,458
1995,Sedale Threatt,PG,33,LAL,59,1384,217,437,36,95,181,342,88,111,558
1995,Wayman Tisdale,PF,30,PHO,65,1276,278,574,0,0,278,574,94,122,650
1995,Tom Tolbert,PF,29,CHH,10,57,6,18,0,4,6,14,2,2,14
1995,Keith Tower,C,24,ORL,3,7,0,2,0,0,0,2,1,2,1
1995,Anthony Tucker,SF,25,WSB,62,982,96,210,0,1,96,209,51,83,243
1995,Henry Turner,PF,28,SAC,30,149,23,57,2,5,21,52,20,35,68
1995,Jeff Turner,PF,32,ORL,49,576,73,178,27,75,46,103,26,29,199
1995,B.J. Tyler,PG,23,PHI,55,809,72,189,16,51,56,138,35,50,195
1995,Nick Van,PG,23,LAL,80,2944,465,1107,183,511,282,596,235,300,1348
1995,Loy Vaught,PF,26,LAC,80,2966,609,1185,7,33,602,1152,176,248,1401
1995,Fred Vinson,SG,24,ATL,5,27,1,7,1,6,0,1,1,1,4
1995,Kenny Walker,SF,30,WSB,24,266,18,42,0,0,18,42,21,28,57
1995,Rex Walters,SG,24,NJN,80,1435,206,469,71,196,135,273,40,52,523
1995,Charlie Ward,PG,24,NYK,10,44,4,19,1,10,3,9,7,10,16
1995,Jamie Watson,SF,22,UTA,60,673,76,152,5,19,71,133,38,56,195
1995,Clarence Weatherspoon,SF,24,PHI,76,2991,543,1238,4,21,539,1217,283,377,1373
1995,Spud Webb,PG,31,SAC,76,2458,302,689,48,145,254,544,226,242,878
1995,Chris Webber,PF,21,WSB,54,2067,464,938,40,145,424,793,117,233,1085
1995,Bill Wennington,C,31,CHI,73,956,156,317,0,4,156,313,51,63,363
1995,David Wesley,PG,24,BOS,51,1380,128,313,51,119,77,194,71,94,378
1995,Doug West,SG,27,MIN,71,2328,351,762,11,61,340,701,206,246,919
1995,Mark West,C,34,DET,67,1543,217,390,0,0,217,390,66,138,500
1995,Ennis Whatley,PG,32,ATL,27,292,24,53,2,8,22,45,20,32,70
1995,Chris Whitney,PG,23,SAS,25,179,14,47,3,19,11,28,11,11,42
1995,Morlon Wiley,PG,28,TOT,43,424,50,117,30,79,20,38,7,10,137
1995,Morlon Wiley,PG,28,DAL,38,407,47,111,29,75,18,36,7,10,130
1995,Morlon Wiley,PG,28,ATL,5,17,3,6,1,4,2,2,0,0,7
1995,Dominique Wilkins*,SF,35,BOS,77,2423,496,1169,112,289,384,880,266,340,1370
1995,Aaron Williams,PF,23,MIL,15,72,8,24,0,1,8,23,8,12,24
1995,Buck Williams,PF,34,POR,82,2422,309,604,1,2,308,602,138,205,757
1995,Herb Williams,C,36,NYK,56,743,82,180,0,0,82,180,23,37,187
1995,Hot Rod,PF,32,CLE,74,2641,366,810,1,5,365,805,196,286,929
1995,Jayson Williams,PF,26,NJN,75,982,149,323,0,5,149,318,65,122,363
1995,John Williams,SF,28,IND,34,402,41,115,4,12,37,103,14,25,100
1995,Lorenzo Williams,C,25,DAL,82,2383,145,304,0,0,145,304,38,101,328
1995,Micheal Williams,PG,28,MIN,1,28,1,4,0,0,1,4,4,5,6
1995,Monty Williams,SF,23,NYK,41,503,60,133,0,8,60,125,17,38,137
1995,Reggie Williams,SF,30,DEN,74,2198,388,846,85,266,303,580,132,174,993
1995,Scott Williams,PF,26,PHI,77,1781,206,434,0,7,206,427,79,107,491
1995,Walt Williams,SF,24,SAC,77,2739,445,998,103,296,342,702,266,364,1259
1995,Kevin Willis,PF,32,TOT,67,2390,473,1015,3,15,470,1000,205,297,1154
1995,Kevin Willis,PF,32,ATL,2,89,16,41,0,1,16,40,10,15,42
1995,Kevin Willis,PF,32,MIA,65,2301,457,974,3,14,454,960,195,282,1112
1995,Trevor Wilson,PF,26,SAC,15,147,18,40,0,0,18,40,11,14,47
1995,David Wingate,SG,31,CHH,52,515,50,122,4,22,46,100,18,24,122
1995,Dontonio Wingfield,SF,20,SEA,20,81,18,51,2,12,16,39,8,10,46
1995,Joe Wolf,PF,30,CHH,63,583,38,81,2,6,36,75,12,16,90
1995,David Wood,PF,30,GSW,78,1336,153,326,31,91,122,235,91,117,428
1995,Randy Woods,PG,24,LAC,62,495,37,117,22,74,15,43,28,38,124
1995,Haywoode Workman,PG,29,IND,69,1028,101,269,35,98,66,171,55,74,292
1995,Sharone Wright,C,22,PHI,79,2044,361,776,0,8,361,768,182,282,904
1995,Danny Young,PG,32,MIL,7,77,9,17,5,12,4,5,1,1,24
,,,,,,,,,,,,,,,
1996,Mahmoud Abdul-Rauf,PG,26,DEN,57,2029,414,955,121,309,293,646,146,157,1095
1996,Michael Adams,PG,33,CHH,21,329,37,83,14,41,23,42,26,35,114
1996,Rafael Addison,SF,31,CHH,53,516,77,165,0,9,77,156,17,22,171
1996,Cory Alexander,PG,22,SAS,60,560,63,155,26,66,37,89,16,25,168
1996,Jerome Allen,SG,23,MIN,41,362,36,105,10,33,26,72,26,36,108
1996,Derrick Alston,C,23,PHI,73,1614,198,387,1,3,197,384,55,112,452
1996,John Amaechi,PF,25,CLE,28,357,29,70,0,0,29,70,19,33,77
1996,Ashraf Amaya,PF,24,VAN,54,1104,121,252,0,1,121,251,97,149,339
1996,Greg Anderson,PF,31,SAS,46,344,24,47,0,1,24,46,6,25,54
1996,Kenny Anderson,PG,25,TOT,69,2344,349,834,92,256,257,578,260,338,1050
1996,Kenny Anderson,PG,25,NJN,31,1042,143,380,36,99,107,281,151,188,473
1996,Kenny Anderson,PG,25,CHH,38,1302,206,454,56,157,150,297,109,150,577
1996,Nick Anderson,SG,28,ORL,77,2717,400,904,168,430,232,474,166,240,1134
1996,Willie Anderson,SG,29,TOT,76,2060,288,660,34,120,254,540,132,163,742
1996,Willie Anderson,SG,29,TOR,49,1564,232,527,29,95,203,432,113,132,606
1996,Willie Anderson,SG,29,NYK,27,496,56,133,5,25,51,108,19,31,136
1996,Greg Anthony,PG,28,VAN,69,2096,324,781,90,271,234,510,229,297,967
1996,B.J. Armstrong,PG,28,GSW,82,2262,340,727,98,207,242,520,234,279,1012
1996,Darrell Armstrong,PG,27,ORL,13,41,16,32,6,12,10,20,4,4,42
1996,Vincent Askew,SG,29,SEA,69,1725,215,436,29,86,186,350,123,161,582
1996,Keith Askins,SF,28,MIA,75,1897,157,391,99,237,58,154,45,57,458
1996,Stacey Augmon,SF,27,ATL,77,2294,362,738,1,4,361,734,251,317,976
1996,Anthony Avent,PF,26,VAN,71,1586,179,466,0,0,179,466,57,77,415
1996,Vin Baker,PF,24,MIL,82,3319,699,1429,10,48,689,1381,321,479,1729
1996,Steve Bardo,SG,27,DET,9,123,9,23,0,4,9,19,4,6,22
1996,Charles Barkley*,PF,32,PHO,71,2632,580,1160,49,175,531,985,440,566,1649
1996,Dana Barros,PG,28,BOS,80,2328,379,806,150,368,229,438,130,147,1038
1996,Brent Barry,SG,24,LAC,79,1898,283,597,123,296,160,301,111,137,800
1996,Jon Barry,SG,26,GSW,68,712,91,185,44,93,47,92,31,37,257
1996,Corey Beck,PG,24,CHH,5,33,2,8,0,0,2,8,1,2,5
1996,Benoit Benjamin,C,31,TOT,83,1896,294,590,0,3,294,587,140,194,728
1996,Benoit Benjamin,C,31,VAN,13,404,71,161,0,0,71,161,39,56,181
1996,Benoit Benjamin,C,31,MIL,70,1492,223,429,0,3,223,426,101,138,547
1996,Elmer Bennett,PG,25,PHI,8,66,4,17,0,0,4,17,3,4,11
1996,Mario Bennett,SF,22,PHO,19,230,29,64,0,1,29,63,27,42,85
1996,David Benoit,SF,27,UTA,81,1961,255,581,64,192,191,389,87,112,661
1996,Travis Best,PG,23,IND,59,571,69,163,8,25,61,138,75,90,221
1996,Mookie Blaylock,PG,28,ATL,81,2893,455,1123,231,623,224,500,127,170,1268
1996,Corie Blount,PF,27,LAL,57,715,79,167,0,2,79,165,25,44,183
1996,Muggsy Bogues,PG,31,CHH,6,77,6,16,0,1,6,15,2,2,14
1996,Anthony Bonner,PF,27,ORL,4,43,5,15,0,0,5,15,3,7,13
1996,Melvin Booker,PG,23,HOU,11,131,16,50,3,19,13,31,9,11,44
1996,Anthony Bowie,SG,32,ORL,74,1078,128,272,12,31,116,241,40,46,308
1996,Donnie Boyce,SG,22,ATL,8,41,9,23,4,8,5,15,2,4,24
1996,Shawn Bradley,C,23,TOT,79,2329,387,873,1,4,386,869,169,246,944
1996,Shawn Bradley,C,23,PHI,12,334,43,97,0,0,43,97,19,25,105
1996,Shawn Bradley,C,23,NJN,67,1995,344,776,1,4,343,772,150,221,839
1996,Marques Bragg,PF,25,MIN,53,369,54,120,0,0,54,120,23,41,131
1996,Terrell Brandon,PG,25,CLE,75,2570,510,1096,91,235,419,861,338,381,1449
1996,Tim Breaux,SF,25,HOU,54,570,59,161,15,46,44,115,28,45,161
1996,Frank Brickowski,C,36,SEA,63,986,123,252,32,79,91,173,61,86,339
1996,Scott Brooks,PG,30,DAL,69,716,134,293,25,62,109,231,59,69,352
1996,Chucky Brown,PF,27,HOU,82,2019,300,555,1,8,299,547,104,150,705
1996,Dee Brown,PG,27,BOS,65,1591,246,616,68,220,178,396,135,158,695
1996,Mike Brown,C,32,PHI,9,162,9,16,0,0,9,16,8,17,26
1996,P.J. Brown,C,26,NJN,81,2942,354,798,3,15,351,783,204,265,915
1996,Randy Brown,PG,27,CHI,68,671,78,192,1,11,77,181,28,46,185
1996,Mark Bryant,PF,30,HOU,71,1587,242,446,0,2,242,444,127,177,611
1996,Jud Buechler,SF,27,CHI,74,740,112,242,40,90,72,152,14,22,278
1996,Matt Bullard,PF,28,ATL,46,460,66,162,26,72,40,90,16,20,174
1996,Scott Burrell,SF,25,CHH,20,693,92,206,37,98,55,108,42,56,263
1996,Junior Burrough,PF,23,BOS,61,495,64,170,0,0,64,170,61,93,189
1996,Mitchell Butler,SG,25,WSB,61,858,88,229,13,60,75,169,48,83,237
1996,Jason Caffey,PF,22,CHI,57,545,71,162,0,1,71,161,40,68,182
1996,Michael Cage,C,34,CLE,82,2631,220,396,0,1,220,395,50,92,490
1996,Adrian Caldwell,PF,29,IND,51,327,46,83,0,0,46,83,18,36,110
1996,Elden Campbell,PF,27,LAL,82,2699,447,888,0,5,447,883,249,349,1143
1996,Antoine Carr,SF,34,UTA,80,1532,233,510,0,3,233,507,114,144,580
1996,Chris Carr,SG,21,PHO,60,590,90,217,11,42,79,175,49,60,240
1996,Sam Cassell,PG,26,HOU,61,1682,289,658,73,210,216,448,235,285,886
1996,Duane Causwell,C,27,SAC,73,1044,90,216,0,1,90,215,70,96,250
1996,Cedric Ceballos,SF,26,LAL,78,2628,638,1203,51,184,587,1019,329,409,1656
1996,Rex Chapman,SG,28,MIA,56,1865,289,679,125,337,164,342,83,113,786
1996,Calbert Cheaney,SF,24,WSB,70,2324,426,905,52,154,374,751,151,214,1055
1996,Pete Chilcutt,PF,27,HOU,74,651,73,179,37,98,36,81,17,26,200
1996,Randolph Childress,PG,23,POR,28,250,25,79,13,47,12,32,22,27,85
1996,Chris Childs,PG,28,NJN,78,2408,324,778,95,259,229,519,259,304,1002
1996,Doug Christie,SF,25,TOT,55,1036,150,337,46,106,104,231,69,93,415
1996,Doug Christie,SF,25,NYK,23,218,35,73,10,19,25,54,13,22,93
1996,Doug Christie,SF,25,TOR,32,818,115,264,36,87,79,177,56,71,322
1996,Robert Churchwell,SG,23,GSW,4,20,3,8,0,0,3,8,0,0,6
1996,Charles Claxton,C,25,BOS,3,7,1,2,0,0,1,2,0,2,2
1996,John Coker,C,24,PHO,5,11,4,5,0,0,4,5,0,0,8
1996,Derrick Coleman,PF,28,PHI,11,294,48,118,7,21,41,97,20,32,123
1996,Bimbo Coles,PG,27,TOT,81,2615,318,777,88,254,230,523,168,211,892
1996,Bimbo Coles,PG,27,MIA,52,1882,231,559,63,172,168,387,139,173,664
1996,Bimbo Coles,PG,27,GSW,29,733,87,218,25,82,62,136,29,38,228
1996,Marty Conlon,C,28,MIL,74,958,153,327,5,30,148,297,84,110,395
1996,Anthony Cook,PF,28,POR,11,60,7,16,0,2,7,14,1,4,15
1996,Tyrone Corbin,SF,33,TOT,71,1284,155,351,3,18,152,333,100,120,413
1996,Tyrone Corbin,SF,33,SAC,49,930,117,259,1,12,116,247,77,92,312
1996,Tyrone Corbin,SF,33,MIA,22,354,38,92,2,6,36,86,23,28,101
1996,Joe Courtney,PF,26,CLE,23,200,15,35,0,0,15,35,8,18,38
1996,John Crotty,PG,26,CLE,58,617,51,114,8,27,43,87,62,72,172
1996,Terry Cummings,PF,34,MIL,81,1777,270,584,1,7,269,577,104,160,645
1996,Dell Curry,SG,31,CHH,82,2371,441,974,164,406,277,568,146,171,1192
1996,Michael Curry,SG-SF,27,TOT,46,783,73,161,20,53,53,108,45,62,211
1996,Michael Curry,SF,27,WSB,5,34,3,10,0,3,3,7,4,4,10
1996,Michael Curry,SG,27,DET,41,749,70,151,20,50,50,101,41,58,201
1996,Rastko Cvetkovic,C,25,DEN,14,48,5,16,0,1,5,15,0,4,10
1996,Sasha Danilovic,SG,25,MIA,19,542,83,184,34,78,49,106,55,72,255
1996,Yinka Dare,C,23,NJN,58,626,63,144,0,0,63,144,38,62,164
1996,Antonio Davis,PF,27,IND,82,2092,236,482,1,2,235,480,246,345,719
1996,Dale Davis,PF,26,IND,78,2617,334,599,0,0,334,599,135,289,803
1996,Hubert Davis,SG,25,NYK,74,1773,275,566,127,267,148,299,112,129,789
1996,Mark Davis,SF,22,MIN,57,571,55,149,4,13,51,136,74,116,188
1996,Terry Davis,PF,28,DAL,28,501,55,108,0,0,55,108,27,47,137
1996,Todd Day,SG,26,TOT,79,1807,299,817,100,302,199,515,224,287,922
1996,Todd Day,SG,26,MIL,8,171,22,71,5,25,17,46,24,26,73
1996,Todd Day,SG,26,BOS,71,1636,277,746,95,277,182,469,200,261,849
1996,Andrew DeClercq,C,22,GSW,22,203,24,50,0,1,24,49,11,19,59
1996,Terry Dehere,PG,24,LAC,82,2018,315,686,139,316,176,370,247,327,1016
1996,Vinny Del,SG,29,SAS,82,2766,478,962,57,150,421,812,178,214,1191
1996,Bison Dele,C,26,LAC,65,2157,416,766,1,6,415,760,196,267,1029
1996,Dell Demps,SG,25,SAS,16,87,19,33,1,2,18,31,14,17,53
1996,Vlade Divac,C,27,LAL,79,2470,414,807,3,18,411,789,189,295,1020
1996,Sherman Douglas,PG,29,TOT,79,2335,345,685,40,110,305,575,160,219,890
1996,Sherman Douglas,PG,29,BOS,10,234,36,84,1,7,35,77,25,40,98
1996,Sherman Douglas,PG,29,MIL,69,2101,309,601,39,103,270,498,135,179,792
1996,Clyde Drexler*,SG,33,HOU,52,1997,331,764,78,235,253,529,265,338,1005
1996,Kevin Duckworth,C,31,MIL,8,58,3,14,0,0,3,14,3,6,9
1996,Chris Dudley,C,30,POR,80,1924,162,358,0,1,162,357,80,157,404
1996,Joe Dumars*,PG,32,DET,67,2193,255,598,121,298,134,300,162,197,793
1996,Richard Dumas,PF,26,PHI,39,739,95,203,2,9,93,194,49,70,241
1996,Tony Dumas,SG,23,DAL,67,1284,274,655,74,207,200,448,154,257,776
1996,Ledell Eackles,SG,29,WSB,55,1238,161,377,54,128,107,249,98,118,474
1996,Acie Earl,C,25,TOR,42,655,117,276,0,3,117,273,82,114,316
1996,Tyus Edney,PG,22,SAC,80,2481,305,740,53,144,252,596,197,252,860
1996,Blue Edwards,SF,30,VAN,82,2773,401,956,84,245,317,711,157,208,1043
1996,Doug Edwards,PF,25,VAN,31,519,32,91,0,4,32,87,29,38,93
1996,James Edwards,C,40,CHI,28,274,41,110,0,0,41,110,16,26,98
1996,Kevin Edwards,SG,30,NJN,34,1007,142,390,42,104,100,286,68,84,394
1996,Craig Ehlo,SG,34,ATL,79,1758,253,591,82,221,171,370,81,103,669
1996,Howard Eisley,PG,23,UTA,65,961,104,242,14,62,90,180,65,77,287
1996,Mario Elie,SF,32,HOU,45,1385,180,357,41,127,139,230,98,115,499
1996,Sean Elliott,SF,27,SAS,77,2901,525,1127,161,392,364,735,326,423,1537
1996,Dale Ellis,SF,35,DEN,81,2626,459,959,150,364,309,595,136,179,1204
1996,LaPhonso Ellis,SF,25,DEN,45,1269,189,432,4,22,185,410,89,148,471
1996,LeRon Ellis,C,26,MIA,12,74,5,22,0,0,5,22,3,6,13
1996,Pervis Ellison,C,28,BOS,69,1431,145,295,0,0,145,295,75,117,365
1996,Vincenzo Esposito,PG,27,TOR,30,282,36,100,13,56,23,44,31,39,116
1996,Patrick Ewing*,C,33,NYK,76,2783,678,1456,4,28,674,1428,351,461,1711
1996,Duane Ferrell,SF,30,IND,54,591,80,166,0,8,80,158,42,57,202
1996,Danny Ferry,PF,29,CLE,82,2680,422,919,143,363,279,556,103,134,1090
1996,Michael Finley,SF,22,PHO,82,3212,465,976,61,186,404,790,242,323,1233
1996,Matt Fish,C,26,TOT,18,134,21,36,0,0,21,36,10,19,52
1996,Matt Fish,C,26,NYK,2,17,6,10,0,0,6,10,0,1,12
1996,Matt Fish,C,26,DEN,16,117,15,26,0,0,15,26,10,18,40
1996,Vern Fleming,PG,33,NJN,77,1747,227,524,3,28,224,496,133,177,590
1996,Sherell Ford,SF,23,SEA,28,139,30,80,4,25,26,55,26,34,90
1996,Greg Foster,C,27,UTA,73,803,107,244,1,8,106,236,61,72,276
1996,Rick Fox,SF,26,BOS,81,2588,421,928,99,272,322,656,196,254,1137
1996,Kevin Gamble,SF,30,TOT,65,1325,152,379,44,114,108,265,38,48,386
1996,Kevin Gamble,SF,30,MIA,44,1033,117,297,38,91,79,206,33,38,305
1996,Kevin Gamble,SF,30,SAC,21,292,35,82,6,23,29,59,5,10,81
1996,Kevin Garnett,SF,19,MIN,80,2293,361,735,8,28,353,707,105,149,835
1996,Chris Gatling,PF,28,TOT,71,1427,326,567,0,1,326,566,139,207,791
1996,Chris Gatling,PF,28,GSW,47,862,171,308,0,1,171,307,84,132,426
1996,Chris Gatling,PF,28,MIA,24,565,155,259,0,0,155,259,55,75,365
1996,Kenny Gattison,PF,31,VAN,25,570,91,190,0,0,91,190,47,78,229
1996,Matt Geiger,C,26,CHH,77,2349,357,666,3,8,354,658,149,205,866
1996,Kendall Gill,SG,27,TOT,47,1683,246,524,26,79,220,445,138,176,656
1996,Kendall Gill,SG,27,CHH,36,1265,179,372,17,54,162,318,89,117,464
1996,Kendall Gill,SG,27,NJN,11,418,67,152,9,25,58,127,49,59,192
1996,Armen Gilliam,SF,31,NJN,78,2856,576,1216,0,1,576,1215,277,350,1429
1996,Gerald Glass,SF,28,TOT,15,71,12,33,1,6,11,27,1,1,26
1996,Gerald Glass,SF,28,NJN,10,56,10,28,1,5,9,23,0,0,21
1996,Gerald Glass,SF,28,CHH,5,15,2,5,0,1,2,4,1,1,5
1996,Anthony Goldwire,PG,24,CHH,42,621,76,189,33,83,43,106,46,60,231
1996,Greg Graham,SG,25,TOT,53,613,78,193,32,82,46,111,52,68,240
1996,Greg Graham,SG,25,PHI,8,128,17,32,7,14,10,18,15,17,56
1996,Greg Graham,SG,25,NJN,45,485,61,161,25,68,36,93,37,51,184
1996,Ron Grandison,PF,31,TOT,28,311,22,58,4,14,18,44,17,25,65
1996,Ron Grandison,PF,31,MIA,18,235,13,39,4,13,9,26,13,19,43
1996,Ron Grandison,PF,31,ATL,4,19,2,4,0,1,2,3,0,0,4
1996,Ron Grandison,PF,31,NYK,6,57,7,15,0,0,7,15,4,6,18
1996,Brian Grant,PF,23,SAC,78,2398,427,842,4,17,423,825,262,358,1120
1996,Gary Grant,PG,30,NYK,47,596,88,181,8,24,80,157,48,58,232
1996,Greg Grant,PG,29,TOT,31,527,35,99,8,34,27,65,5,6,83
1996,Greg Grant,PG,29,PHI,11,280,18,48,4,18,14,30,5,6,45
1996,Greg Grant,PG,29,WSB,10,138,11,28,2,10,9,18,0,0,24
1996,Greg Grant,PG,29,DEN,10,109,6,23,2,6,4,17,0,0,14
1996,Harvey Grant,PF,30,POR,76,2394,314,679,21,67,293,612,60,110,709
1996,Horace Grant,PF,30,ORL,63,2286,347,677,1,6,346,671,152,207,847
1996,A.C. Green,SF,32,PHO,82,2113,215,444,14,52,201,392,168,237,612
1996,Tom Gugliotta,PF,26,MIN,78,2835,473,1004,26,86,447,918,289,374,1261
1996,Jack Haley,C,32,CHI,1,7,2,6,0,0,2,6,1,2,5
1996,Thomas Hamilton,C,20,BOS,11,70,9,31,0,0,9,31,7,18,25
1996,Geert Hammink,C,26,TOT,6,17,2,4,0,0,2,4,4,7,8
1996,Geert Hammink,C,26,ORL,3,7,1,2,0,0,1,2,2,4,4
1996,Geert Hammink,C,26,GSW,3,10,1,2,0,0,1,2,2,3,4
1996,Tom Hammonds,PF,28,DEN,71,1045,127,268,0,0,127,268,88,115,342
1996,Darrin Hancock,SF,24,CHH,63,838,112,214,1,3,111,211,47,73,272
1996,Anfernee Hardaway,PG,24,ORL,82,3015,623,1215,89,283,534,932,445,580,1780
1996,Tim Hardaway,PG,29,TOT,80,2534,419,992,138,379,281,613,241,305,1217
1996,Tim Hardaway,PG,29,GSW,52,1487,255,606,85,232,170,374,140,182,735
1996,Tim Hardaway,PG,29,MIA,28,1047,164,386,53,147,111,239,101,123,482
1996,Derek Harper,PG,34,NYK,82,2893,436,939,121,325,315,614,156,206,1149
1996,Ron Harper,PG,32,CHI,80,1886,234,501,28,104,206,397,98,139,594
1996,Lucious Harris,SG,25,DAL,61,1016,183,397,47,125,136,272,68,87,481
1996,Antonio Harvey,PF,25,TOT,55,821,83,224,0,2,83,222,38,83,204
1996,Antonio Harvey,PF,25,VAN,18,410,39,95,0,2,39,93,20,43,98
1996,Antonio Harvey,PF,25,LAC,37,411,44,129,0,0,44,129,18,40,106
1996,Hersey Hawkins,SG,29,SEA,82,2823,443,936,146,380,297,556,249,285,1281
1996,Alvin Heggs,SF,28,HOU,4,14,3,5,0,0,3,5,2,3,8
1996,Alan Henderson,PF,23,ATL,79,1416,192,434,0,3,192,431,119,200,503
1996,Carl Herrera,PF,29,SAS,44,393,40,97,0,1,40,96,5,17,85
1996,Sean Higgins,SF,27,PHI,44,916,134,323,48,129,86,194,35,37,351
1996,Grant Hill,SF,23,DET,80,3260,564,1221,5,26,559,1195,485,646,1618
1996,Tyrone Hill,PF,27,CLE,44,929,130,254,0,0,130,254,81,135,341
1996,Donald Hodge,C,26,TOT,15,115,9,24,0,0,9,24,0,0,18
1996,Donald Hodge,C,26,DAL,13,113,9,24,0,0,9,24,0,0,18
1996,Donald Hodge,C,26,CHH,2,2,0,0,0,0,0,0,0,0,0
1996,Fred Hoiberg,SG,23,IND,15,85,8,19,1,3,7,16,15,18,32
1996,Jeff Hornacek,SG,32,UTA,82,2588,442,880,104,223,338,657,259,290,1247
1996,Robert Horry,SF,25,HOU,71,2634,300,732,142,388,158,344,111,143,853
1996,Allan Houston,SG,24,DET,82,3072,564,1244,191,447,373,797,298,362,1617
1996,Byron Houston,PF,26,SAC,25,276,32,64,1,3,31,61,21,26,86
1996,Juwan Howard,PF,22,WSB,81,3294,733,1500,4,13,729,1487,319,426,1789
1996,Lindsey Hunter,PG,25,DET,80,2138,239,628,117,289,122,339,84,120,679
1996,Bobby Hurley,PG,24,SAC,72,1059,65,230,22,76,43,154,68,85,220
1996,Jaren Jackson,SG,28,HOU,4,33,0,8,0,5,0,3,8,10,8
1996,Jim Jackson,SG,25,DAL,82,2820,569,1308,121,333,448,975,345,418,1604
1996,Mark Jackson,PG,30,IND,81,2643,296,626,64,149,232,477,150,191,806
1996,Henry James,PF,30,HOU,7,58,10,24,5,15,5,9,5,5,30
1996,Avery Johnson,PG,30,SAS,82,3084,438,887,6,31,432,856,189,262,1071
1996,Darryl Johnson,PG,30,CLE,11,28,5,12,0,1,5,11,2,2,12
1996,Eddie Johnson,SF,36,IND,62,1002,180,436,45,128,135,308,70,79,475
1996,Ervin Johnson,C,28,SEA,81,1519,180,352,1,3,179,349,85,127,446
1996,Kevin Johnson,PG,29,PHO,56,2007,342,674,21,57,321,617,342,398,1047
1996,Larry Johnson,PF,26,CHH,81,3274,583,1225,67,183,516,1042,427,564,1660
1996,Magic Johnson*,PF,36,LAL,32,958,137,294,22,58,115,236,172,201,468
1996,Charles Jones,PF,38,HOU,46,297,6,19,0,0,6,19,4,13,16
1996,Eddie Jones,SG,24,LAL,70,2184,337,685,83,227,254,458,136,184,893
1996,Popeye Jones,PF,25,DAL,68,2322,327,733,14,39,313,694,102,133,770
1996,Michael Jordan*,SG,32,CHI,82,3090,916,1850,111,260,805,1590,548,657,2491
1996,Reggie Jordan,PG,28,ATL,24,247,36,71,0,0,36,71,22,38,94
1996,Adam Keefe,PF,25,UTA,82,1708,180,346,0,4,180,342,139,201,499
1996,Shawn Kemp,PF,26,SEA,79,2631,526,937,5,12,521,925,493,664,1550
1996,Tim Kempton,PF,32,ATL,3,11,0,0,0,0,0,0,0,0,0
1996,Steve Kerr,PG,30,CHI,82,1919,244,482,122,237,122,245,78,84,688
1996,Jerome Kersey,SF,33,GSW,76,1620,205,500,3,17,202,483,97,147,510
1996,Randolph Keys,SF,29,MIL,69,816,87,208,22,71,65,137,36,43,232
1996,Jason Kidd,PG,22,DAL,81,3034,493,1293,133,396,360,897,229,331,1348
1996,Chris King,SF,26,VAN,80,1930,250,585,44,113,206,472,90,136,634
1996,Frankie King,PG,23,LAL,6,20,3,11,0,1,3,10,1,3,7
1996,Jimmy King,SG,22,TOR,62,868,110,255,5,34,105,221,54,77,279
1996,Stacey King,PF,29,MIA,15,156,17,36,0,0,17,36,4,8,38
1996,Joe Kleine,C,34,PHO,56,663,71,169,2,7,69,162,20,25,164
1996,Jon Koncak,C,32,ORL,67,1288,84,175,3,9,81,166,32,57,203
1996,Toni Kukoc,SF,27,CHI,81,2103,386,787,87,216,299,571,206,267,1065
1996,Christian Laettner,C,26,TOT,74,2495,442,907,9,39,433,868,324,396,1217
1996,Christian Laettner,C,26,MIN,44,1518,283,582,9,31,274,551,217,266,792
1996,Christian Laettner,C,26,ATL,30,977,159,325,0,8,159,317,107,130,425
1996,Andrew Lang,C,29,TOT,71,2365,353,790,1,5,352,785,125,156,832
1996,Andrew Lang,C,29,ATL,51,1815,281,619,0,3,281,616,95,118,657
1996,Andrew Lang,C,29,MIN,20,550,72,171,1,2,71,169,30,38,175
1996,Antonio Lang,SF,23,CLE,41,367,41,77,0,2,41,75,34,47,116
1996,Eric Leckner,C,29,DET,18,155,18,29,0,0,18,29,8,13,44
1996,Tim Legler,SG,29,WSB,77,1775,233,460,128,245,105,215,132,153,726
1996,Voshon Lenard,SG,22,MIA,30,323,53,141,36,101,17,40,34,43,176
1996,Cedric Lewis,C,26,WSB,3,4,2,3,0,0,2,3,0,0,4
1996,Martin Lewis,SF,20,TOR,16,189,29,60,2,7,27,53,15,25,75
1996,Alton Lister,C,37,TOT,64,735,51,105,0,0,51,105,41,64,143
1996,Alton Lister,C,37,MIL,7,88,4,9,0,0,4,9,2,2,10
1996,Alton Lister,C,37,BOS,57,647,47,96,0,0,47,96,39,62,133
1996,Brad Lohaus,PF,31,TOT,55,598,71,175,51,122,20,53,4,5,197
1996,Brad Lohaus,PF,31,SAS,32,273,39,96,27,65,12,31,2,3,107
1996,Brad Lohaus,PF,31,NYK,23,325,32,79,24,57,8,22,2,2,90
1996,Grant Long,PF,29,ATL,82,3008,395,838,31,86,364,752,257,337,1078
1996,Luc Longley,C,27,CHI,62,1641,242,502,0,0,242,502,80,103,564
1996,George Lynch,SF,25,LAL,76,1012,117,272,4,13,113,259,53,80,291
1996,Sam Mack,SF,25,HOU,31,868,121,287,54,135,67,152,39,46,335
1996,Don MacLean,SF,26,DEN,56,1107,233,547,14,49,219,498,145,198,625
1996,Mark Macon,PG,26,DET,23,287,29,67,7,15,22,52,9,11,74
1996,Rick Mahorn,C,37,NJN,50,450,43,122,0,1,43,121,34,47,120
1996,Dan Majerle,SF,30,CLE,82,2367,303,748,146,414,157,334,120,169,872
1996,Jeff Malone,SG,34,TOT,32,510,76,193,5,16,71,177,29,32,186
1996,Jeff Malone,SG,34,PHI,25,407,63,160,5,16,58,144,24,26,155
1996,Jeff Malone,SG,34,MIA,7,103,13,33,0,0,13,33,5,6,31
1996,Karl Malone*,PF,32,UTA,82,3113,789,1520,16,40,773,1480,512,708,2106
1996,Danny Manning,PF,29,PHO,33,816,178,388,3,14,175,374,82,109,441
1996,Rich Manning,PF,25,VAN,29,311,49,113,0,1,49,112,9,14,107
1996,Sarunas Marciulionis*,SG,31,SAC,53,1039,176,389,64,157,112,232,155,200,571
1996,Donny Marshall,SF,23,CLE,34,208,24,68,7,30,17,38,22,35,77
1996,Donyell Marshall,SF,22,GSW,62,934,125,314,28,94,97,220,64,83,342
1996,Cuonzo Martin,SG,24,VAN,4,19,3,5,3,3,0,2,0,2,9
1996,Darrick Martin,PG,24,TOT,59,1149,147,362,20,69,127,293,101,120,415
1996,Darrick Martin,PG,24,VAN,24,402,59,131,5,22,54,109,38,46,161
1996,Darrick Martin,PG,24,MIN,35,747,88,231,15,47,73,184,63,74,254
1996,Jamal Mashburn,SF,23,DAL,18,669,145,383,35,102,110,281,97,133,422
1996,Anthony Mason,SF,29,NYK,82,3457,449,798,0,0,449,798,298,414,1196
1996,Tony Massenburg,PF,28,TOT,54,1463,214,432,0,3,214,429,111,157,539
1996,Tony Massenburg,PF,28,TOR,24,659,100,196,0,0,100,196,43,65,243
1996,Tony Massenburg,PF,28,PHI,30,804,114,236,0,3,114,233,68,92,296
1996,Vernon Maxwell,PG,30,PHI,75,2467,410,1052,146,460,264,592,251,332,1217
1996,Lee Mayberry,PG,25,MIL,82,1705,153,364,75,189,78,175,41,68,422
1996,Bob McCann,PF,31,WSB,62,653,76,153,1,2,75,151,35,74,188
1996,George McCloud,SF,28,DAL,79,2846,530,1281,257,678,273,603,180,224,1497
1996,Clint McDaniel,SG,23,SAC,12,71,8,23,2,6,6,17,12,16,30
1996,Antonio McDyess,PF,21,DEN,76,2280,427,881,0,4,427,877,166,243,1020
1996,Jim McIlvaine,C,23,WSB,80,1195,62,145,0,0,62,145,58,105,182
1996,Derrick McKey,SF,29,IND,75,2440,346,712,17,68,329,644,170,221,879
1996,Aaron McKie,SG,23,POR,81,2259,337,722,38,117,299,605,152,199,864
1996,Nate McMillan,PG,31,SEA,55,1261,100,238,46,121,54,117,29,41,275
1996,Loren Meyer,C,23,DAL,72,1266,145,330,3,11,142,319,70,102,363
1996,Anthony Miller,PF,24,LAL,27,123,15,35,0,2,15,33,6,10,36
1996,Oliver Miller,PF,25,TOR,76,2516,418,795,0,11,418,784,146,221,982
1996,Reggie Miller*,SG,30,IND,76,2621,504,1066,168,410,336,656,430,498,1606
1996,Chris Mills,SF,26,CLE,80,3060,454,971,79,210,375,761,218,263,1205
1996,Terry Mills,PF,28,DET,82,1656,283,675,82,207,201,468,121,157,769
1996,Harold Miner,SG,24,CLE,19,136,23,52,2,10,21,42,13,13,61
1996,Greg Minor,SG,24,BOS,78,1761,320,640,7,27,313,613,99,130,746
1996,Sam Mitchell,SF,32,MIN,78,2145,303,618,1,18,302,600,237,291,844
1996,Eric Mobley,C,25,TOT,39,676,74,138,1,2,73,136,39,87,188
1996,Eric Mobley,C,25,MIL,5,65,2,7,0,0,2,7,2,4,6
1996,Eric Mobley,C,25,VAN,34,611,72,131,1,2,71,129,37,83,182
1996,Eric Montross,C,24,BOS,61,1432,196,346,0,0,196,346,50,133,442
1996,Tracy Moore,SG,30,HOU,8,190,30,76,13,30,17,46,18,19,91
1996,Chris Morris,SG,30,UTA,66,1424,265,606,63,197,202,409,98,127,691
1996,Lawrence Moten,SG,23,VAN,44,573,112,247,18,55,94,192,49,75,291
1996,Alonzo Mourning*,C,25,MIA,70,2671,563,1076,9,30,554,1046,488,712,1623
1996,Chris Mullin*,SF,32,GSW,55,1617,269,539,59,150,210,389,137,160,734
1996,Todd Mundt,C,25,TOT,33,151,16,41,0,0,16,41,5,8,37
1996,Todd Mundt,C,25,ATL,24,118,13,32,0,0,13,32,5,8,31
1996,Todd Mundt,C,25,BOS,9,33,3,9,0,0,3,9,0,0,6
1996,Eric Murdock,PG,27,TOT,73,1673,244,587,45,145,199,442,114,143,647
1996,Eric Murdock,PG,27,MIL,9,193,24,66,6,23,18,43,8,12,62
1996,Eric Murdock,PG,27,VAN,64,1480,220,521,39,122,181,399,106,131,585
1996,Gheorghe Muresan,C,24,WSB,76,2242,466,798,0,1,466,797,172,278,1104
1996,Lamond Murray,SF,22,LAC,77,1816,257,575,37,116,220,459,99,132,650
1996,Tracy Murray,SF,24,TOR,82,2458,496,1092,151,358,345,734,182,219,1325
1996,Dikembe Mutombo*,C,29,DEN,74,2713,284,569,0,1,284,568,246,354,814
1996,Pete Myers,SG,32,TOT,71,1092,91,247,14,58,77,189,80,122,276
1996,Pete Myers,SG,32,MIA,39,639,62,160,11,42,51,118,49,76,184
1996,Pete Myers,SG,32,CHH,32,453,29,87,3,16,26,71,31,46,92
1996,Howard Nathan,PG,24,ATL,5,15,5,9,0,1,5,8,3,4,13
1996,Johnny Newman,SG,32,MIL,82,2690,321,649,61,162,260,487,186,232,889
1996,Ken Norman,SF,31,ATL,34,770,127,273,33,84,94,189,17,48,304
1996,Ed O'Bannon,SG,23,NJN,64,1253,156,400,10,56,146,344,77,108,399
1996,Shaquille O'Neal*,C,23,ORL,54,1946,592,1033,1,2,591,1031,249,511,1434
1996,Dan O'Sullivan,C,27,TOR,5,139,13,35,0,1,13,34,7,8,33
1996,Charles Oakley,PF,32,NYK,53,1775,211,448,7,26,204,422,175,210,604
1996,Hakeem Olajuwon*,C,33,HOU,72,2797,768,1494,3,14,765,1480,397,548,1936
1996,Greg Ostertag,C,22,UTA,57,661,86,182,0,0,86,182,36,54,208
1996,Bo Outlaw,PF,24,LAC,80,985,107,186,0,3,107,183,72,162,286
1996,Doug Overton,PG,26,DEN,55,607,67,178,8,26,59,152,40,55,182
1996,Billy Owens,SF,26,TOT,62,1982,323,673,5,18,318,655,157,247,808
1996,Billy Owens,SF,26,MIA,40,1388,239,473,0,6,239,467,112,177,590
1996,Billy Owens,SF,26,SAC,22,594,84,200,5,12,79,188,45,70,218
1996,Robert Pack,PG,26,WSB,31,1084,190,444,26,98,164,346,154,182,560
1996,Robert Parish*,C,42,CHH,74,1086,120,241,0,0,120,241,50,71,290
1996,Cherokee Parks,C,23,DAL,64,869,101,247,7,26,94,221,41,62,250
1996,Gary Payton*,PG,27,SEA,81,3162,618,1276,98,299,520,977,229,306,1563
1996,Anthony Peeler,SG,26,LAL,73,1608,272,602,105,254,167,348,61,86,710
1996,Mike Peplowski,C,25,TOT,7,17,3,5,0,0,3,5,1,3,7
1996,Mike Peplowski,C,25,WSB,2,5,0,0,0,0,0,0,0,0,0
1996,Mike Peplowski,C,25,MIL,5,12,3,5,0,0,3,5,1,3,7
1996,Will Perdue,C,30,SAS,80,1396,173,331,0,1,173,330,67,125,413
1996,Sam Perkins,PF,34,SEA,82,2169,325,797,129,363,196,434,191,241,970
1996,Elliot Perry,PG,26,PHO,81,1668,261,549,24,59,237,490,151,194,697
1996,Tim Perry,PF,30,TOT,30,254,31,65,4,8,27,57,5,9,71
1996,Tim Perry,PF,30,PHI,8,87,8,18,1,1,7,17,2,3,19
1996,Tim Perry,PF,30,NJN,22,167,23,47,3,7,20,40,3,6,52
1996,Chuck Person,SF,31,SAS,80,2131,308,705,190,463,118,242,67,104,873
1996,Wesley Person,SG,24,PHO,82,2609,390,877,117,313,273,564,148,192,1045
1996,Bobby Phills,SG,26,CLE,72,2530,386,826,93,211,293,615,186,240,1051
1996,Eric Piatkowski,SG,25,LAC,65,784,98,242,38,114,60,128,67,82,301
1996,Ricky Pierce,SG,36,IND,76,1404,264,590,35,104,229,486,174,205,737
1996,Ed Pinckney,PF,32,TOT,74,1710,171,335,0,3,171,332,136,179,478
1996,Ed Pinckney,PF,32,TOR,47,1031,117,233,0,3,117,230,94,124,328
1996,Ed Pinckney,PF,32,PHI,27,679,54,102,0,0,54,102,42,55,150
1996,Scottie Pippen*,SF,30,CHI,77,2825,563,1216,150,401,413,815,220,324,1496
1996,Olden Polynice,C,31,SAC,81,2441,431,818,1,3,430,815,122,203,985
1996,Terry Porter,PG,32,MIN,82,2072,269,608,71,226,198,382,164,209,773
1996,Brent Price,PG,27,WSB,81,2042,252,534,139,301,113,233,167,191,810
1996,Mark Price,PG,31,WSB,7,127,18,60,10,30,8,30,10,10,56
1996,Kevin Pritchard,PG,28,WSB,2,22,2,3,1,1,1,2,2,3,7
1996,Dino Radja,PF,28,BOS,53,1984,426,852,0,0,426,852,191,275,1043
1996,Theo Ratliff,C,22,DET,75,1305,128,230,0,1,128,229,85,120,341
1996,Eldridge Recasner,SG,28,HOU,63,1275,149,359,81,191,68,168,57,66,436
1996,Bryant Reeves,C,22,VAN,77,2460,401,877,0,3,401,874,219,299,1021
1996,Khalid Reeves,PG,23,TOT,51,833,95,227,28,91,67,136,61,82,279
1996,Khalid Reeves,PG,23,CHH,20,418,54,118,11,36,43,82,43,51,162
1996,Khalid Reeves,PG,23,NJN,31,415,41,109,17,55,24,54,18,31,117
1996,Don Reid,PF,22,DET,69,997,106,187,0,0,106,187,51,77,263
1996,J.R. Reid,PF,27,TOT,65,1313,160,324,0,1,160,323,107,142,427
1996,J.R. Reid,PF,27,SAS,32,643,72,164,0,1,72,163,64,87,208
1996,J.R. Reid,PF,27,NYK,33,670,88,160,0,0,88,160,43,55,219
1996,Terrence Rencher,PG,22,TOT,36,405,33,100,9,29,24,71,31,46,106
1996,Terrence Rencher,PG,22,MIA,34,397,32,99,9,29,23,70,30,43,103
1996,Terrence Rencher,PG,22,PHO,2,8,1,1,0,0,1,1,1,3,3
1996,Shawn Respert,SG,23,MIL,62,845,113,292,42,122,71,170,35,42,303
1996,Jerry Reynolds,SF,33,MIL,19,191,21,53,1,10,20,43,13,21,56
1996,Glen Rice,SF,28,CHH,79,3142,610,1296,171,403,439,893,319,381,1710
1996,Pooh Richardson,PG,29,LAC,63,2013,281,664,94,245,187,419,78,105,734
1996,Mitch Richmond*,SG,30,SAC,81,2946,611,1368,225,515,386,853,425,491,1872
1996,Isaiah Rider,SG,24,MIN,75,2594,560,1206,102,275,458,931,248,296,1470
1996,Eric Riley,C,25,MIN,25,310,35,74,0,1,35,73,22,28,92
1996,Doc Rivers,PG,34,SAS,78,1235,108,290,47,137,61,153,48,64,311
1996,Fred Roberts,C,35,LAL,33,317,48,97,4,14,44,83,22,28,122
1996,Stanley Roberts,C,25,LAC,51,795,141,304,0,0,141,304,74,133,356
1996,Alvin Robertson,SG,33,TOR,77,2478,285,607,41,151,244,456,107,158,718
1996,Clifford Robinson,SF,29,POR,78,2980,553,1306,178,471,375,835,360,542,1644
1996,David Robinson*,C,30,SAS,82,3019,711,1378,3,9,708,1369,626,823,2051
1996,Glenn Robinson,SF,23,MIL,82,3249,627,1382,90,263,537,1119,316,389,1660
1996,James Robinson,PG,25,POR,76,1627,229,574,102,284,127,290,89,135,649
1996,Rumeal Robinson,PG,29,POR,43,715,92,221,30,79,62,142,33,51,247
1996,Dennis Rodman*,PF,34,CHI,64,2088,146,304,3,27,143,277,56,106,351
1996,Lou Roe,SF,23,DET,49,372,32,90,2,9,30,81,24,32,90
1996,Carlos Rogers,PF,24,TOR,56,1043,178,344,3,21,175,323,71,130,430
1996,Rodney Rogers,SF,24,LAC,67,1950,306,641,49,153,257,488,113,180,774
1996,Sean Rooks,C,26,TOT,65,1117,144,285,1,7,143,278,135,202,424
1996,Sean Rooks,C,26,MIN,49,902,112,227,1,6,111,221,106,159,331
1996,Sean Rooks,C,26,ATL,16,215,32,58,0,1,32,57,29,43,93
1996,Jalen Rose,SG,23,DEN,80,2134,290,604,32,108,258,496,191,277,803
1996,Donald Royal,SF,29,ORL,64,963,106,216,0,2,106,214,125,164,337
1996,Clifford Rozier,C,23,GSW,59,723,79,135,0,2,79,133,26,55,184
1996,Trevor Ruffin,PG,25,PHI,61,1551,263,648,104,284,159,364,148,182,778
1996,Stefano Rusconi,PF,27,PHO,7,30,3,9,0,0,3,9,2,5,8
1996,Bryon Russell,SF,25,UTA,59,577,56,142,14,40,42,102,48,67,174
1996,Arvydas Sabonis*,C,31,POR,73,1735,394,723,39,104,355,619,231,305,1058
1996,John Salley,PF,31,TOT,42,673,63,140,0,0,63,140,59,85,185
1996,John Salley,PF,31,TOR,25,482,51,105,0,0,51,105,47,65,149
1996,John Salley,PF,31,CHI,17,191,12,35,0,0,12,35,12,20,36
1996,Danny Schayes,C,36,MIA,32,399,32,94,0,0,32,94,37,46,101
1996,Steve Scheffler,C,28,SEA,35,181,24,45,1,5,23,40,9,19,58
1996,Dwayne Schintzius,C,27,IND,33,297,49,110,0,0,49,110,13,21,111
1996,Detlef Schrempf,SF,33,SEA,63,2200,360,740,73,179,287,561,287,370,1080
1996,Byron Scott,SG,34,VAN,80,1894,271,676,74,221,197,455,203,243,819
1996,Dennis Scott,SF,27,ORL,82,3041,491,1117,267,628,224,489,182,222,1431
1996,Malik Sealy,SF,25,LAC,62,1601,272,655,21,100,251,555,147,184,712
1996,Rony Seikaly,C,30,GSW,64,1813,285,568,2,3,283,565,204,282,776
1996,Brian Shaw,PG,29,ORL,75,1679,182,486,41,144,141,342,91,114,496
1996,Lionel Simmons,SF,27,SAC,54,810,86,217,19,51,67,166,55,75,246
1996,Dickey Simpkins,PF,23,CHI,60,685,77,160,1,1,76,159,61,97,216
1996,Scott Skiles,PG,31,PHI,10,236,20,57,15,34,5,23,8,10,63
1996,Reggie Slater,PF,25,TOT,11,72,14,27,0,0,14,27,3,7,31
1996,Reggie Slater,PF,25,POR,4,20,3,5,0,0,3,5,0,0,6
1996,Reggie Slater,PF,25,DEN,4,26,6,11,0,0,6,11,2,5,14
1996,Reggie Slater,PF,25,DAL,3,26,5,11,0,0,5,11,1,2,11
1996,Charles Smith,PG,28,MIN,8,39,3,10,0,3,3,7,0,2,6
1996,Charles Smith,PF,30,TOT,73,1716,244,578,2,15,242,563,119,163,609
1996,Charles Smith,PF,30,NYK,41,890,114,294,2,15,112,279,73,103,303
1996,Charles Smith,PF,30,SAS,32,826,130,284,0,0,130,284,46,60,306
1996,Doug Smith,PF,26,BOS,17,92,14,39,0,0,14,39,5,8,33
1996,Joe Smith,PF,20,GSW,82,2821,469,1024,10,28,459,996,303,392,1251
1996,Kenny Smith,PG,30,HOU,68,1617,201,464,91,238,110,226,87,106,580
1996,Michael Smith,PF,23,SAC,65,1384,144,238,1,1,143,237,68,177,357
1996,Steve Smith,SG,26,ATL,80,2856,494,1143,140,423,354,720,318,385,1446
1996,Tony Smith,SG,27,TOT,59,938,116,274,38,116,78,158,28,46,298
1996,Tony Smith,SG,27,PHO,34,528,70,173,25,77,45,96,24,37,189
1996,Tony Smith,SG,27,MIA,25,410,46,101,13,39,33,62,4,9,109
1996,Rik Smits,C,29,IND,63,1901,466,894,1,5,465,889,231,293,1164
1996,Eric Snow,PG,22,SEA,43,389,42,100,2,10,40,90,29,49,115
1996,Elmore Spencer,C,26,TOT,17,58,5,13,0,0,5,13,4,6,14
1996,Elmore Spencer,C,26,DEN,6,21,0,1,0,0,0,1,0,0,0
1996,Elmore Spencer,C,26,POR,11,37,5,12,0,0,5,12,4,6,14
1996,Felton Spencer,C,28,UTA,71,1267,146,281,0,0,146,281,104,151,396
1996,Latrell Sprewell,SG,25,GSW,78,3064,515,1202,91,282,424,920,352,446,1473
1996,Jerry Stackhouse,SG,21,PHI,72,2701,452,1091,93,292,359,799,387,518,1384
1996,John Starks,SG,30,NYK,81,2491,375,846,143,396,232,450,131,174,1024
1996,Bryant Stith,SG,25,DEN,82,2810,379,911,41,148,338,763,320,379,1119
1996,John Stockton*,PG,33,UTA,82,2915,440,818,95,225,345,593,234,282,1209
1996,Damon Stoudamire,PG,22,TOR,70,2865,481,1129,133,337,348,792,236,296,1331
1996,Rod Strickland,PG,29,POR,67,2526,471,1023,38,111,433,912,276,423,1256
1996,Derek Strong,PF,27,LAL,63,746,72,169,1,9,71,160,69,85,214
1996,Bob Sura,SG,22,CLE,79,1150,148,360,27,78,121,282,99,141,422
1996,Greg Sutton,PG,28,TOT,48,655,85,217,47,117,38,100,35,46,252
1996,Greg Sutton,PG,28,CHH,18,190,20,50,7,21,13,29,15,19,62
1996,Greg Sutton,PG,28,PHI,30,465,65,167,40,96,25,71,20,27,190
1996,Larry Sykes,PF,22,BOS,1,2,0,0,0,0,0,0,0,0,0
1996,Zan Tabak,C,25,TOR,67,1332,225,414,0,1,225,413,64,114,514
1996,Kurt Thomas,PF,23,MIA,74,1655,274,547,0,2,274,545,118,178,666
1996,Brooks Thompson,PG,25,ORL,33,246,48,103,25,64,23,39,19,27,140
1996,LaSalle Thompson,C,34,PHI,44,773,33,83,0,0,33,83,19,24,85
1996,Bob Thornton,PF,33,WSB,7,31,1,6,0,0,1,6,1,2,3
1996,Otis Thorpe,PF,33,DET,82,2841,452,853,0,4,452,849,257,362,1161
1996,Sedale Threatt,PG,34,LAL,82,1687,241,526,60,169,181,357,54,71,596
1996,Wayman Tisdale,PF,31,PHO,63,1152,279,564,0,0,279,564,114,149,672
1996,Andy Toolson,SF,30,UTA,13,53,8,22,3,12,5,10,3,4,22
1996,Keith Tower,C,25,LAC,34,305,32,72,0,1,32,71,18,26,82
1996,Gary Trent,PF,21,POR,69,1219,220,429,0,9,220,420,78,141,518
1996,Jeff Turner,PF,33,ORL,13,192,18,51,9,27,9,24,2,2,47
1996,Nick Van,PG,24,LAL,74,2513,396,950,144,403,252,547,163,204,1099
1996,Logan Vander,SF,24,LAC,15,31,3,14,0,5,3,9,3,4,9
1996,David Vaughn,PF,22,ORL,33,266,27,80,0,1,27,79,10,18,64
1996,Loy Vaught,PF,27,LAC,80,2966,571,1087,7,19,564,1068,149,205,1298
1996,Rasheed Wallace,PF,21,WSB,65,1788,275,565,27,82,248,483,78,120,655
1996,Rex Walters,SG,25,TOT,44,610,61,148,22,66,39,82,42,52,186
1996,Rex Walters,SG,25,NJN,11,87,12,33,3,12,9,21,6,6,33
1996,Rex Walters,SG,25,PHI,33,523,49,115,19,54,30,61,36,46,153
1996,Charlie Ward,PG,25,NYK,62,787,87,218,33,99,54,119,37,54,244
1996,Jamie Watson,SF,23,UTA,16,217,18,43,3,7,15,36,9,13,48
1996,Clarence Weatherspoon,SF,25,PHI,78,3096,491,1015,0,2,491,1013,318,426,1300
1996,Spud Webb,PG,32,TOT,77,1462,186,430,47,129,139,301,125,145,544
1996,Spud Webb,PG,32,ATL,51,817,104,222,18,57,86,165,74,87,300
1996,Spud Webb,PG,32,MIN,26,645,82,208,29,72,53,136,51,58,244
1996,Chris Webber,PF,22,WSB,15,558,150,276,15,34,135,242,41,69,356
1996,Jeff Webster,SF,24,WSB,11,58,8,23,2,6,6,17,0,0,18
1996,Bill Wennington,C,32,CHI,71,1065,169,343,1,1,168,342,37,43,376
1996,Robert Werdann,C,25,NJN,13,93,16,32,0,0,16,32,7,13,39
1996,David Wesley,PG,25,BOS,82,2104,338,736,116,272,222,464,217,288,1009
1996,Doug West,SG,28,MIN,73,1639,175,393,1,13,174,380,114,144,465
1996,Mark West,C,35,DET,47,682,61,126,0,0,61,126,28,45,150
1996,Dwayne Whitfield,PF,23,TOR,8,122,13,30,0,0,13,30,14,22,40
1996,Chris Whitney,PG,24,WSB,21,335,45,99,19,44,26,55,41,44,150
1996,Gerald Wilkins,SG,32,VAN,28,738,77,205,14,64,63,141,20,23,188
1996,Buck Williams,PF,35,POR,70,1672,192,384,2,3,190,381,125,187,511
1996,Eric Williams,SF,23,BOS,64,1470,241,546,3,10,238,536,200,298,685
1996,Herb Williams,PF-C,37,TOT,44,571,62,152,1,4,61,148,13,20,138
1996,Herb Williams,C,37,TOR,1,31,3,8,0,0,3,8,0,0,6
1996,Herb Williams,PF,37,NYK,43,540,59,144,1,4,58,140,13,20,132
1996,Hot Rod,C,33,PHO,62,1652,180,397,0,1,180,396,95,130,455
1996,Jayson Williams,PF,27,NJN,80,1858,279,660,2,7,277,653,161,272,721
1996,Lorenzo Williams,C,26,DAL,65,1806,87,214,0,1,87,213,24,70,198
1996,Micheal Williams,PG,29,MIN,9,189,13,40,1,3,12,37,28,33,55
1996,Monty Williams,SF,24,TOT,31,184,27,68,0,1,27,67,14,20,68
1996,Monty Williams,SF,24,NYK,14,62,7,22,0,0,7,22,5,8,19
1996,Monty Williams,SF,24,SAS,17,122,20,46,0,1,20,45,9,12,49
1996,Reggie Williams,SF,31,DEN,52,817,94,254,20,89,74,165,33,39,241
1996,Scott Williams,PF,27,PHI,13,193,15,29,0,2,15,27,10,12,40
1996,Walt Williams,SF,25,TOT,73,2169,359,808,114,293,245,515,163,232,995
1996,Walt Williams,SF,25,SAC,45,1381,235,540,58,170,177,370,130,172,658
1996,Walt Williams,SF,25,MIA,28,788,124,268,56,123,68,145,33,60,337
1996,Corliss Williamson,SF,22,SAC,53,609,125,268,0,3,125,265,47,84,297
1996,Kevin Willis,PF,33,TOT,75,2135,325,712,1,9,324,703,143,202,794
1996,Kevin Willis,PF,33,MIA,47,1357,195,412,0,5,195,407,89,125,479
1996,Kevin Willis,PF,33,GSW,28,778,130,300,1,4,129,296,54,77,315
1996,Trevor Wilson,PF,27,PHI,6,79,10,20,0,0,10,20,3,4,23
1996,David Wingate,SG,32,SEA,60,695,88,212,15,34,73,178,32,41,223
1996,Dontonio Wingfield,SF,21,POR,44,487,60,157,19,63,41,94,26,34,165
1996,Joe Wolf,PF,31,TOT,64,1065,135,263,0,6,135,257,21,29,291
1996,Joe Wolf,PF,31,CHH,1,18,0,1,0,0,0,1,0,0,0
1996,Joe Wolf,PF,31,ORL,63,1047,135,262,0,6,135,256,21,29,291
1996,David Wood,PF,31,TOT,62,772,75,174,20,62,55,112,38,50,208
1996,David Wood,PF,31,GSW,21,96,7,14,1,3,6,11,7,8,22
1996,David Wood,PF,31,PHO,4,34,1,6,0,0,1,6,2,2,4
1996,David Wood,PF,31,DAL,37,642,67,154,19,59,48,95,29,40,182
1996,Randy Woods,PG,25,DEN,8,72,6,22,5,21,1,1,2,2,19
1996,Haywoode Workman,PG,30,IND,77,1164,101,259,23,71,78,188,54,73,279
1996,Sharone Wright,C,23,TOT,57,1434,248,512,1,3,247,509,167,259,664
1996,Sharone Wright,C,23,PHI,46,1136,183,384,0,0,183,384,117,186,483
1996,Sharone Wright,C,23,TOR,11,298,65,128,1,3,64,125,50,73,181
1996,George Zidek,C,22,CHH,71,888,105,248,0,0,105,248,71,93,281
,,,,,,,,,,,,,,,
1997,Mahmoud Abdul-Rauf,PG,27,SAC,75,2131,411,924,94,246,317,678,115,136,1031
1997,Shareef Abdur-Rahim,PF,20,VAN,80,2802,550,1214,7,27,543,1187,387,519,1494
1997,Rafael Addison,SF,32,CHH,41,355,49,122,8,20,41,102,22,28,128
1997,Cory Alexander,PG,23,SAS,80,1454,194,490,94,252,100,238,95,129,577
1997,Jerome Allen,SG,24,TOT,76,943,78,221,30,93,48,128,42,72,228
1997,Jerome Allen,SG,24,IND,51,692,57,147,23,59,34,88,27,47,164
1997,Jerome Allen,SG,24,DEN,25,251,21,74,7,34,14,40,15,25,64
1997,Ray Allen,SG,21,MIL,82,2532,390,908,117,298,273,610,205,249,1102
1997,Derrick Alston,C,24,ATL,2,11,0,5,0,0,0,5,0,2,0
1997,Ashraf Amaya,PF,25,WSB,31,144,12,40,1,1,11,39,15,28,40
1997,Greg Anderson,C,32,SAS,82,1659,130,262,0,1,130,261,62,93,322
1997,Kenny Anderson,PG,26,POR,82,3081,485,1137,132,366,353,771,334,435,1436
1997,Nick Anderson,SG,29,ORL,63,2163,288,725,143,405,145,320,38,94,757
1997,Shandon Anderson,SG,23,UTA,65,1066,147,318,24,47,123,271,68,99,386
1997,Willie Anderson,SG,30,MIA,28,303,29,64,8,19,21,45,17,20,83
1997,Greg Anthony,PG,29,VAN,65,1863,199,507,88,238,111,269,130,178,616
1997,B.J. Armstrong,PG,29,GSW,49,1020,148,327,25,90,123,237,68,79,389
1997,Darrell Armstrong,PG,28,ORL,67,1010,132,345,55,181,77,164,92,106,411
1997,Vincent Askew,SG,30,TOT,43,838,81,186,7,24,74,162,70,88,239
1997,Vincent Askew,SG,30,NJN,1,7,0,0,0,0,0,0,0,0,0
1997,Vincent Askew,SG,30,IND,41,822,79,183,7,24,72,159,68,86,233
1997,Vincent Askew,SG,30,DEN,1,9,2,3,0,0,2,3,2,2,6
1997,Keith Askins,SF,29,MIA,78,1773,138,319,69,172,69,147,39,58,384
1997,Stacey Augmon,SG,28,TOT,60,942,105,220,0,0,105,220,69,97,279
1997,Stacey Augmon,SG,28,DET,20,292,31,77,0,0,31,77,28,41,90
1997,Stacey Augmon,SG,28,POR,40,650,74,143,0,0,74,143,41,56,189
1997,Isaac Austin,C,27,MIA,82,1881,321,639,0,3,321,636,150,226,792
1997,Vin Baker,PF,25,MIL,78,3159,632,1251,15,54,617,1197,358,521,1637
1997,Charles Barkley*,PF,33,HOU,53,2009,335,692,58,205,277,487,288,415,1016
1997,Dana Barros,PG,29,BOS,24,708,110,253,43,105,67,148,37,43,300
1997,Brent Barry,SG,25,LAC,59,1094,155,379,56,173,99,206,76,93,442
1997,Jon Barry,SG,27,ATL,58,965,100,246,48,124,52,122,37,46,285
1997,Benoit Benjamin,C,32,TOR,4,44,5,12,0,0,5,12,3,4,13
1997,Elmer Bennett,PG,26,TOT,9,75,6,19,3,9,3,10,7,10,22
1997,Elmer Bennett,PG,26,HOU,4,16,2,6,1,3,1,3,5,6,10
1997,Elmer Bennett,PG,26,DEN,5,59,4,13,2,6,2,7,2,4,12
1997,Travis Best,PG,24,IND,76,2064,274,620,57,155,217,465,149,197,754
1997,Mookie Blaylock,PG,29,ATL,78,3056,501,1159,221,604,280,555,131,174,1354
1997,Corie Blount,PF,28,LAL,58,1009,92,179,1,3,91,176,56,83,241
1997,Muggsy Bogues,PG,32,CHH,65,1880,204,443,60,144,144,299,54,64,522
1997,Dexter Boney,SG,26,PHO,8,48,6,19,1,6,5,13,6,8,19
1997,Melvin Booker,PG,24,TOT,21,430,46,105,12,37,34,68,18,20,122
1997,Melvin Booker,PG,24,DEN,5,21,2,4,1,2,1,2,0,0,5
1997,Melvin Booker,PG,24,GSW,16,409,44,101,11,35,33,66,18,20,117
1997,Bruce Bowen,SF,25,MIA,1,1,0,0,0,0,0,0,0,0,0
1997,Donnie Boyce,SG,23,ATL,22,154,21,63,2,16,19,47,11,22,55
1997,Shawn Bradley,C,24,TOT,73,2288,406,905,0,8,406,897,149,228,961
1997,Shawn Bradley,C,24,NJN,40,1228,199,456,0,5,199,451,81,122,479
1997,Shawn Bradley,C,24,DAL,33,1060,207,449,0,3,207,446,68,106,482
1997,Mark Bradtke,C,28,PHI,36,251,25,58,0,0,25,58,9,13,59
1997,Terrell Brandon,PG,26,CLE,78,2868,575,1313,101,271,474,1042,268,297,1519
1997,Frank Brickowski,PF,37,BOS,17,255,32,73,7,20,25,53,10,14,81
1997,Scott Brooks,PG,31,NYK,38,251,19,39,5,12,14,27,14,15,57
1997,Chucky Brown,SF,28,TOT,70,757,78,154,1,6,77,148,47,70,204
1997,Chucky Brown,SF,28,PHO,10,83,13,26,0,0,13,26,8,11,34
1997,Chucky Brown,SF,28,MIL,60,674,65,128,1,6,64,122,39,59,170
1997,Dee Brown,PG,28,BOS,21,522,61,166,20,65,41,101,18,22,160
1997,Marcus Brown,PG,22,POR,21,184,28,70,13,32,15,38,13,19,82
1997,Mike Brown,C,33,PHO,6,83,5,12,0,0,5,12,6,10,16
1997,P.J. Brown,PF,27,MIA,80,2592,300,656,0,2,300,654,161,220,761
1997,Randy Brown,PG,28,CHI,72,1057,140,333,4,22,136,311,57,84,341
1997,Kobe Bryant,SG,18,LAL,71,1103,176,422,51,136,125,286,136,166,539
1997,Mark Bryant,PF,31,PHO,41,1018,152,275,0,0,152,275,76,108,380
1997,Jud Buechler,SF,28,CHI,76,703,58,158,18,54,40,104,5,14,139
1997,Matt Bullard,PF,29,HOU,71,1025,114,284,67,183,47,101,25,34,320
1997,Scott Burrell,SF,26,TOT,57,939,98,271,41,116,57,155,57,76,294
1997,Scott Burrell,SF,26,CHH,28,482,45,131,19,55,26,76,42,53,151
1997,Scott Burrell,SF,26,GSW,29,457,53,140,22,61,31,79,15,23,143
1997,Willie Burton,SF,28,ATL,24,380,39,116,13,46,26,70,57,68,148
1997,Mitchell Butler,SG,26,POR,49,465,52,125,12,39,40,86,32,50,148
1997,Jason Caffey,PF,23,CHI,75,1405,205,385,0,1,205,384,139,211,549
1997,Michael Cage,C,35,PHI,82,1247,66,141,0,0,66,141,19,41,151
1997,Adrian Caldwell,PF,30,TOT,45,569,40,92,0,2,40,90,21,50,101
1997,Adrian Caldwell,PF,30,NJN,18,204,10,35,0,2,10,33,9,17,29
1997,Adrian Caldwell,PF,30,PHI,27,365,30,57,0,0,30,57,12,33,72
1997,Marcus Camby,C,22,TOR,63,1897,375,778,2,14,373,764,183,264,935
1997,Elden Campbell,PF,28,LAL,77,2516,442,942,1,4,441,938,263,370,1148
1997,Antoine Carr,PF,35,UTA,82,1460,252,522,0,3,252,519,99,127,603
1997,Chris Carr,SG,22,MIN,55,830,125,271,31,88,94,183,56,73,337
1997,Jimmy Carruth,PF,27,MIL,4,21,2,3,0,0,2,3,1,1,5
1997,Sam Cassell,PG,27,TOT,61,1714,337,783,81,231,256,552,212,251,967
1997,Sam Cassell,PG,27,PHO,22,539,100,241,19,62,81,179,106,124,325
1997,Sam Cassell,PG,27,DAL,16,398,70,165,15,49,55,116,42,50,197
1997,Sam Cassell,PG,27,NJN,23,777,167,377,47,120,120,257,64,77,445
1997,Duane Causwell,C,28,SAC,46,581,48,94,2,3,46,91,20,37,118
1997,Cedric Ceballos,SF,27,TOT,50,1426,282,617,26,102,256,515,139,186,729
1997,Cedric Ceballos,SF,27,LAL,8,279,34,83,5,21,29,62,13,15,86
1997,Cedric Ceballos,SF,27,PHO,42,1147,248,534,21,81,227,453,126,171,643
1997,Tom Chambers,PF,37,CHH,12,83,7,31,2,3,5,28,3,4,19
1997,Rex Chapman,SG,29,PHO,65,1833,332,749,110,314,222,435,124,149,898
1997,Calbert Cheaney,SG,25,WSB,79,2411,369,730,4,30,365,700,95,137,837
1997,Pete Chilcutt,PF,28,VAN,54,662,72,165,25,69,47,96,13,22,182
1997,Randolph Childress,PG,24,TOT,23,155,14,40,5,19,9,21,6,8,39
1997,Randolph Childress,PG,24,POR,19,125,10,30,3,16,7,14,6,8,29
1997,Randolph Childress,PG,24,DET,4,30,4,10,2,3,2,7,0,0,10
1997,Chris Childs,PG,29,NYK,65,2076,211,510,70,181,141,329,113,149,605
1997,Doug Christie,SG,26,TOR,81,3127,396,949,147,383,249,566,237,306,1176
1997,Derrick Coleman,PF,29,PHI,57,2102,364,836,32,119,332,717,272,365,1032
1997,Bimbo Coles,PG,28,GSW,51,1183,122,314,30,102,92,212,37,49,311
1997,Marty Conlon,C,29,BOS,74,1614,214,454,2,10,212,444,144,171,574
1997,Tyrone Corbin,SF,34,ATL,70,2305,253,600,74,208,179,392,86,108,666
1997,Joe Courtney,PF,27,TOT,9,100,11,30,0,0,11,30,3,5,25
1997,Joe Courtney,PF,27,PHI,4,52,6,14,0,0,6,14,0,0,12
1997,Joe Courtney,PF,27,SAS,5,48,5,16,0,0,5,16,3,5,13
1997,John Crotty,PG,27,MIA,48,659,79,154,20,49,59,105,54,64,232
1997,Terry Cummings,PF,35,SEA,45,828,155,319,3,5,152,314,57,82,370
1997,Earl Cureton,PF,39,TOR,9,46,3,8,0,0,3,8,1,3,7
1997,Dell Curry,SG,32,CHH,68,2078,384,836,126,296,258,540,114,142,1008
1997,Michael Curry,SG,28,DET,81,1217,99,221,23,77,76,144,97,108,318
1997,Erick Dampier,C,21,IND,72,1052,131,336,1,1,130,335,107,168,370
1997,Lloyd Daniels,SG,29,TOT,22,310,36,119,21,70,15,49,5,6,98
1997,Lloyd Daniels,SG,29,SAC,5,28,2,16,2,11,0,5,0,0,6
1997,Lloyd Daniels,SG,29,NJN,17,282,34,103,19,59,15,44,5,6,92
1997,Sasha Danilovic,SG,26,TOT,56,1789,248,570,85,236,163,334,121,151,702
1997,Sasha Danilovic,SG,26,MIA,43,1351,175,396,63,176,112,220,73,94,486
1997,Sasha Danilovic,SG,26,DAL,13,438,73,174,22,60,51,114,48,57,216
1997,Yinka Dare,C,24,NJN,41,313,19,54,0,0,19,54,19,37,57
1997,Antonio Davis,PF,28,IND,82,2335,308,641,1,14,307,627,241,362,858
1997,Ben Davis,PF,24,PHO,20,98,10,26,0,0,10,26,9,20,29
1997,Dale Davis,PF,27,IND,80,2589,370,688,0,0,370,688,92,215,832
1997,Emanual Davis,PG,28,HOU,13,230,24,54,12,27,12,27,5,8,65
1997,Hubert Davis,SG,26,TOR,36,623,74,184,16,70,58,114,17,23,181
1997,Mark Davis,SF,23,PHI,75,1705,251,535,24,93,227,442,113,168,639
1997,Todd Day,SG,27,BOS,81,2277,398,999,126,348,272,651,256,331,1178
1997,Andrew DeClercq,C,23,GSW,71,1065,142,273,0,0,142,273,91,151,375
1997,Terry Dehere,PG,25,LAC,73,1053,148,383,52,160,96,223,122,148,470
1997,Vinny Del,SG,30,SAS,72,2243,365,781,44,140,321,641,112,129,886
1997,Bison Dele,C,27,CHI,9,138,26,63,0,0,26,63,11,15,63
1997,Tony Delk,PG,23,CHH,61,867,119,256,52,112,67,144,42,51,332
1997,Dell Demps,SG,26,ORL,2,10,0,3,0,1,0,2,2,2,2
1997,Vlade Divac,C,28,CHH,81,2840,418,847,11,47,407,800,177,259,1024
1997,Aleksandar Djordjevic,SG,29,POR,8,61,8,16,5,7,3,9,4,5,25
1997,Sherman Douglas,PG,30,MIL,79,2316,306,610,38,114,268,496,114,171,764
1997,Greg Dreiling,C,34,DAL,40,389,34,74,1,1,33,73,11,27,80
1997,Clyde Drexler*,SG,34,HOU,62,2271,397,899,119,335,278,564,201,268,1114
1997,Nate Driggers,SG,23,BOS,15,132,13,43,0,9,13,34,10,14,36
1997,Kevin Duckworth,C,32,LAC,26,384,45,103,3,4,42,99,11,16,104
1997,Chris Dudley,C,31,POR,81,1840,126,293,0,0,126,293,65,137,317
1997,Joe Dumars*,SG,33,DET,79,2923,385,875,166,384,219,491,222,256,1158
1997,Tony Dumas,SG,24,TOT,24,278,33,96,4,28,29,68,16,25,86
1997,Tony Dumas,SG,24,DAL,18,227,27,77,3,24,24,53,15,23,72
1997,Tony Dumas,SG,24,PHO,6,51,6,19,1,4,5,15,1,2,14
1997,Acie Earl,C,26,TOT,47,500,67,180,0,5,67,175,54,84,188
1997,Acie Earl,C,26,TOR,38,457,59,157,0,5,59,152,44,70,162
1997,Acie Earl,C,26,MIL,9,43,8,23,0,0,8,23,10,14,26
1997,Tyus Edney,PG,23,SAC,70,1376,150,391,8,42,142,349,177,215,485
1997,Blue Edwards,SF,31,VAN,61,1439,182,458,25,89,157,369,89,109,478
1997,Kevin Edwards,PG,31,NJN,32,477,69,183,15,43,54,140,37,43,190
1997,Craig Ehlo,SG,35,SEA,62,848,87,248,27,95,60,153,13,26,214
1997,Howard Eisley,PG,24,UTA,82,1083,139,308,20,72,119,236,70,89,368
1997,Mario Elie,SF,33,HOU,78,2687,291,585,120,286,171,299,207,231,909
1997,Sean Elliott,SF,28,SAS,39,1393,196,464,42,126,154,338,148,196,582
1997,Dale Ellis,SF,36,DEN,82,2940,477,1151,192,528,285,623,215,263,1361
1997,LaPhonso Ellis,PF,26,DEN,55,2002,445,1014,95,259,350,755,218,282,1203
1997,Pervis Ellison,PF,29,BOS,6,125,6,16,0,0,6,16,3,5,15
1997,Brian Evans,SF,23,ORL,14,59,8,22,4,8,4,14,0,0,20
1997,Patrick Ewing*,C,34,NYK,78,2887,655,1342,2,9,653,1333,439,582,1751
1997,Jamie Feick,PF-C,22,TOT,41,624,56,157,5,14,51,143,34,67,151
1997,Jamie Feick,C,22,CHH,3,10,2,4,1,1,1,3,0,2,5
1997,Jamie Feick,PF,22,SAS,38,614,54,153,4,13,50,140,34,65,146
1997,Duane Ferrell,SF,31,IND,62,1115,159,337,18,44,141,293,58,94,394
1997,Danny Ferry,PF,30,CLE,82,2633,341,794,114,284,227,510,74,87,870
1997,Michael Finley,SF,23,TOT,83,2790,475,1071,101,280,374,791,198,245,1249
1997,Michael Finley,SF,23,PHO,27,796,141,297,14,55,127,242,56,69,352
1997,Michael Finley,SF,23,DAL,56,1994,334,774,87,225,247,549,142,176,897
1997,Matt Fish,C,27,TOT,6,8,1,3,0,0,1,3,0,0,2
1997,Matt Fish,C,27,WSB,5,7,1,3,0,0,1,3,0,0,2
1997,Matt Fish,C,27,MIA,1,1,0,0,0,0,0,0,0,0,0
1997,Derek Fisher,PG,22,LAL,80,921,104,262,22,73,82,189,79,120,309
1997,Greg Foster,C,28,UTA,79,920,111,245,2,3,109,242,54,65,278
1997,Rick Fox,SF,27,BOS,76,2650,433,950,101,278,332,672,207,263,1174
1997,Todd Fuller,C,22,GSW,75,949,114,266,0,0,114,266,76,110,304
1997,Kevin Gamble,SF,31,SAC,62,953,123,286,54,112,69,174,7,10,307
1997,Kevin Garnett,SF,20,MIN,77,2995,549,1100,6,21,543,1079,205,272,1309
1997,Dean Garrett,C,30,MIN,68,1665,223,389,0,0,223,389,96,138,542
1997,Chris Gatling,PF,29,TOT,47,1283,327,623,1,6,326,617,236,329,891
1997,Chris Gatling,PF,29,DAL,44,1191,309,580,1,6,308,574,221,313,840
1997,Chris Gatling,PF,29,NJN,3,92,18,43,0,0,18,43,15,16,51
1997,Reggie Geary,PG,23,CLE,39,246,22,58,8,21,14,37,5,11,57
1997,Matt Geiger,C,27,CHH,49,1044,171,350,6,20,165,330,89,127,437
1997,Kendall Gill,SF,28,NJN,82,3199,644,1453,74,220,570,1233,427,536,1789
1997,Armen Gilliam,PF,32,MIL,80,2050,246,522,0,0,246,522,199,259,691
1997,Anthony Goldwire,PG,25,TOT,60,1188,131,330,64,153,67,177,61,78,387
1997,Anthony Goldwire,PG,25,CHH,33,576,62,154,36,82,26,72,30,40,190
1997,Anthony Goldwire,PG,25,DEN,27,612,69,176,28,71,41,105,31,38,197
1997,Greg Graham,SG,26,SEA,28,197,29,80,9,31,20,49,26,40,93
1997,Brian Grant,PF,24,SAC,24,607,91,207,0,0,91,207,70,90,252
1997,Gary Grant,PG,31,MIA,28,365,39,110,14,46,25,64,18,22,110
1997,Harvey Grant,PF,31,WSB,78,1604,129,314,28,89,101,225,30,39,316
1997,Horace Grant,PF,31,ORL,67,2496,358,695,1,6,357,689,128,179,845
1997,Devin Gray,PF,24,TOT,6,49,8,26,0,0,8,26,2,5,18
1997,Devin Gray,PF,24,SAC,3,25,3,11,0,0,3,11,2,4,8
1997,Devin Gray,PF,24,SAS,3,24,5,15,0,0,5,15,0,1,10
1997,Evric Gray,SF,27,NJN,5,42,4,15,1,4,3,11,4,4,13
1997,Jeff Grayer,SG,31,SAC,25,316,38,83,4,11,34,72,11,20,91
1997,A.C. Green,PF,33,TOT,83,2492,234,484,1,20,233,464,128,197,597
1997,A.C. Green,PF,33,PHO,27,548,61,128,0,3,61,125,31,48,153
1997,A.C. Green,PF,33,DAL,56,1944,173,356,1,17,172,339,97,149,444
1997,Litterial Green,PG,26,DET,45,311,30,64,0,10,30,54,30,47,90
1997,Tom Gugliotta,PF,27,MIN,81,3131,592,1339,24,93,568,1246,464,566,1672
1997,Jack Haley,C,33,NJN,20,74,13,37,0,0,13,37,14,19,40
1997,Darvin Ham,SF,23,TOT,36,318,33,62,0,0,33,62,17,35,83
1997,Darvin Ham,SF,23,DEN,35,313,32,61,0,0,32,61,16,33,80
1997,Darvin Ham,SF,23,IND,1,5,1,1,0,0,1,1,1,2,3
1997,Steve Hamer,C,23,BOS,35,268,30,57,0,2,30,55,16,29,76
1997,Tom Hammonds,PF,29,DEN,81,1758,191,398,0,2,191,396,124,172,506
1997,Darrin Hancock,SF,25,TOT,24,133,16,35,0,0,16,35,10,14,42
1997,Darrin Hancock,SF,25,MIL,9,39,2,6,0,0,2,6,0,0,4
1997,Darrin Hancock,SF,25,ATL,14,86,13,27,0,0,13,27,8,12,34
1997,Darrin Hancock,SF,25,SAS,1,8,1,2,0,0,1,2,2,2,4
1997,Anfernee Hardaway,PG,25,ORL,59,2221,421,941,85,267,336,674,283,345,1210
1997,Tim Hardaway,PG,30,MIA,81,3136,575,1384,203,590,372,794,291,364,1644
1997,Derek Harper,PG,35,DAL,75,2210,299,674,60,176,239,498,95,128,753
1997,Ron Harper,PG,33,CHI,76,1740,177,406,68,188,109,218,58,82,480
1997,Othella Harrington,PF,23,HOU,57,860,112,204,0,3,112,201,49,81,273
1997,Lucious Harris,SG,26,PHI,54,813,112,294,36,99,76,195,33,47,293
1997,Antonio Harvey,PF,26,SEA,6,26,5,11,0,0,5,11,5,6,15
1997,Hersey Hawkins,SG,30,SEA,82,2755,369,795,143,355,226,440,258,295,1139
1997,Michael Hawkins,PG,24,BOS,29,326,29,68,10,31,19,37,12,15,80
1997,Shane Heal,PG,26,MIN,43,236,26,97,20,65,6,32,3,5,75
1997,Alan Henderson,PF,24,ATL,30,501,77,162,0,0,77,162,45,75,199
1997,Mark Hendrickson,PF,22,PHI,29,301,32,77,3,12,29,65,18,26,85
1997,Carl Herrera,PF,30,SAS,75,1837,257,593,2,6,255,587,81,118,597
1997,Grant Hill,SF,24,DET,80,3147,625,1259,10,33,615,1226,450,633,1710
1997,Tyrone Hill,C,28,CLE,74,2582,357,595,0,1,357,594,241,381,955
1997,Fred Hoiberg,SG,24,IND,47,572,67,156,29,70,38,86,61,77,224
1997,Jeff Hornacek,SG,33,UTA,82,2592,413,856,72,195,341,661,293,326,1191
1997,Robert Horry,SF,26,TOT,54,1395,157,360,49,154,108,206,60,90,423
1997,Robert Horry,SF,26,PHO,32,719,82,195,24,78,58,117,32,50,220
1997,Robert Horry,SF,26,LAL,22,676,75,165,25,76,50,89,28,40,203
1997,Allan Houston,SG,25,NYK,81,2681,437,1032,148,384,289,648,175,218,1197
1997,Juwan Howard,SF,23,WSB,82,3324,638,1313,0,2,638,1311,294,389,1570
1997,Stephen Howard,SF,26,TOT,49,418,62,108,0,0,62,108,52,81,176
1997,Stephen Howard,SF,26,SAS,7,69,7,12,0,0,7,12,12,14,26
1997,Stephen Howard,SF,26,UTA,42,349,55,96,0,0,55,96,40,67,150
1997,Lindsey Hunter,PG,26,DET,82,3023,421,1042,166,468,255,574,158,203,1166
1997,Bobby Hurley,PG,25,SAC,49,632,46,125,14,45,32,80,37,53,143
1997,Allen Iverson*,PG,21,PHI,76,3045,625,1504,155,455,470,1049,382,544,1787
1997,Jaren Jackson,SG,29,WSB,75,1133,134,329,53,158,81,171,53,69,374
1997,Jim Jackson,SG-SF,26,TOT,77,2831,444,1029,86,247,358,782,252,310,1226
1997,Jim Jackson,SG,26,DAL,46,1676,260,588,46,139,214,449,148,188,714
1997,Jim Jackson,SF,26,NJN,31,1155,184,441,40,108,144,333,104,122,512
1997,Mark Jackson,PG,31,TOT,82,3054,289,679,66,178,223,501,168,213,812
1997,Mark Jackson,PG,31,DEN,52,2001,192,452,48,121,144,331,109,136,541
1997,Mark Jackson,PG,31,IND,30,1053,97,227,18,57,79,170,59,77,271
1997,Henry James,PF,31,ATL,53,945,125,306,76,181,49,125,30,36,356
1997,Chris Jent,SF,27,NYK,3,10,2,6,2,3,0,3,0,0,6
1997,Avery Johnson,PG,31,SAS,76,2472,327,685,6,26,321,659,140,203,800
1997,Eddie Johnson,SF,37,TOT,52,913,160,362,49,131,111,231,55,68,424
1997,Eddie Johnson,SF,37,IND,28,306,59,136,9,28,50,108,20,27,147
1997,Eddie Johnson,SF,37,HOU,24,607,101,226,40,103,61,123,35,41,277
1997,Ervin Johnson,C,29,DEN,82,2599,243,467,0,2,243,465,96,156,582
1997,Kevin Johnson,PG,30,PHO,70,2658,441,890,89,202,352,688,439,515,1410
1997,Larry Johnson,SF,27,NYK,76,2613,376,735,34,105,342,630,190,274,976
1997,Charles Jones,PF,39,HOU,12,93,2,5,0,0,2,5,0,0,4
1997,Eddie Jones,SG,25,LAL,80,2998,473,1081,152,389,321,692,276,337,1374
1997,Popeye Jones,PF,26,TOR,79,2421,258,537,1,13,257,524,99,121,616
1997,Michael Jordan*,SG,33,CHI,82,3106,920,1892,111,297,809,1595,480,576,2431
1997,Reggie Jordan,SG,29,TOT,19,130,16,26,0,0,16,26,8,17,40
1997,Reggie Jordan,SG,29,POR,9,99,8,16,0,0,8,16,4,10,20
1997,Reggie Jordan,SG,29,MIN,10,31,8,10,0,0,8,10,4,7,20
1997,Adam Keefe,C,26,UTA,62,915,82,160,0,1,82,159,71,103,235
1997,Shawn Kemp,PF,27,SEA,81,2750,526,1032,12,33,514,999,452,609,1516
1997,Tim Kempton,PF,33,SAS,10,59,1,5,0,0,1,5,2,2,4
1997,Steve Kerr,PG,31,CHI,82,1861,249,467,110,237,139,230,54,67,662
1997,Jerome Kersey,SF,34,LAL,70,1766,194,449,17,65,177,384,71,118,476
1997,Jason Kidd,PG,23,TOT,55,1964,213,529,61,165,152,364,112,165,599
1997,Jason Kidd,PG,23,DAL,22,791,75,203,21,65,54,138,46,69,217
1997,Jason Kidd,PG,23,PHO,33,1173,138,326,40,100,98,226,66,96,382
1997,Frankie King,SG,24,PHI,7,59,7,17,1,2,6,15,5,5,20
1997,Jimmy King,SG,23,DEN,2,22,2,6,0,0,2,6,2,4,6
1997,Stacey King,C,30,TOT,11,103,11,22,0,0,11,22,2,7,24
1997,Stacey King,C,30,BOS,5,33,5,7,0,0,5,7,2,3,12
1997,Stacey King,C,30,DAL,6,70,6,15,0,0,6,15,0,4,12
1997,Kerry Kittles,SG,22,NJN,82,3012,507,1189,158,419,349,770,175,227,1347
1997,Joe Kleine,C,35,TOT,59,848,69,170,2,3,67,167,28,38,168
1997,Joe Kleine,C,35,PHO,23,365,32,80,1,1,31,79,13,18,78
1997,Joe Kleine,C,35,LAL,8,30,2,8,0,0,2,8,2,2,6
1997,Joe Kleine,C,35,NJN,28,453,35,82,1,2,34,80,13,18,84
1997,Travis Knight,C,22,LAL,71,1156,140,275,0,0,140,275,62,100,342
1997,Larry Krystkowiak,PF,32,LAL,3,11,1,2,0,0,1,2,1,2,3
1997,Toni Kukoc,SF,28,CHI,57,1610,285,605,50,151,235,454,134,174,754
1997,Christian Laettner,PF,27,ATL,82,3140,548,1128,31,88,517,1040,359,440,1486
1997,Andrew Lang,C,30,MIL,52,1194,115,248,0,0,115,248,44,61,274
1997,Antonio Lang,PF,24,CLE,64,843,68,162,0,6,68,156,35,48,171
1997,Priest Lauderdale,C,23,ATL,35,180,49,89,0,1,49,88,13,23,111
1997,Eric Leckner,C,30,TOT,20,126,14,33,0,0,14,33,6,12,34
1997,Eric Leckner,C,30,CHH,1,11,0,3,0,0,0,3,0,0,0
1997,Eric Leckner,C,30,VAN,19,115,14,30,0,0,14,30,6,12,34
1997,Tim Legler,SG,30,WSB,15,182,15,48,8,29,7,19,6,7,44
1997,Voshon Lenard,SG,23,MIA,73,2111,314,684,183,442,131,242,86,105,897
1997,Martin Lewis,SF,21,TOR,9,50,6,14,1,3,5,11,1,2,14
1997,Alton Lister,C,38,BOS,53,516,32,77,0,0,32,77,23,31,87
1997,Randy Livingston,PG,21,HOU,64,981,100,229,9,22,91,207,42,65,251
1997,Horacio Llamas,C,23,PHO,20,101,15,28,0,0,15,28,4,8,34
1997,Brad Lohaus,PF,32,TOR,6,45,4,15,2,7,2,8,0,0,10
1997,Grant Long,PF,30,DET,65,1166,123,275,17,47,106,228,63,84,326
1997,John Long,SG,40,TOR,32,370,46,117,12,34,34,83,25,28,129
1997,Luc Longley,C,28,CHI,59,1472,221,485,0,2,221,483,95,120,537
1997,George Lynch,SF,26,VAN,41,1059,137,291,8,31,129,260,60,97,342
1997,Sam Mack,SF,26,HOU,52,904,105,262,47,142,58,120,35,42,292
1997,Don MacLean,SF,27,PHI,37,733,163,365,12,38,151,327,64,97,402
1997,Rick Mahorn,C,38,DET,22,218,20,54,0,1,20,53,16,22,56
1997,Dan Majerle,SF,31,MIA,36,1264,141,347,68,201,73,146,40,59,390
1997,Karl Malone*,PF,33,UTA,82,2998,864,1571,0,13,864,1558,521,690,2249
1997,Matt Maloney,PG,25,HOU,82,2386,271,615,154,381,117,234,71,93,767
1997,Danny Manning,PF,30,PHO,77,2134,426,795,7,36,419,759,181,251,1040
1997,Rich Manning,PF,26,TOT,26,201,32,82,2,4,30,78,9,14,75
1997,Rich Manning,PF,26,VAN,16,128,18,48,2,3,16,45,6,8,44
1997,Rich Manning,PF,26,LAC,10,73,14,34,0,1,14,33,3,6,31
1997,Stephon Marbury,PG,19,MIN,67,2324,355,871,102,288,253,583,245,337,1057
1997,Sarunas Marciulionis*,SG,32,DEN,17,255,38,101,11,30,27,71,29,36,116
1997,Donny Marshall,SF,24,CLE,56,548,52,160,33,87,19,73,38,54,175
1997,Donyell Marshall,SF,23,GSW,61,1022,174,421,35,111,139,310,61,98,444
1997,Cuonzo Martin,SG,25,MIL,3,13,0,7,0,2,0,5,0,0,0
1997,Darrick Martin,PG,25,LAC,82,1820,292,718,91,234,201,484,218,250,893
1997,Jamal Mashburn,SF,24,TOT,69,2164,286,743,90,277,196,466,160,228,822
1997,Jamal Mashburn,SF,24,DAL,37,975,140,376,42,131,98,245,72,111,394
1997,Jamal Mashburn,SF,24,MIA,32,1189,146,367,48,146,98,221,88,117,428
1997,Anthony Mason,PF,30,CHH,73,3143,433,825,1,3,432,822,319,428,1186
1997,Tony Massenburg,PF,29,NJN,79,1954,219,452,0,1,219,451,130,206,568
1997,Vernon Maxwell,SG,31,SAS,72,2068,340,906,115,372,225,534,134,180,929
1997,Lee Mayberry,PG,26,VAN,80,1952,149,370,83,221,66,149,29,46,410
1997,Walter McCarty,PF,22,NYK,35,192,26,68,4,14,22,54,8,14,64
1997,Amal McCaskill,C,23,ORL,17,109,10,32,0,2,10,30,8,12,28
1997,George McCloud,SF,29,TOT,64,1493,238,578,99,254,139,324,83,101,658
1997,George McCloud,SF,29,DAL,41,1207,204,482,78,205,126,277,77,92,563
1997,George McCloud,SF,29,LAL,23,286,34,96,21,49,13,47,6,9,95
1997,Xavier McDaniel,PF,33,NJN,62,1170,138,355,5,25,133,330,65,89,346
1997,Antonio McDyess,PF,22,DEN,74,2565,536,1157,6,35,530,1122,274,387,1352
1997,Jim McIlvaine,C,24,SEA,82,1477,130,276,1,7,129,269,53,107,314
1997,Jeff McInnis,PG,22,DEN,13,117,23,49,12,26,11,23,7,10,65
1997,Derrick McKey,SF,30,IND,50,1449,148,379,15,58,133,321,89,123,400
1997,Aaron McKie,SG,24,TOT,83,1625,150,365,41,103,109,262,92,110,433
1997,Aaron McKie,SG,24,POR,41,775,53,156,23,55,30,101,41,49,170
1997,Aaron McKie,SG,24,DET,42,850,97,209,18,48,79,161,51,61,263
1997,Nate McMillan,PG,32,SEA,37,798,61,149,28,84,33,65,19,29,169
1997,Loren Meyer,PF,24,TOT,54,708,108,244,4,7,104,237,46,64,266
1997,Loren Meyer,PF,24,DAL,19,259,34,78,1,2,33,76,9,12,78
1997,Loren Meyer,PF,24,PHO,35,449,74,166,3,5,71,161,37,52,188
1997,Anthony Miller,PF,25,ATL,1,14,0,5,0,0,0,5,0,0,0
1997,Oliver Miller,C,26,TOT,61,1152,123,238,0,2,123,236,48,79,294
1997,Oliver Miller,C,26,DAL,42,836,76,154,0,1,76,153,28,53,180
1997,Oliver Miller,C,26,TOR,19,316,47,84,0,1,47,83,20,26,114
1997,Reggie Miller*,SG,31,IND,81,2966,552,1244,229,536,323,708,418,475,1751
1997,Chris Mills,SF,27,CLE,80,3167,405,894,86,220,319,674,176,209,1072
1997,Terry Mills,PF,29,DET,79,1997,312,702,175,415,137,287,58,70,857
1997,Greg Minor,SF,25,BOS,23,547,94,196,1,8,93,188,31,36,220
1997,Sam Mitchell,SF,33,MIN,82,2044,269,603,4,25,265,578,224,295,766
1997,Eric Mobley,C,26,VAN,28,307,28,63,0,0,28,63,16,30,72
1997,Eric Montross,C,25,TOT,78,1828,159,349,0,0,159,349,21,62,339
1997,Eric Montross,C,25,DAL,47,984,86,187,0,0,86,187,10,34,182
1997,Eric Montross,C,25,NJN,31,844,73,162,0,0,73,162,11,28,157
1997,Tracy Moore,SG,31,HOU,27,237,33,85,11,43,22,42,22,31,99
1997,Chris Morris,SF,31,UTA,73,977,122,299,31,113,91,186,39,54,314
1997,Lawrence Moten,SG,24,VAN,67,1214,171,441,41,141,130,300,64,99,447
1997,Alonzo Mourning*,C,26,MIA,66,2320,473,885,1,9,472,876,363,565,1310
1997,Chris Mullin*,SF,33,GSW,79,2733,438,792,83,202,355,590,184,213,1143
1997,Eric Murdock,PG,28,DEN,12,114,15,33,4,10,11,23,11,12,45
1997,Gheorghe Muresan,C,25,WSB,73,1849,327,541,0,0,327,541,123,199,777
1997,Lamond Murray,SF,23,LAC,74,1295,181,435,31,91,150,344,156,211,549
1997,Tracy Murray,SF,25,WSB,82,1814,288,678,106,300,182,378,135,161,817
1997,Dikembe Mutombo*,C,30,ATL,80,2973,380,721,0,0,380,721,306,434,1066
1997,Martin Muursepp,PF,22,TOT,42,348,54,131,4,24,50,107,44,70,156
1997,Martin Muursepp,PF,22,MIA,10,27,5,14,1,4,4,10,6,14,17
1997,Martin Muursepp,PF,22,DAL,32,321,49,117,3,20,46,97,38,56,139
1997,Steve Nash,PG,22,PHO,65,684,74,175,23,55,51,120,42,51,213
1997,Ruben Nembhard,SG-PG,24,TOT,10,113,16,37,0,6,16,31,8,10,40
1997,Ruben Nembhard,SG,24,UTA,8,94,12,29,0,4,12,25,8,10,32
1997,Ruben Nembhard,PG,24,POR,2,19,4,8,0,2,4,6,0,0,8
1997,Ivano Newbill,PF,26,ATL,72,850,40,91,0,0,40,91,20,52,100
1997,Johnny Newman,SF,33,MIL,82,2060,246,547,34,98,212,449,189,247,715
1997,Gaylon Nickerson,SG,27,TOT,4,42,4,12,0,2,4,10,7,7,15
1997,Gaylon Nickerson,SG,27,SAS,3,36,3,9,0,1,3,8,7,7,13
1997,Gaylon Nickerson,SG,27,WSB,1,6,1,3,0,1,1,2,0,0,2
1997,Ken Norman,SF,32,ATL,17,220,27,94,6,38,21,56,4,12,64
1997,Moochie Norris,PG,23,VAN,8,89,4,22,2,10,2,12,2,5,12
1997,Ed O'Bannon,SF,24,TOT,64,809,93,279,18,70,75,209,31,35,235
1997,Ed O'Bannon,SF,24,NJN,45,634,76,207,17,60,59,147,20,23,189
1997,Ed O'Bannon,SF,24,DAL,19,175,17,72,1,10,16,62,11,12,46
1997,Jermaine O'Neal,PF,18,POR,45,458,69,153,0,1,69,152,47,78,185
1997,Shaquille O'Neal*,C,24,LAL,51,1941,552,991,0,4,552,987,232,479,1336
1997,Charles Oakley,PF,33,NYK,80,2873,339,694,5,19,334,675,181,224,864
1997,Hakeem Olajuwon*,C,34,HOU,78,2852,727,1426,5,16,722,1410,351,446,1810
1997,Jimmy Oliver,SG,27,TOR,4,43,4,13,1,6,3,7,2,2,11
1997,Greg Ostertag,C,23,UTA,77,1818,210,408,0,4,210,404,139,205,559
1997,Bo Outlaw,PF,25,LAC,82,2195,254,417,0,8,254,409,117,232,625
1997,Doug Overton,PG,27,PHI,61,634,81,190,10,40,71,150,45,48,217
1997,Billy Owens,SF,27,SAC,66,1995,299,640,25,72,274,568,101,145,724
1997,Ray Owes,PF,24,GSW,57,592,75,180,1,5,74,175,26,46,177
1997,Robert Pack,PG,27,TOT,54,1782,272,693,31,112,241,581,196,243,771
1997,Robert Pack,PG,27,NJN,34,1185,193,474,22,74,171,400,134,170,542
1997,Robert Pack,PG,27,DAL,20,597,79,219,9,38,70,181,62,73,229
1997,Robert Parish*,C,43,CHI,43,406,70,143,0,0,70,143,21,31,161
1997,Cherokee Parks,PF,24,MIN,76,961,103,202,0,1,103,201,46,76,252
1997,Gary Payton*,PG,28,SEA,82,3213,706,1482,119,380,587,1102,254,355,1785
1997,Anthony Peeler,SG,27,VAN,72,2291,402,1011,128,343,274,668,109,133,1041
1997,Will Perdue,C,31,SAS,65,1918,233,410,0,0,233,410,99,171,565
1997,Sam Perkins,C,35,SEA,81,1976,290,661,122,309,168,352,187,229,889
1997,Elliot Perry,PG,27,MIL,82,1595,217,458,49,137,168,321,79,106,562
1997,Wesley Person,SG,25,PHO,80,2326,409,903,171,414,238,489,91,114,1080
1997,Bobby Phills,SG,27,CLE,69,2375,328,766,85,216,243,550,125,174,866
1997,Eric Piatkowski,SG,26,LAC,65,747,134,298,51,120,83,178,69,84,388
1997,Ricky Pierce,SG,37,TOT,60,1250,239,497,42,95,197,402,139,155,659
1997,Ricky Pierce,SG,37,DEN,33,600,120,260,12,39,108,221,83,92,335
1997,Ricky Pierce,SG,37,CHH,27,650,119,237,30,56,89,181,56,63,324
1997,Ed Pinckney,PF,33,MIA,27,273,23,43,0,0,23,43,20,25,66
1997,Scottie Pippen*,SF,31,CHI,82,3095,648,1366,156,424,492,942,204,291,1656
1997,Olden Polynice,C,32,SAC,82,2893,442,967,0,6,442,961,141,251,1025
1997,Terry Porter,PG,33,MIN,82,1568,187,449,67,200,120,249,127,166,568
1997,Vitaly Potapenko,C,21,CLE,80,1238,186,423,1,2,185,421,92,125,465
1997,Brent Price,PG,28,HOU,25,390,44,105,17,53,27,52,21,21,126
1997,Mark Price,PG,32,GSW,70,1876,263,589,112,283,151,306,155,171,793
1997,Dino Radja,C,29,BOS,25,874,149,339,0,1,149,338,51,71,349
1997,Theo Ratliff,C,23,DET,76,1292,179,337,0,0,179,337,81,116,439
1997,Eldridge Recasner,SG,29,ATL,71,1207,148,350,58,140,90,210,51,58,405
1997,Bryant Reeves,C,23,VAN,75,2777,498,1025,1,11,497,1014,216,307,1213
1997,Khalid Reeves,PG,24,TOT,63,1432,184,470,83,227,101,243,65,87,516
1997,Khalid Reeves,PG,24,NJN,50,1048,141,359,76,192,65,167,56,75,414
1997,Khalid Reeves,PG,24,DAL,13,384,43,111,7,35,36,76,9,12,102
1997,Don Reid,PF,23,DET,47,462,54,112,0,1,54,111,24,32,132
1997,Shawn Respert,SG,24,TOT,41,495,59,139,20,57,39,82,34,39,172
1997,Shawn Respert,SG,24,MIL,14,83,6,19,1,9,5,10,7,7,20
1997,Shawn Respert,SG,24,TOR,27,412,53,120,19,48,34,72,27,32,152
1997,Glen Rice,SF,29,CHH,79,3362,722,1513,207,440,515,1073,464,535,2115
1997,Pooh Richardson,PG,30,LAC,59,1065,131,344,42,128,89,216,26,43,330
1997,Mitch Richmond*,SG,31,SAC,81,3125,717,1578,204,477,513,1101,457,531,2095
1997,Isaiah Rider,SG,25,POR,76,2563,456,983,99,257,357,726,212,261,1223
1997,Fred Roberts,PF,36,DAL,12,40,6,15,0,0,6,15,10,14,22
1997,Stanley Roberts,C,26,LAC,18,378,63,148,0,0,63,148,45,64,171
1997,Chris Robinson,SG,22,VAN,41,681,69,182,34,89,35,93,16,26,188
1997,Clifford Robinson,SF,30,POR,81,3077,444,1043,121,350,323,693,215,309,1224
1997,David Robinson*,C,31,SAS,6,147,36,72,0,0,36,72,34,52,106
1997,Glenn Robinson,SF,24,MIL,80,3114,669,1438,63,180,606,1258,288,364,1689
1997,James Robinson,PG,26,MIN,69,1309,196,482,102,267,94,215,78,114,572
1997,Rumeal Robinson,PG,30,TOT,54,508,66,164,18,56,48,108,26,35,176
1997,Rumeal Robinson,PG,30,LAL,15,126,17,48,6,23,11,25,5,8,45
1997,Rumeal Robinson,PG,30,PHO,12,87,16,34,3,10,13,24,1,4,36
1997,Rumeal Robinson,PG,30,POR,27,295,33,82,9,23,24,59,20,23,95
1997,Dennis Rodman*,PF,35,CHI,55,1947,128,286,5,19,123,267,50,88,311
1997,Lou Roe,SF,24,GSW,17,107,14,48,3,11,11,37,9,19,40
1997,Carlos Rogers,PF,25,TOR,56,1397,212,404,25,66,187,338,102,170,551
1997,Rodney Rogers,SF,25,LAC,81,2480,408,884,65,180,343,704,191,288,1072
1997,Roy Rogers,PF,23,VAN,82,1848,244,483,1,1,243,482,54,94,543
1997,Sean Rooks,C,27,LAL,69,735,87,185,0,1,87,184,91,130,265
1997,Jalen Rose,SF,24,IND,66,1188,172,377,21,72,151,305,117,156,482
1997,Malik Rose,PF,22,CHH,54,525,61,128,0,2,61,126,38,62,160
1997,Donald Royal,SF,30,TOT,62,858,62,146,0,2,62,144,94,117,218
1997,Donald Royal,SF,30,ORL,1,29,4,10,0,0,4,10,4,4,12
1997,Donald Royal,SF,30,GSW,36,509,37,96,0,2,37,94,62,78,136
1997,Donald Royal,SF,30,CHH,25,320,21,40,0,0,21,40,28,35,70
1997,Clifford Rozier,C,24,TOT,42,737,79,174,0,2,79,172,31,61,189
1997,Clifford Rozier,C,24,GSW,1,5,0,1,0,0,0,1,0,0,0
1997,Clifford Rozier,C,24,TOR,41,732,79,173,0,2,79,171,31,61,189
1997,Bryon Russell,SF,26,UTA,81,2525,297,620,108,264,189,356,171,244,873
1997,Arvydas Sabonis*,C,32,POR,69,1762,328,658,49,132,279,526,223,287,928
1997,Kevin Salvadori,C,26,SAC,23,154,12,33,0,0,12,33,13,18,37
1997,Jason Sasser,SF,23,TOT,8,69,9,23,1,3,8,20,0,0,19
1997,Jason Sasser,SF,23,SAS,6,62,8,19,1,2,7,17,0,0,17
1997,Jason Sasser,SF,23,DAL,2,7,1,4,0,1,1,3,0,0,2
1997,Danny Schayes,PF,37,ORL,45,540,47,120,0,1,47,119,39,52,133
1997,Steve Scheffler,C,29,SEA,7,29,6,7,0,0,6,7,1,2,13
1997,Dwayne Schintzius,C,28,LAC,15,116,13,36,1,2,12,34,7,8,34
1997,Detlef Schrempf,SF,34,SEA,61,2192,356,724,57,161,299,563,253,316,1022
1997,Brent Scott,PF,25,IND,16,55,8,17,0,0,8,17,3,6,19
1997,Byron Scott,SG,35,LAL,79,1440,163,379,73,188,90,191,127,151,526
1997,Dennis Scott,SF,28,ORL,66,2166,298,749,147,373,151,376,80,101,823
1997,James Scott,SF,24,MIA,8,32,0,8,0,4,0,4,1,2,1
1997,Shawnelle Scott,C,24,CLE,16,50,8,16,0,0,8,16,4,11,20
1997,Malik Sealy,SG,26,LAC,80,2456,373,942,79,222,294,720,254,290,1079
1997,Rony Seikaly,C,31,ORL,74,2615,460,907,0,3,460,904,357,500,1277
1997,Brian Shaw,PG,30,ORL,77,1867,189,516,63,194,126,322,111,140,552
1997,Lionel Simmons,SF,28,SAC,41,521,45,136,7,30,38,106,42,48,139
1997,Dickey Simpkins,PF,24,CHI,48,395,31,93,1,4,30,89,28,40,91
1997,Reggie Slater,PF,26,TOR,26,406,82,149,0,2,82,147,39,75,203
1997,Charles Smith,PF,31,SAS,19,329,34,84,0,1,34,83,20,26,88
1997,Joe Smith,PF,21,GSW,80,3086,587,1293,12,46,575,1247,307,377,1493
1997,Kenny Smith,PG,31,TOT,48,765,101,239,59,135,42,104,39,45,300
1997,Kenny Smith,PG,31,DET,9,64,8,20,5,10,3,10,2,2,23
1997,Kenny Smith,PG,31,ORL,6,47,6,13,3,5,3,8,2,2,17
1997,Kenny Smith,PG,31,DEN,33,654,87,206,51,120,36,86,35,41,260
1997,Michael Smith,PF,24,SAC,81,2526,202,375,0,0,202,375,128,258,532
1997,Steve Smith,SG,27,ATL,72,2818,491,1145,130,388,361,757,333,393,1445
1997,Stevin Smith,SG,25,DAL,8,60,6,18,1,6,5,12,1,1,14
1997,Tony Smith,PG,28,CHH,69,1291,138,337,32,99,106,238,38,59,346
1997,Rik Smits,C,30,IND,52,1518,356,733,2,8,354,725,173,217,887
1997,Eric Snow,PG,23,SEA,67,775,74,164,4,15,70,149,47,66,199
1997,Elmore Spencer,C,27,SEA,1,5,0,1,0,0,0,1,0,0,0
1997,Felton Spencer,C,29,TOT,73,1558,139,284,0,0,139,284,94,161,372
1997,Felton Spencer,C,29,ORL,1,19,2,2,0,0,2,2,0,0,4
1997,Felton Spencer,C,29,GSW,72,1539,137,282,0,0,137,282,94,161,368
1997,Latrell Sprewell,SG,26,GSW,80,3353,649,1444,147,415,502,1029,493,585,1938
1997,Jerry Stackhouse,SG,22,PHI,81,3166,533,1308,102,342,431,966,511,667,1679
1997,John Starks,SG,31,NYK,77,2042,369,856,150,407,219,449,173,225,1061
1997,Matt Steigenga,SF,26,CHI,2,12,1,4,0,2,1,2,1,2,3
1997,Joe Stephens,PF,24,HOU,2,9,1,5,1,3,0,2,0,0,3
1997,Larry Stewart,SF,28,SEA,70,982,112,252,9,37,103,215,67,93,300
1997,Bryant Stith,SG,26,DEN,52,1788,251,603,70,182,181,421,202,234,774
1997,John Stockton*,PG,34,UTA,82,2896,416,759,76,180,340,579,275,325,1183
1997,Damon Stoudamire,PG,23,TOR,81,3311,564,1407,176,496,388,911,330,401,1634
1997,Erick Strickland,SG,23,DAL,28,759,102,256,28,92,74,164,65,80,297
1997,Mark Strickland,PF,26,MIA,31,153,25,60,0,1,25,59,12,21,62
1997,Rod Strickland,PG,30,WSB,82,2997,515,1105,13,77,502,1028,367,497,1410
1997,Derek Strong,PF,28,ORL,82,2004,262,586,0,13,262,573,175,218,699
1997,Bob Sura,SG,23,CLE,82,2269,253,587,53,164,200,423,196,319,755
1997,Brett Szabo,C,28,BOS,70,662,54,121,0,1,54,120,45,61,153
1997,Zan Tabak,C,26,TOR,13,218,32,71,0,0,32,71,20,29,84
1997,Carl Thomas,SG,27,CLE,19,77,9,24,2,12,7,12,1,1,21
1997,Kurt Thomas,PF,24,MIA,18,374,39,105,0,1,39,104,35,46,113
1997,Brooks Thompson,PG,26,TOT,67,1055,162,406,97,244,65,162,24,38,445
1997,Brooks Thompson,PG,26,UTA,2,8,0,1,0,0,0,1,0,0,0
1997,Brooks Thompson,PG,26,DEN,65,1047,162,405,97,244,65,161,24,38,445
1997,LaSalle Thompson,C,35,TOT,26,140,3,19,0,0,3,19,4,6,10
1997,LaSalle Thompson,C,35,DEN,17,105,3,16,0,0,3,16,1,2,7
1997,LaSalle Thompson,C,35,IND,9,35,0,3,0,0,0,3,3,4,3
1997,Otis Thorpe,C,34,DET,79,2661,419,787,0,2,419,785,198,303,1036
1997,Sedale Threatt,SG,35,HOU,21,334,28,74,8,20,20,54,6,8,70
1997,Wayman Tisdale,PF,32,PHO,53,778,158,371,0,0,158,371,30,48,346
1997,Keith Tower,C,26,MIL,5,72,3,8,0,0,3,8,1,8,7
1997,Gary Trent,PF,22,POR,82,1918,361,674,0,11,361,663,160,229,882
1997,Nick Van,PG,25,LAL,79,2937,432,1075,177,468,255,607,165,200,1206
1997,David Vaughn,PF,23,ORL,35,298,31,72,0,0,31,72,19,30,81
1997,Loy Vaught,PF,28,LAC,82,2838,542,1084,2,12,540,1072,134,191,1220
1997,Stojko Vrankovic,C,33,MIN,53,766,78,139,0,0,78,139,25,37,181
1997,Antoine Walker,PF,20,BOS,82,2970,576,1354,52,159,524,1195,231,366,1435
1997,Samaki Walker,PF,20,DAL,43,602,83,187,0,1,83,186,48,74,214
1997,Ben Wallace,PF,22,WSB,34,197,16,46,0,0,16,46,6,20,38
1997,John Wallace,SF,22,NYK,68,787,122,236,2,4,120,232,79,110,325
1997,Rasheed Wallace,PF,22,POR,62,1892,380,681,9,33,371,648,169,265,938
1997,Rex Walters,SG,26,PHI,59,1041,148,325,57,148,91,177,49,62,402
1997,Charlie Ward,PG,26,NYK,79,1763,133,337,48,154,85,183,95,125,409
1997,Jamie Watson,SF,24,TOT,23,340,31,72,4,12,27,60,12,16,78
1997,Jamie Watson,SF,24,UTA,13,129,11,25,1,3,10,22,10,12,33
1997,Jamie Watson,SF,24,DAL,10,211,20,47,3,9,17,38,2,4,45
1997,Clarence Weatherspoon,SF,26,PHI,82,2949,398,811,1,6,397,805,206,279,1003
1997,Chris Webber,PF,23,WSB,72,2806,604,1167,60,151,544,1016,177,313,1445
1997,Bill Wennington,C,33,CHI,61,783,118,237,0,2,118,235,44,53,280
1997,Robert Werdann,C,26,NJN,6,31,3,7,0,0,3,7,3,3,9
1997,David Wesley,PG,26,BOS,74,2991,456,974,103,286,353,688,225,288,1240
1997,Doug West,SG,29,MIN,68,1920,226,484,15,45,211,439,64,94,531
1997,Mark West,C,36,CLE,70,959,100,180,0,0,100,180,27,56,227
1997,Ennis Whatley,PG,34,POR,3,22,2,4,0,0,2,4,0,0,4
1997,Donald Whiteside,PG,27,TOR,27,259,18,55,12,36,6,19,11,15,59
1997,Chris Whitney,PG,25,WSB,82,1117,139,330,58,163,81,167,94,113,430
1997,Dominique Wilkins*,SF,37,SAS,63,1945,397,953,70,239,327,714,281,350,1145
1997,Gerald Wilkins,SG,33,ORL,80,2202,323,759,66,203,257,556,136,190,848
1997,Aaron Williams,PF-C,25,TOT,33,563,85,148,0,1,85,147,33,49,203
1997,Aaron Williams,C,25,DEN,1,10,3,5,0,0,3,5,0,0,6
1997,Aaron Williams,PF,25,VAN,32,553,82,143,0,1,82,142,33,49,197
1997,Buck Williams,PF,36,NYK,74,1496,175,326,0,1,175,325,115,179,465
1997,Eric Williams,SG,24,BOS,72,2435,374,820,2,8,372,812,328,436,1078
1997,Herb Williams,PF,38,NYK,21,184,18,46,0,1,18,45,3,4,39
1997,Hot Rod,C,34,PHO,68,2137,204,416,0,2,204,414,133,198,541
1997,Jayson Williams,PF,28,NJN,41,1432,221,540,0,4,221,536,108,183,550
1997,Jerome Williams,PF,23,DET,33,177,20,51,0,0,20,51,9,17,49
1997,Lorenzo Williams,C,27,WSB,19,264,20,31,0,0,20,31,5,7,45
1997,Monty Williams,SF,25,SAS,65,1345,234,460,0,1,234,459,120,186,588
1997,Reggie Williams,SF,32,TOT,13,200,29,76,9,34,20,42,9,12,76
1997,Reggie Williams,SF,32,IND,2,33,2,9,0,1,2,8,1,2,5
1997,Reggie Williams,SF,32,NJN,11,167,27,67,9,33,18,34,8,10,71
1997,Scott Williams,C,28,PHI,62,1317,162,318,0,2,162,316,38,55,362
1997,Walt Williams,SF,26,TOR,73,2647,419,982,175,437,244,545,186,243,1199
1997,Corliss Williamson,SF,23,SAC,79,1992,371,745,0,3,371,742,173,251,915
1997,Kevin Willis,PF,34,HOU,75,1964,350,728,2,14,348,714,140,202,842
1997,David Wingate,SG,33,SEA,65,929,89,214,25,71,64,143,33,40,236
1997,Dontonio Wingfield,SF,22,POR,47,569,79,193,26,77,53,116,27,40,211
1997,Joe Wolf,C,32,MIL,56,525,40,89,1,7,39,82,14,19,95
1997,David Wood,PF,32,MIL,46,240,20,38,5,15,15,23,12,18,57
1997,Haywoode Workman,PG,31,IND,4,81,11,20,0,3,11,17,0,1,22
1997,Lorenzen Wright,C,21,LAC,77,1936,236,491,1,4,235,487,88,150,561
1997,Sharone Wright,C,24,TOR,60,1009,161,403,0,1,161,402,68,133,390
1997,George Zidek,C,23,TOT,52,376,49,118,0,2,49,116,45,57,143
1997,George Zidek,C,23,CHH,36,288,33,85,0,2,33,83,25,32,91
1997,George Zidek,C,23,DEN,16,88,16,33,0,0,16,33,20,25,52
,,,,,,,,,,,,,,,
1998,Mahmoud Abdul-Rauf,PG,28,SAC,31,530,103,273,5,31,98,242,16,16,227
1998,Tariq Abdul-Wahad,SG,23,SAC,59,959,144,357,4,19,140,338,84,125,376
1998,Shareef Abdur-Rahim,SF,21,VAN,82,2950,653,1347,21,51,632,1296,502,640,1829
1998,Cory Alexander,PG,24,TOT,60,1298,171,400,66,176,105,224,80,102,488
1998,Cory Alexander,PG,24,SAS,37,501,60,145,20,64,40,81,25,37,165
1998,Cory Alexander,PG,24,DEN,23,797,111,255,46,112,65,143,55,65,323
1998,Ray Allen,SG,22,MIL,82,3287,563,1315,134,368,429,947,342,391,1602
1998,Derek Anderson,SF,23,CLE,66,1839,239,586,17,84,222,502,275,315,770
1998,Greg Anderson,C,33,ATL,50,398,36,81,0,5,36,76,16,41,88
1998,Kenny Anderson,PG,27,TOT,61,1858,268,674,57,160,211,514,153,194,746
1998,Kenny Anderson,PG,27,POR,45,1472,204,527,47,133,157,394,112,145,567
1998,Kenny Anderson,PG,27,BOS,16,386,64,147,10,27,54,120,41,49,179
1998,Nick Anderson,SF,30,ORL,58,1701,343,754,77,214,266,540,127,199,890
1998,Shandon Anderson,SG,24,UTA,82,1602,269,500,7,32,262,468,136,185,681
1998,Chris Anstey,C,23,DAL,41,680,92,231,3,16,89,215,53,74,240
1998,Greg Anthony,PG,30,SEA,80,1021,150,349,66,159,84,190,53,80,419
1998,B.J. Armstrong,PG,30,TOT,66,831,105,213,9,35,96,178,42,50,261
1998,B.J. Armstrong,PG,30,GSW,4,59,6,19,0,1,6,18,5,7,17
1998,B.J. Armstrong,PG,30,CHH,62,772,99,194,9,34,90,160,37,43,244
1998,Darrell Armstrong,PG,29,ORL,48,1236,156,380,25,68,131,312,105,123,442
1998,Vincent Askew,SG,31,POR,30,443,19,54,0,2,19,52,28,39,66
1998,Keith Askins,SF,30,MIA,46,681,39,122,21,74,18,48,12,19,111
1998,Stacey Augmon,SG,29,POR,71,1445,154,372,1,7,153,365,94,156,403
1998,Isaac Austin,C,28,TOT,78,2266,406,871,0,8,406,863,243,363,1055
1998,Isaac Austin,C,28,MIA,52,1371,252,532,0,3,252,529,155,228,659
1998,Isaac Austin,C,28,LAC,26,895,154,339,0,5,154,334,88,135,396
1998,Vin Baker,C,26,SEA,82,2944,631,1164,1,7,630,1157,311,526,1574
1998,Charles Barkley*,PF,34,HOU,68,2243,361,744,18,84,343,660,296,397,1036
1998,Dana Barros,PG,30,BOS,80,1686,281,609,100,246,181,363,122,144,784
1998,Brent Barry,SG,26,TOT,58,1600,213,506,90,229,123,277,115,134,631
1998,Brent Barry,SG,26,LAC,41,1341,190,444,78,195,112,249,103,122,561
1998,Brent Barry,SG,26,MIA,17,259,23,62,12,34,11,28,12,12,70
1998,Drew Barry,PG,24,ATL,27,256,18,38,9,21,9,17,11,13,56
1998,Jon Barry,SG,28,LAL,49,374,38,104,18,61,20,43,27,29,121
1998,Tony Battie,PF,21,DEN,65,1506,234,525,3,14,231,511,73,104,544
1998,Corey Beck,PG,26,CHH,59,738,73,159,2,4,71,155,43,59,191
1998,Benoit Benjamin,C,33,PHI,14,197,22,41,0,0,22,41,19,30,63
1998,Mario Bennett,PF,24,LAL,45,354,80,135,1,2,79,133,16,44,177
1998,David Benoit,SF,29,TOT,77,1123,152,408,55,170,97,238,61,74,420
1998,David Benoit,SF,29,NJN,53,799,102,269,41,119,61,150,37,44,282
1998,David Benoit,SF,29,ORL,24,324,50,139,14,51,36,88,24,30,138
1998,Travis Best,PG,25,IND,82,1547,201,480,21,70,180,410,112,131,535
1998,Chauncey Billups,PG,21,TOT,80,2216,280,749,107,325,173,424,226,266,893
1998,Chauncey Billups,PG,21,BOS,51,1296,177,454,64,189,113,265,147,180,565
1998,Chauncey Billups,PG,21,TOR,29,920,103,295,43,136,60,159,79,86,328
1998,Mookie Blaylock,PG,30,ATL,70,2700,368,938,90,334,278,604,95,134,921
1998,Corie Blount,PF,29,LAL,70,1029,107,187,0,4,107,183,39,78,253
1998,Muggsy Bogues,PG,33,TOT,61,1570,141,323,4,16,137,307,61,68,347
1998,Muggsy Bogues,PG,33,CHH,2,16,2,5,0,0,2,5,2,2,6
1998,Muggsy Bogues,PG,33,GSW,59,1554,139,318,4,16,135,302,59,66,341
1998,Etdrick Bohannon,PF,24,IND,5,11,0,4,0,0,0,4,0,0,0
1998,Keith Booth,SF,23,CHI,6,17,2,6,0,1,2,5,6,6,10
1998,Bruce Bowen,SF,26,BOS,61,1305,122,298,20,59,102,239,76,122,340
1998,Anthony Bowie,SG,34,NYK,27,224,32,59,3,4,29,55,8,9,75
1998,Shawn Bradley,C,25,DAL,64,1822,300,711,1,3,299,708,130,180,731
1998,Terrell Brandon,PG,27,MIL,50,1784,339,731,31,93,308,638,132,156,841
1998,Tim Breaux,SF,27,MIL,6,30,4,11,1,3,3,8,1,2,10
1998,Scott Brooks,PG,32,CLE,43,312,28,66,5,11,23,55,18,20,79
1998,Chucky Brown,SF,29,ATL,77,1202,161,372,2,8,159,364,63,87,387
1998,Dee Brown,SG,29,TOT,72,1719,246,562,108,271,138,291,58,71,658
1998,Dee Brown,SG,29,BOS,41,811,109,255,43,113,66,142,19,28,280
1998,Dee Brown,SG,29,TOR,31,908,137,307,65,158,72,149,39,43,378
1998,P.J. Brown,PF,28,MIA,74,2362,278,590,0,0,278,590,151,197,707
1998,Randy Brown,PG,29,CHI,71,1147,116,302,0,5,116,297,56,78,288
1998,Rick Brunson,PG,25,POR,38,622,49,141,22,61,27,80,42,62,162
1998,Kobe Bryant,SG,19,LAL,79,2056,391,913,75,220,316,693,363,457,1220
1998,Mark Bryant,C,32,PHO,70,1110,109,225,0,1,109,224,73,95,291
1998,Jud Buechler,SF,29,CHI,74,608,85,176,25,65,60,111,3,6,198
1998,Matt Bullard,SF,30,HOU,67,1190,175,389,96,231,79,158,20,27,466
1998,Scott Burrell,SF,27,CHI,80,1096,159,375,51,144,108,231,47,64,416
1998,Willie Burton,SF,29,SAS,13,43,8,21,3,9,5,12,8,12,27
1998,Mitchell Butler,SG,27,CLE,18,206,15,47,1,6,14,41,6,10,37
1998,Jason Caffey,PF,24,TOT,80,1423,226,466,0,2,226,464,131,200,583
1998,Jason Caffey,PF,24,CHI,51,710,100,199,0,1,100,198,68,103,268
1998,Jason Caffey,PF,24,GSW,29,713,126,267,0,1,126,266,63,97,315
1998,Michael Cage,C,36,NJN,79,1201,43,84,0,1,43,83,20,36,106
1998,Adrian Caldwell,PF,31,DAL,1,3,0,0,0,0,0,0,0,0,0
1998,Marcus Camby,C,23,TOR,63,2002,308,747,0,2,308,745,149,244,765
1998,Elden Campbell,PF,29,LAL,81,1784,289,624,1,2,288,622,237,342,816
1998,Antoine Carr,PF,36,UTA,66,1086,151,325,0,0,151,325,76,98,378
1998,Chris Carr,SG,23,MIN,51,1165,190,452,40,127,150,325,84,99,504
1998,Sam Cassell,PG,28,NJN,75,2606,510,1156,15,80,495,1076,436,507,1471
1998,Kelvin Cato,C,23,POR,74,1007,98,229,0,3,98,226,86,125,282
1998,Duane Causwell,C,29,MIA,37,363,37,89,0,0,37,89,15,26,89
1998,Cedric Ceballos,SF,28,TOT,47,990,204,415,21,70,183,345,107,145,536
1998,Cedric Ceballos,SF,28,PHO,35,626,129,258,15,50,114,208,60,84,333
1998,Cedric Ceballos,SF,28,DAL,12,364,75,157,6,20,69,137,47,61,203
1998,Tom Chambers,PF,38,PHI,1,10,2,2,0,0,2,2,2,2,6
1998,Rex Chapman,SG,30,PHO,68,2263,408,956,120,311,288,645,146,187,1082
1998,Calbert Cheaney,SG,26,WAS,82,2841,448,981,15,53,433,928,139,215,1050
1998,Pete Chilcutt,PF,29,VAN,82,1420,156,359,54,130,102,229,39,59,405
1998,Chris Childs,PG,30,NYK,68,1599,149,354,27,87,122,267,104,126,429
1998,Doug Christie,SG,27,TOR,78,2939,458,1071,100,307,358,764,271,327,1287
1998,Keith Closs,C,21,LAC,58,740,93,207,0,0,93,207,46,77,232
1998,Derrick Coleman,PF,30,PHI,59,2135,356,867,26,98,330,769,302,391,1040
1998,Bimbo Coles,PG,29,GSW,53,1471,166,438,13,57,153,381,78,88,423
1998,James Collins,SG,24,LAC,23,103,21,55,9,20,12,35,8,14,59
1998,Marty Conlon,C,30,MIA,18,209,28,62,0,0,28,62,32,44,88
1998,Tyrone Corbin,SF,35,ATL,79,2699,328,747,49,141,279,606,101,128,806
1998,James Cotton,SG,22,SEA,9,33,8,21,0,4,8,17,8,9,24
1998,Chris Crawford,PF,22,ATL,40,256,46,110,1,3,45,107,57,68,150
1998,Austin Croshere,PF,22,IND,26,243,32,86,4,13,28,73,8,14,76
1998,John Crotty,PG,28,POR,26,379,29,90,6,20,23,70,32,34,96
1998,Terry Cummings,PF,36,TOT,74,1185,200,428,0,1,200,427,67,98,467
1998,Terry Cummings,PF,36,PHI,44,656,97,212,0,1,97,211,39,58,233
1998,Terry Cummings,PF,36,NYK,30,529,103,216,0,0,103,216,28,40,234
1998,William Cunningham,C,23,TOT,7,39,4,9,0,0,4,9,0,0,8
1998,William Cunningham,C,23,UTA,6,38,4,9,0,0,4,9,0,0,8
1998,William Cunningham,C,23,PHI,1,1,0,0,0,0,0,0,0,0,0
1998,Bill Curley,PF,25,MIN,11,146,16,33,0,1,16,32,2,3,34
1998,Dell Curry,SG,33,CHH,52,971,194,434,61,145,133,289,41,52,490
1998,Michael Curry,SG,29,MIL,82,1978,196,418,4,9,192,409,147,176,543
1998,Erick Dampier,C,22,GSW,82,2656,352,791,0,2,352,789,267,399,971
1998,Antonio Daniels,SG,22,VAN,74,1956,228,548,11,52,217,496,112,170,579
1998,Lloyd Daniels,SG,30,TOR,6,82,12,29,2,9,10,20,8,10,34
1998,Yinka Dare,C,25,NJN,10,60,4,18,0,0,4,18,4,8,12
1998,Antonio Davis,PF,29,IND,82,2191,254,528,0,3,254,525,277,398,785
1998,Ben Davis,PF,25,NYK,7,13,2,10,0,0,2,10,0,0,4
1998,Dale Davis,C,28,IND,78,2174,273,498,0,0,273,498,80,172,626
1998,Emanual Davis,PG,29,HOU,45,599,63,142,27,72,36,70,31,37,184
1998,Hubert Davis,SG,27,DAL,81,2378,350,767,101,230,249,537,97,116,898
1998,Mark Davis,SF,24,PHI,71,906,109,244,0,6,109,238,64,101,282
1998,Terry Davis,PF,30,WAS,74,1705,127,256,0,1,127,255,69,119,323
1998,Todd Day,SG,28,MIA,5,69,11,31,2,12,9,19,6,9,30
1998,Andrew DeClercq,C,24,BOS,81,1523,169,340,0,1,169,339,101,168,439
1998,Terry Dehere,PG,26,SAC,77,1410,180,451,50,132,130,319,79,99,489
1998,Vinny Del,SG,31,SAS,54,1721,211,479,17,39,194,440,74,93,513
1998,Bison Dele,C,28,DET,78,2619,531,1040,1,3,530,1037,198,280,1261
1998,Tony Delk,PG,24,TOT,77,1681,314,798,42,157,272,641,111,151,781
1998,Tony Delk,PG,24,CHH,3,34,3,4,1,1,2,3,1,2,8
1998,Tony Delk,PG,24,GSW,74,1647,311,794,41,156,270,638,110,149,773
1998,Vlade Divac,C,29,CHH,64,1805,267,536,3,14,264,522,130,188,667
1998,Sherman Douglas,PG,31,NJN,80,1699,255,515,14,46,241,469,115,172,639
1998,Clyde Drexler*,SG,35,HOU,70,2473,452,1059,106,334,346,725,277,346,1287
1998,Chris Dudley,C,32,NYK,51,858,58,143,0,0,58,143,41,92,157
1998,Joe Dumars*,SG,34,DET,72,2326,329,791,158,426,171,365,127,154,943
1998,Tony Dumas,SG,25,CLE,7,47,6,12,2,4,4,8,0,3,14
1998,Tim Duncan,PF,21,SAS,82,3204,706,1287,0,10,706,1277,319,482,1731
1998,Ledell Eackles,SG,31,WAS,42,547,75,175,16,46,59,129,52,59,218
1998,Tyus Edney,PG,24,BOS,52,623,93,216,3,10,90,206,88,111,277
1998,Blue Edwards,SG,32,VAN,81,1968,326,742,40,120,286,622,180,215,872
1998,Kevin Edwards,SG,32,TOT,39,487,57,165,6,15,51,150,30,35,150
1998,Kevin Edwards,SG,32,NJN,27,352,37,106,4,11,33,95,13,15,91
1998,Kevin Edwards,SG,32,ORL,12,135,20,59,2,4,18,55,17,20,59
1998,Howard Eisley,PG,25,UTA,82,1726,229,519,48,118,181,401,127,149,633
1998,Mario Elie,SF,34,HOU,73,1988,206,456,55,189,151,267,145,174,612
1998,Sean Elliott,SF,29,SAS,36,1012,122,303,34,90,88,213,56,78,334
1998,Dale Ellis,SF,37,SEA,79,1939,348,700,127,274,221,426,111,142,934
1998,Harold Ellis,SF,27,DEN,27,344,62,111,0,4,62,107,40,63,164
1998,LaPhonso Ellis,SF,27,DEN,76,2575,410,1007,57,201,353,806,206,256,1083
1998,Pervis Ellison,PF,30,BOS,33,447,40,70,0,0,40,70,20,34,100
1998,Brian Evans,SF,24,TOT,72,893,123,312,29,87,94,225,46,57,321
1998,Brian Evans,SF,24,ORL,44,561,77,206,12,45,65,161,40,48,206
1998,Brian Evans,SF,24,NJN,28,332,46,106,17,42,29,64,6,9,115
1998,Patrick Ewing*,C,35,NYK,26,848,203,403,0,2,203,401,134,186,540
1998,Tony Farmer,C,28,CHH,27,169,17,53,2,9,15,44,31,39,67
1998,Jamie Feick,PF,23,MIL,45,450,39,90,4,13,35,77,20,41,102
1998,Duane Ferrell,SF,32,GSW,50,461,41,111,0,6,41,105,12,22,94
1998,Danny Ferry,PF,31,CLE,69,1034,113,286,33,99,80,187,32,40,291
1998,Michael Finley,SF,24,DAL,82,3394,675,1505,87,244,588,1261,326,416,1763
1998,Derek Fisher,PG,23,LAL,82,1760,164,378,31,81,133,297,115,152,474
1998,Danny Fortson,PF,21,DEN,80,1811,276,611,1,3,275,608,263,339,816
1998,Greg Foster,C,29,UTA,78,1446,186,418,2,9,184,409,67,87,441
1998,Rick Fox,SF,28,LAL,82,2709,363,771,86,265,277,506,171,230,983
1998,Adonal Foyle,C,22,GSW,55,656,69,170,0,1,69,169,27,62,165
1998,Todd Fuller,C,23,GSW,57,613,86,205,0,4,86,201,55,80,227
1998,Lawrence Funderburke,PF,27,SAC,52,1094,191,390,1,7,190,383,110,162,493
1998,Chris Garner,PG,22,TOR,38,293,23,70,4,14,19,56,3,7,53
1998,Kevin Garnett,PF,21,MIN,82,3222,635,1293,3,16,632,1277,245,332,1518
1998,Dean Garrett,C,31,DEN,82,2632,242,565,0,0,242,565,114,176,598
1998,Kiwane Garris,SG,23,DEN,28,225,22,65,5,14,17,51,19,25,68
1998,Chris Gatling,PF,30,NJN,57,1359,248,545,1,4,247,541,159,265,656
1998,Reggie Geary,PG,24,SAS,62,685,56,169,12,40,44,129,28,56,152
1998,Matt Geiger,C,28,CHH,78,1839,358,709,1,11,357,698,168,236,885
1998,Kendall Gill,SF,29,NJN,81,2733,418,974,26,101,392,873,225,327,1087
1998,Armen Gilliam,PF,33,MIL,82,2114,327,676,0,4,327,672,267,333,921
1998,Anthony Goldwire,PG,26,DEN,82,2212,269,636,63,164,206,472,150,186,751
1998,Greg Graham,SG,27,CLE,6,56,7,12,0,3,7,9,2,2,16
1998,Brian Grant,SF,25,POR,61,1921,283,557,0,1,283,556,171,228,737
1998,Gary Grant,PG,32,POR,22,359,43,93,7,19,36,74,12,14,105
1998,Harvey Grant,SF,32,WAS,65,895,75,196,1,6,74,190,19,30,170
1998,Horace Grant,C,32,ORL,76,2803,393,857,0,7,393,850,135,199,921
1998,Ed Gray,SG,22,ATL,30,472,77,202,18,46,59,156,55,65,227
1998,Jeff Grayer,SG,32,TOT,5,34,4,11,2,6,2,5,0,0,10
1998,Jeff Grayer,SG,32,CHH,1,11,0,4,0,3,0,1,0,0,0
1998,Jeff Grayer,SG,32,GSW,4,23,4,7,2,3,2,4,0,0,10
1998,A.C. Green,PF,34,DAL,82,2649,242,534,0,4,242,530,116,162,600
1998,Litterial Green,PG,27,MIL,21,124,5,23,0,2,5,21,15,20,25
1998,Derek Grimm,SF,23,SAC,9,34,4,14,4,12,0,2,2,2,14
1998,Tom Gugliotta,SF,28,MIN,41,1582,319,635,2,17,317,618,183,223,823
1998,Jack Haley,C,34,NJN,16,51,5,18,0,1,5,17,12,21,22
1998,Darvin Ham,SF,24,WAS,71,635,55,104,0,0,55,104,35,74,145
1998,Tom Hammonds,PF,30,MIN,57,1140,127,246,0,1,127,245,92,132,346
1998,Reggie Hanson,SF,29,BOS,8,26,3,6,0,0,3,6,0,0,6
1998,Anfernee Hardaway,SG,26,ORL,19,625,103,273,15,50,88,223,90,118,311
1998,Tim Hardaway,PG,31,MIA,81,3031,558,1296,155,442,403,854,257,329,1528
1998,Derek Harper,SG,36,ORL,66,1761,226,542,59,164,167,378,55,79,566
1998,Ron Harper,PG,34,CHI,82,2284,293,665,16,84,277,581,162,216,764
1998,Othella Harrington,PF,24,HOU,58,903,129,266,0,1,129,265,92,122,350
1998,Lucious Harris,SG,27,NJN,50,671,69,177,12,39,57,138,41,55,191
1998,Hersey Hawkins,SG,31,SEA,82,2597,280,636,125,301,155,335,177,204,862
1998,Alan Henderson,PF,25,ATL,69,2000,365,753,3,6,362,747,253,388,986
1998,Cedric Henderson,SF,22,CLE,82,2527,348,725,0,4,348,721,136,190,832
1998,Mark Hendrickson,PF,23,SAC,48,737,58,149,0,5,58,144,47,57,163
1998,Steve Henson,PG,29,DET,23,65,13,26,3,8,10,18,7,7,36
1998,Carl Herrera,PF,31,SAS,58,516,76,175,0,1,76,174,18,44,170
1998,Sean Higgins,SF,29,POR,2,12,0,5,0,2,0,3,0,0,0
1998,Grant Hill,SF,25,DET,81,3294,615,1361,3,21,612,1340,479,647,1712
1998,Tyrone Hill,PF,29,MIL,57,2064,208,418,0,1,208,417,155,255,571
1998,Fred Hoiberg,SG,25,IND,65,874,85,222,32,85,53,137,59,69,261
1998,Jerald Honeycutt,PF,23,MIL,38,530,90,221,29,77,61,144,36,58,245
1998,Jeff Hornacek,SG,34,UTA,80,2460,399,828,56,127,343,701,285,322,1139
1998,Robert Horry,PF,27,LAL,72,2192,200,420,19,93,181,327,117,169,536
1998,Allan Houston,SG,26,NYK,82,2848,571,1277,82,213,489,1064,285,335,1509
1998,Juwan Howard,PF,24,WAS,64,2559,463,991,0,2,463,989,258,358,1184
1998,Stephen Howard,SF,27,SEA,13,53,8,21,0,0,8,21,9,18,25
1998,Troy Hudson,PG,21,UTA,8,23,6,14,0,3,6,11,0,0,12
1998,Lindsey Hunter,PG,27,DET,71,2505,316,826,85,265,231,561,145,196,862
1998,Bobby Hurley,PG,26,TOT,61,875,93,238,5,22,88,216,59,76,250
1998,Bobby Hurley,PG,26,SAC,34,417,47,115,4,15,43,100,30,37,128
1998,Bobby Hurley,PG,26,VAN,27,458,46,123,1,7,45,116,29,39,122
1998,Zydrunas Ilgauskas,C,22,CLE,82,2379,454,876,1,4,453,872,230,302,1139
1998,Allen Iverson*,PG,22,PHI,80,3150,649,1407,70,235,579,1172,390,535,1758
1998,Bobby Jackson,PG,24,DEN,68,2042,310,791,21,81,289,710,149,183,790
1998,Jaren Jackson,SG,30,SAS,82,2226,258,654,112,297,146,357,94,118,722
1998,Jim Jackson,SG,27,TOT,79,3046,476,1107,61,191,415,916,229,282,1242
1998,Jim Jackson,SG,27,PHI,48,1788,246,535,39,112,207,423,126,154,657
1998,Jim Jackson,SG,27,GSW,31,1258,230,572,22,79,208,493,103,128,585
1998,Mark Jackson,PG,32,IND,82,2413,249,598,43,137,206,461,137,180,678
1998,Henry James,PF,32,CLE,28,166,24,59,11,25,13,34,21,22,80
1998,Anthony Johnson,PG,23,SAC,77,2266,226,609,42,128,184,481,80,110,574
1998,Avery Johnson,PG,32,SAS,75,2674,321,671,2,13,319,658,122,168,766
1998,Eddie Johnson,SF,38,HOU,75,1490,227,544,66,198,161,346,113,136,633
1998,Ervin Johnson,C,30,MIL,81,2261,253,471,0,0,253,471,143,238,649
1998,Kevin Johnson,PG,31,PHO,50,1290,155,347,4,26,151,321,162,186,476
1998,Larry Johnson,SF,28,NYK,70,2412,429,884,15,63,414,821,214,283,1087
1998,Charles Jones,PF,40,HOU,24,127,7,10,0,0,7,10,1,2,15
1998,Dontae' Jones,SF,22,BOS,15,91,19,57,6,23,13,34,0,0,44
1998,Eddie Jones,SG,26,LAL,80,2910,486,1005,143,368,343,637,234,306,1349
1998,Popeye Jones,PF,27,TOR,14,352,52,127,2,3,50,124,14,19,120
1998,Michael Jordan*,SG,34,CHI,82,3181,881,1893,30,126,851,1767,565,721,2357
1998,Reggie Jordan,SG,30,MIN,57,487,54,113,0,1,54,112,41,72,149
1998,Adam Keefe,C,27,UTA,80,2047,229,424,0,0,229,424,162,200,620
1998,Shawn Kemp,PF,28,CLE,80,2769,518,1164,2,8,516,1156,404,556,1442
1998,Tim Kempton,PF,34,TOT,8,47,2,9,0,0,2,9,0,0,4
1998,Tim Kempton,PF,34,ORL,3,15,0,2,0,0,0,2,0,0,0
1998,Tim Kempton,PF,34,TOR,5,32,2,7,0,0,2,7,0,0,4
1998,Steve Kerr,PG,32,CHI,50,1119,137,302,57,130,80,172,45,49,376
1998,Jerome Kersey,SF,35,SEA,37,717,97,233,1,10,96,223,39,65,234
1998,Jason Kidd,PG,24,PHO,82,3118,357,859,73,233,284,626,167,209,954
1998,Kerry Kittles,SG,23,NJN,77,2814,508,1154,110,263,398,891,202,250,1328
1998,Joe Kleine,C,36,CHI,46,397,39,106,0,0,39,106,15,18,93
1998,Brevin Knight,PG,22,CLE,80,2483,261,592,0,7,261,585,201,251,723
1998,Travis Knight,C,23,BOS,74,1503,193,438,15,55,178,383,81,103,482
1998,Toni Kukoc,SF,29,CHI,74,2235,383,841,63,174,320,667,155,219,984
1998,Christian Laettner,PF,28,ATL,74,2282,354,730,6,27,348,703,306,354,1020
1998,Andrew Lang,C,31,MIL,57,692,54,143,0,1,54,142,44,57,152
1998,Antonio Lang,SF,25,MIA,6,29,3,5,0,0,3,5,6,8,12
1998,Rusty LaRue,PG,24,CHI,14,140,20,49,4,16,16,33,5,8,49
1998,Priest Lauderdale,C,24,DEN,39,345,53,127,0,0,53,127,38,69,144
1998,Jason Lawson,C,23,ORL,17,80,9,15,0,0,9,15,8,10,26
1998,Tim Legler,SG,31,WAS,8,76,3,19,0,6,3,13,3,4,9
1998,Voshon Lenard,SG,24,MIA,81,2621,363,854,153,378,210,476,141,179,1020
1998,Alton Lister,C,39,POR,7,44,3,8,0,0,3,8,0,0,6
1998,Randy Livingston,PG,22,ATL,12,82,3,12,0,0,3,12,4,5,10
1998,Horacio Llamas,C,24,PHO,8,42,8,21,1,3,7,18,7,10,24
1998,Brad Lohaus,PF,33,SAS,9,102,7,21,4,14,3,7,1,3,19
1998,Grant Long,PF,31,DET,40,739,50,117,0,4,50,113,41,57,141
1998,Luc Longley,C,29,CHI,58,1703,277,609,0,0,277,609,109,148,663
1998,George Lynch,SF,27,VAN,82,1493,248,516,9,30,239,486,111,158,616
1998,Sam Mack,SF,27,VAN,57,1414,222,559,110,269,112,290,62,77,616
1998,Don MacLean,SF,28,NJN,9,42,1,10,1,2,0,8,0,0,3
1998,Gerald Madkins,SG,28,GSW,19,243,13,34,6,15,7,19,5,7,37
1998,Rick Mahorn,C,39,DET,59,707,59,129,0,0,59,129,23,34,141
1998,Dan Majerle,SG,32,MIA,72,1928,184,439,111,295,73,144,40,51,519
1998,Karl Malone*,PF,34,UTA,81,3030,780,1472,2,6,778,1466,628,825,2190
1998,Matt Maloney,PG,26,HOU,78,2217,239,586,126,346,113,240,65,78,669
1998,Danny Manning,PF,31,PHO,70,1794,390,756,0,7,390,749,167,226,947
1998,Stephon Marbury,PG,20,MIN,82,3112,513,1237,95,304,418,933,329,450,1450
1998,Donyell Marshall,SF,24,GSW,73,2611,451,1090,63,201,388,889,158,216,1123
1998,Darrick Martin,PG,26,LAC,82,2299,275,730,107,293,168,437,184,217,841
1998,Jamal Mashburn,SF,25,MIA,48,1729,251,577,37,122,214,455,184,231,723
1998,Anthony Mason,PF,31,CHH,81,3148,389,764,0,4,389,760,261,402,1039
1998,Tony Massenburg,C,30,VAN,61,894,148,309,0,0,148,309,100,137,396
1998,Vernon Maxwell,SG,32,TOT,42,636,103,258,37,112,66,146,48,60,291
1998,Vernon Maxwell,SG,32,ORL,11,169,26,78,6,26,20,52,23,26,81
1998,Vernon Maxwell,SG,32,CHH,31,467,77,180,31,86,46,94,25,34,210
1998,Lee Mayberry,PG,27,VAN,79,1835,131,349,63,180,68,169,38,51,363
1998,Bob McCann,SF,33,TOR,1,5,0,1,0,0,0,1,0,0,0
1998,Walter McCarty,SF,23,BOS,82,2340,295,730,54,175,241,555,144,194,788
1998,George McCloud,SF,30,PHO,63,1213,173,427,71,208,102,219,39,51,456
1998,Xavier McDaniel,SF,34,NJN,20,180,10,30,0,0,10,30,5,8,25
1998,Michael McDonald,C,28,CHH,1,4,0,0,0,0,0,0,0,0,0
1998,Antonio McDyess,PF,23,PHO,81,2441,497,927,0,2,497,925,231,329,1225
1998,Tracy McGrady,SF,18,TOR,64,1179,179,398,14,41,165,357,79,111,451
1998,Jim McIlvaine,C,25,SEA,78,1211,101,223,0,3,101,220,45,81,247
1998,Derrick McKey,SF,31,IND,57,1316,150,327,4,17,146,310,55,77,359
1998,Aaron McKie,SG-SF,25,TOT,81,1813,139,381,12,63,127,318,42,55,332
1998,Aaron McKie,SF,25,DET,24,472,43,104,3,17,40,87,20,23,109
1998,Aaron McKie,SG,25,PHI,57,1341,96,277,9,46,87,231,22,32,223
1998,Nate McMillan,SG,33,SEA,18,279,23,67,15,34,8,33,1,1,62
1998,Ron Mercer,SG,21,BOS,80,2662,515,1145,3,28,512,1117,188,224,1221
1998,Marko Milic,SF,20,PHO,33,163,39,64,3,6,36,58,11,17,92
1998,Anthony Miller,PF,26,ATL,37,228,29,52,0,0,29,52,21,39,79
1998,Oliver Miller,C,27,TOR,64,1628,170,369,0,4,170,365,61,101,401
1998,Reggie Miller*,SG,32,IND,81,2795,516,1081,164,382,352,699,382,440,1578
1998,Chris Mills,SF,28,NYK,80,2183,292,675,40,137,252,538,152,189,776
1998,Terry Mills,PF,30,MIA,50,782,81,206,25,81,56,125,25,33,212
1998,Greg Minor,SG,26,BOS,69,1126,140,321,6,31,134,290,59,86,345
1998,Sam Mitchell,SF,34,MIN,81,2239,371,800,15,43,356,757,243,292,1000
1998,Eric Montross,C,26,TOT,48,691,61,144,0,0,61,144,16,40,138
1998,Eric Montross,C,26,PHI,20,337,30,76,0,0,30,76,7,19,67
1998,Eric Montross,C,26,DET,28,354,31,68,0,0,31,68,9,21,71
1998,Chris Morris,SF,32,UTA,54,538,85,207,19,62,66,145,44,61,233
1998,Lawrence Moten,SG,25,WAS,8,27,3,13,0,1,3,12,3,4,9
1998,Alonzo Mourning*,C,27,MIA,58,1939,403,732,0,0,403,732,309,465,1115
1998,Chris Mullin*,SF,34,IND,82,2177,333,692,107,243,226,449,154,164,927
1998,Eric Murdock,PG,29,MIA,82,1395,177,419,28,91,149,328,125,156,507
1998,Lamond Murray,SF,24,LAC,79,2579,473,984,54,153,419,831,220,294,1220
1998,Tracy Murray,SF,26,WAS,82,2227,449,1007,158,403,291,604,182,209,1238
1998,Dikembe Mutombo*,C,31,ATL,82,2917,399,743,0,0,399,743,303,452,1101
1998,Martin Muursepp,PF,23,DAL,41,603,83,191,16,38,67,153,51,67,233
1998,Pete Myers,SG,34,NYK,9,40,5,10,0,0,5,10,4,6,14
1998,Steve Nash,PG,23,PHO,76,1664,268,584,81,195,187,389,74,86,691
1998,Ivano Newbill,PF,27,VAN,28,249,20,57,1,1,19,56,17,30,58
1998,Johnny Newman,SF,34,DEN,74,2176,344,799,36,105,308,694,365,445,1089
1998,Jeff Nordgaard,PF,24,MIL,13,48,5,18,0,0,5,18,8,9,18
1998,Charles O'Bannon,SG,22,DET,30,234,26,69,0,3,26,66,12,15,64
1998,Jermaine O'Neal,PF,19,POR,60,808,112,231,0,2,112,229,45,89,269
1998,Shaquille O'Neal*,C,25,LAL,60,2175,670,1147,0,0,670,1147,359,681,1699
1998,Charles Oakley,PF,34,NYK,79,2734,307,698,0,6,307,692,97,114,711
1998,Hakeem Olajuwon*,C,35,HOU,47,1633,306,633,0,3,306,630,160,212,772
1998,Brian Oliver,SG,29,ATL,5,61,7,19,0,0,7,19,1,4,15
1998,Jimmy Oliver,SG,28,WAS,1,10,2,4,1,2,1,2,0,0,5
1998,Kevin Ollie,PG,25,TOT,35,430,37,98,0,1,37,97,49,70,123
1998,Kevin Ollie,PG,25,DAL,16,214,14,42,0,0,14,42,18,25,46
1998,Kevin Ollie,PG,25,ORL,19,216,23,56,0,1,23,55,31,45,77
1998,Greg Ostertag,C,24,UTA,63,1288,115,239,0,0,115,239,67,140,297
1998,Bo Outlaw,PF,26,ORL,82,2953,301,543,1,4,300,539,180,313,783
1998,Doug Overton,PG,28,PHI,23,277,24,63,0,3,24,60,14,16,62
1998,Billy Owens,SF,28,SAC,78,2348,338,728,26,70,312,658,116,197,818
1998,Robert Pack,PG,28,DAL,12,292,33,98,3,6,30,92,25,36,94
1998,Anthony Parker,SG,22,PHI,37,196,25,63,9,28,16,35,13,20,72
1998,Cherokee Parks,C,25,MIN,79,1703,224,449,0,1,224,448,110,169,558
1998,Gary Payton*,PG,29,SEA,82,3145,579,1278,134,397,445,881,279,375,1571
1998,Anthony Peeler,SG,28,TOT,38,1193,190,420,53,125,137,295,36,47,469
1998,Anthony Peeler,SG,28,VAN,8,202,35,72,5,19,30,53,4,6,79
1998,Anthony Peeler,SG,28,MIN,30,991,155,348,48,106,107,242,32,41,390
1998,Will Perdue,C,32,SAS,79,1491,162,295,0,1,162,294,70,133,394
1998,Sam Perkins,PF,36,SEA,81,1675,196,471,87,222,109,249,101,128,580
1998,Elliot Perry,PG,28,MIL,81,1752,241,561,17,50,224,511,92,109,591
1998,Chuck Person,PF,33,SAS,61,1455,143,398,95,276,48,122,28,37,409
1998,Wesley Person,SG,26,CLE,82,3198,440,957,192,447,248,510,132,170,1204
1998,Bobby Phills,SG,28,CHH,62,1887,246,552,44,114,202,438,106,140,642
1998,Eric Piatkowski,SG,27,LAC,67,1740,257,568,106,259,151,309,140,170,760
1998,Ricky Pierce,SG,38,MIL,39,442,52,143,4,13,48,130,43,52,151
1998,Scottie Pippen*,SF,32,CHI,44,1652,315,704,61,192,254,512,150,193,841
1998,Scot Pollard,C,22,DET,33,317,35,70,0,0,35,70,19,23,89
1998,Olden Polynice,C,33,SAC,70,1458,249,542,0,1,249,541,52,115,550
1998,Mark Pope,SF,25,IND,28,193,14,41,1,3,13,38,10,17,39
1998,Terry Porter,PG,34,MIN,82,1786,259,577,92,233,167,344,167,195,777
1998,Vitaly Potapenko,C,22,CLE,80,1412,234,488,0,1,234,487,102,144,570
1998,Brent Price,PG,29,HOU,72,1332,128,310,73,187,55,123,77,98,406
1998,Mark Price,PG,33,ORL,63,1430,229,531,52,155,177,376,87,103,597
1998,Theo Ratliff,C,24,TOT,82,2447,306,597,0,0,306,597,197,281,809
1998,Theo Ratliff,C,24,DET,24,586,57,111,0,0,57,111,43,63,157
1998,Theo Ratliff,C,24,PHI,58,1861,249,486,0,0,249,486,154,218,652
1998,Eldridge Recasner,SG,30,ATL,59,1454,206,452,62,148,144,304,74,79,548
1998,Bryant Reeves,C,24,VAN,74,2527,492,941,0,4,492,937,223,316,1207
1998,Khalid Reeves,PG,25,DAL,82,1950,248,593,56,152,192,441,165,213,717
1998,Don Reid,PF,24,DET,68,994,94,176,0,0,94,176,50,71,238
1998,J.R. Reid,PF,29,CHH,79,1109,146,318,3,8,143,310,89,122,384
1998,Shawn Respert,SG,25,TOT,57,911,130,293,31,93,99,200,48,61,339
1998,Shawn Respert,SG,25,TOR,47,696,94,209,25,67,69,142,44,54,257
1998,Shawn Respert,SG,25,DAL,10,215,36,84,6,26,30,58,4,7,82
1998,Rodrick Rhodes,SF,24,HOU,58,1070,112,305,2,8,110,297,111,180,337
1998,Glen Rice,SF,30,CHH,82,3295,634,1386,130,300,504,1086,428,504,1826
1998,Pooh Richardson,PG,31,LAC,69,1252,124,333,11,57,113,276,30,43,289
1998,Mitch Richmond*,SG,32,SAC,70,2569,543,1220,130,334,413,886,407,471,1623
1998,Isaiah Rider,SG,26,POR,74,2786,551,1302,135,420,416,882,221,267,1458
1998,Eric Riley,C,27,DAL,39,544,56,135,0,1,56,134,27,36,139
1998,Stanley Roberts,C,27,MIN,74,1328,191,386,0,0,191,386,75,156,457
1998,Chris Robinson,SG,23,TOT,35,414,65,174,24,66,41,108,8,16,162
1998,Chris Robinson,SG,23,VAN,16,143,23,63,7,24,16,39,1,2,54
1998,Chris Robinson,SG,23,SAC,19,271,42,111,17,42,25,69,7,14,108
1998,Clifford Robinson,SF,31,PHO,80,2359,429,895,27,84,402,811,248,360,1133
1998,David Robinson*,C,32,SAS,73,2457,544,1065,1,4,543,1061,485,660,1574
1998,Glenn Robinson,SF,25,MIL,56,2294,534,1136,25,65,509,1071,215,266,1308
1998,James Robinson,PG,27,LAC,70,1231,195,501,74,225,121,276,77,107,541
1998,Larry Robinson,SF,30,VAN,6,41,6,19,3,6,3,13,2,2,17
1998,Dennis Rodman*,PF,36,CHI,80,2856,155,360,4,23,151,337,61,111,375
1998,Carlos Rogers,PF,26,TOT,21,376,47,91,0,2,47,89,18,32,112
1998,Carlos Rogers,PF,26,TOR,18,351,45,87,0,1,45,86,18,32,108
1998,Carlos Rogers,PF,26,POR,3,25,2,4,0,1,2,3,0,0,4
1998,Rodney Rogers,SF,26,LAC,76,2499,426,935,72,212,354,723,225,328,1149
1998,Roy Rogers,PF,24,TOT,15,106,9,25,0,0,9,25,2,6,20
1998,Roy Rogers,PF,24,BOS,9,37,3,8,0,0,3,8,1,2,7
1998,Roy Rogers,PF,24,TOR,6,69,6,17,0,0,6,17,1,4,13
1998,Sean Rooks,C,28,LAL,41,425,46,101,0,0,46,101,47,79,139
1998,Jalen Rose,SF,25,IND,82,1706,290,607,25,73,265,534,166,228,771
1998,Malik Rose,PF,23,SAS,53,429,59,136,1,3,58,133,39,61,158
1998,Donald Royal,SF,31,TOT,31,323,25,69,0,0,25,69,29,33,79
1998,Donald Royal,SF,31,ORL,2,18,1,6,0,0,1,6,3,4,5
1998,Donald Royal,SF,31,CHH,29,305,24,63,0,0,24,63,26,29,74
1998,Clifford Rozier,C,25,MIN,6,30,3,6,0,0,3,6,0,1,6
1998,Bryon Russell,SF,27,UTA,82,2219,226,525,73,214,153,311,213,278,738
1998,Arvydas Sabonis*,C,33,POR,73,2333,407,826,30,115,377,711,323,405,1167
1998,Kevin Salvadori,C,27,SAC,16,87,1,13,0,0,1,13,3,6,5
1998,Danny Schayes,C,38,ORL,74,1272,155,371,0,0,155,371,96,119,406
1998,Detlef Schrempf,SF,35,SEA,78,2742,437,898,61,147,376,751,297,352,1232
1998,Dennis Scott,SF,29,TOT,81,2290,329,828,125,342,204,486,105,130,888
1998,Dennis Scott,SF,29,DAL,52,1797,258,666,94,273,164,393,97,118,707
1998,Dennis Scott,SF,29,PHO,29,493,71,162,31,69,40,93,8,12,181
1998,Shawnelle Scott,C,25,CLE,41,188,16,36,0,0,16,36,12,18,44
1998,Shea Seals,SG,22,LAL,4,9,1,8,0,3,1,5,2,4,4
1998,Malik Sealy,SF,27,DET,77,1641,216,505,9,41,207,464,150,182,591
1998,Rony Seikaly,C,32,TOT,56,1636,250,579,0,2,250,577,246,332,746
1998,Rony Seikaly,C,32,ORL,47,1484,237,538,0,2,237,536,230,305,704
1998,Rony Seikaly,C,32,NJN,9,152,13,41,0,0,13,41,16,27,42
1998,God Shammgod,PG,21,WAS,20,146,19,58,0,2,19,56,23,30,61
1998,Brian Shaw,PG,31,TOT,59,1530,154,446,28,95,126,351,36,52,372
1998,Brian Shaw,PG,31,GSW,39,1028,103,307,21,67,82,240,24,33,251
1998,Brian Shaw,PG,31,PHI,20,502,51,139,7,28,44,111,12,19,121
1998,Dickey Simpkins,PF,25,TOT,40,433,48,89,0,2,48,87,36,70,132
1998,Dickey Simpkins,PF,25,GSW,19,196,22,48,0,1,22,47,10,26,54
1998,Dickey Simpkins,PF,25,CHI,21,237,26,41,0,1,26,40,26,44,78
1998,Reggie Slater,PF,27,TOR,78,1662,211,459,0,0,211,459,203,322,625
1998,Charles Smith,SG,22,TOT,34,292,49,125,15,47,34,78,6,11,119
1998,Charles Smith,SG,22,MIA,11,32,4,18,1,3,3,15,1,2,10
1998,Charles Smith,SG,22,LAC,23,260,45,107,14,44,31,63,5,9,109
1998,Joe Smith,PF,22,TOT,79,2344,464,1070,0,8,464,1062,227,293,1155
1998,Joe Smith,PF,22,GSW,49,1645,343,800,0,7,343,793,160,208,846
1998,Joe Smith,PF,22,PHI,30,699,121,270,0,1,121,269,67,85,309
1998,Michael Smith,PF,25,TOT,48,1053,93,194,0,1,93,193,65,103,251
1998,Michael Smith,PF,25,SAC,18,347,26,61,0,0,26,61,17,30,69
1998,Michael Smith,PF,25,VAN,30,706,67,133,0,1,67,132,48,73,182
1998,Steve Smith,SG,28,ATL,73,2857,489,1101,97,276,392,825,389,455,1464
1998,Tony Smith,PG,29,MIL,7,80,8,24,0,4,8,20,3,4,19
1998,Rik Smits,C,31,IND,73,2085,514,1038,0,3,514,1035,188,240,1216
1998,Eric Snow,PG,24,TOT,64,918,79,184,2,17,77,167,49,71,209
1998,Eric Snow,PG,24,SEA,17,74,10,23,0,1,10,22,5,10,25
1998,Eric Snow,PG,24,PHI,47,844,69,161,2,16,67,145,44,61,184
1998,Felton Spencer,C,30,GSW,68,813,59,129,0,0,59,129,44,79,162
1998,Latrell Sprewell,SG,27,GSW,14,547,110,277,9,48,101,229,70,94,299
1998,Jerry Stackhouse,SG-SF,23,TOT,79,2545,424,975,47,195,377,780,354,450,1249
1998,Jerry Stackhouse,SF,23,PHI,22,748,128,283,16,46,112,237,81,101,353
1998,Jerry Stackhouse,SG,23,DET,57,1797,296,692,31,149,265,543,273,349,896
1998,John Starks,SG,32,NYK,82,2188,372,947,130,398,242,549,185,235,1059
1998,Joe Stephens,SF,25,HOU,7,37,10,28,3,10,7,18,4,6,27
1998,Kebu Stewart,PF,24,PHI,15,110,12,26,0,0,12,26,16,25,40
1998,Michael Stewart,C,22,SAC,81,1761,155,323,0,0,155,323,65,142,375
1998,Bryant Stith,SG,27,DEN,31,718,75,225,10,48,65,177,75,86,235
1998,John Stockton*,PG,35,UTA,64,1858,270,511,39,91,231,420,191,231,770
1998,Ed Stokes,C,26,TOR,4,17,1,3,0,0,1,3,1,2,3
1998,Damon Stoudamire,PG,24,TOT,71,2839,448,1091,91,304,357,787,238,287,1225
1998,Damon Stoudamire,PG,24,TOR,49,2033,354,833,65,205,289,628,179,212,952
1998,Damon Stoudamire,PG,24,POR,22,806,94,258,26,99,68,159,59,75,273
1998,Erick Strickland,SG,24,DAL,67,1505,199,558,48,163,151,395,65,84,511
1998,Mark Strickland,PF,27,MIA,51,847,145,269,0,1,145,268,59,82,349
1998,Rod Strickland,PG,31,WAS,76,3020,490,1130,12,48,478,1082,357,492,1349
1998,Derek Strong,PF,29,ORL,58,1638,259,617,0,4,259,613,218,279,736
1998,Bob Sura,SG,24,CLE,46,942,87,231,19,60,68,171,74,131,267
1998,Zan Tabak,C,27,TOT,57,984,142,304,0,1,142,303,23,61,307
1998,Zan Tabak,C,27,TOR,39,752,116,249,0,1,116,248,16,48,248
1998,Zan Tabak,C,27,BOS,18,232,26,55,0,0,26,55,7,13,59
1998,Johnny Taylor,SF,23,ORL,12,108,13,37,1,2,12,35,11,16,38
1998,Maurice Taylor,PF,21,LAC,71,1513,321,675,0,1,321,674,173,244,815
1998,Carl Thomas,SG,28,TOT,43,426,56,140,20,59,36,81,16,25,148
1998,Carl Thomas,SG,28,GSW,10,139,25,65,5,21,20,44,7,10,62
1998,Carl Thomas,SG,28,ORL,4,15,4,5,0,0,4,5,1,2,9
1998,Carl Thomas,SG,28,CLE,29,272,27,70,15,38,12,32,8,13,77
1998,John Thomas,PF,22,TOT,54,535,55,113,0,0,55,113,41,54,151
1998,John Thomas,PF,22,BOS,33,368,41,80,0,0,41,80,26,33,108
1998,John Thomas,PF,22,TOR,21,167,14,33,0,0,14,33,15,21,43
1998,Kurt Thomas,PF,25,DAL,5,73,17,45,0,0,17,45,3,3,37
1998,Tim Thomas,SF,20,PHI,77,1779,306,684,62,171,244,513,171,231,845
1998,Brooks Thompson,PG,27,TOT,30,167,23,56,9,30,14,26,4,8,59
1998,Brooks Thompson,PG,27,PHO,13,46,10,27,5,16,5,11,1,3,26
1998,Brooks Thompson,PG,27,NYK,17,121,13,29,4,14,9,15,3,5,33
1998,Otis Thorpe,PF,35,TOT,74,2197,294,624,0,5,294,619,164,240,752
1998,Otis Thorpe,PF,35,VAN,47,1574,205,430,0,4,205,426,118,170,528
1998,Otis Thorpe,PF,35,SAC,27,623,89,194,0,1,89,193,46,70,224
1998,Gary Trent,PF,23,TOT,54,1360,241,505,4,12,237,493,144,212,630
1998,Gary Trent,PF,23,POR,41,1005,177,359,4,9,173,350,113,163,471
1998,Gary Trent,PF,23,TOR,13,355,64,146,0,3,64,143,31,49,159
1998,Nick Van,PG,26,LAL,64,2053,311,743,123,316,188,427,136,172,881
1998,Keith Van,PF,22,NJN,62,2325,446,1047,69,224,377,823,258,305,1219
1998,David Vaughn,PF,24,TOT,40,489,66,148,0,1,66,147,30,47,162
1998,David Vaughn,PF,24,GSW,22,322,46,114,0,1,46,113,22,34,114
1998,David Vaughn,PF,24,CHI,3,6,1,1,0,0,1,1,2,4,4
1998,David Vaughn,PF,24,NJN,15,161,19,33,0,0,19,33,6,9,44
1998,Jacque Vaughn,PG,22,UTA,45,419,44,122,3,8,41,114,48,68,139
1998,Loy Vaught,PF,29,LAC,10,265,36,84,0,2,36,82,3,8,75
1998,Stojko Vrankovic,C,34,LAC,65,996,79,186,0,0,79,186,37,65,195
1998,Antoine Walker,PF,21,BOS,82,3268,722,1705,91,292,631,1413,305,473,1840
1998,Samaki Walker,PF,21,DAL,41,1027,156,321,0,1,156,320,53,97,365
1998,Ben Wallace,C,23,WAS,67,1124,85,164,0,0,85,164,35,98,205
1998,John Wallace,SF,23,TOR,82,2361,468,979,1,2,467,977,210,293,1147
1998,Rasheed Wallace,PF,23,POR,77,2896,466,875,8,39,458,836,184,278,1124
1998,Rex Walters,SG,27,TOT,38,235,24,53,6,22,18,31,26,28,80
1998,Rex Walters,SG,27,PHI,19,127,11,29,3,14,8,15,17,17,42
1998,Rex Walters,SG,27,MIA,19,108,13,24,3,8,10,16,9,11,38
1998,Charlie Ward,PG,27,NYK,82,2317,235,516,81,215,154,301,91,113,642
1998,Eric Washington,SG,23,DEN,66,1539,201,498,44,137,157,361,65,83,511
1998,Clarence Weatherspoon,PF,27,TOT,79,2325,268,608,0,0,268,608,200,277,736
1998,Clarence Weatherspoon,PF,27,PHI,48,1290,141,331,0,0,141,331,123,174,405
1998,Clarence Weatherspoon,PF,27,GSW,31,1035,127,277,0,0,127,277,77,103,331
1998,Spud Webb,PG,34,ORL,4,34,5,12,0,1,5,11,2,2,12
1998,Chris Webber,C,24,WAS,71,2809,647,1341,65,205,582,1136,196,333,1555
1998,Bubba Wells,SG,23,DAL,39,395,48,116,1,6,47,110,31,43,128
1998,Bill Wennington,C,34,CHI,48,467,75,172,0,0,75,172,17,21,167
1998,David Wesley,PG,27,CHH,81,2845,383,864,59,170,324,694,229,288,1054
1998,Doug West,SG,30,MIN,38,688,64,171,0,2,64,169,29,40,157
1998,Mark West,C,37,IND,15,105,10,21,0,0,10,21,3,6,23
1998,DeJuan Wheat,PG,24,MIN,34,150,20,50,8,17,12,33,9,15,57
1998,Donald Whiteside,PG,28,ATL,3,16,1,2,0,1,1,1,0,2,2
1998,Chris Whitney,PG,26,WAS,82,1073,126,355,52,169,74,186,118,129,422
1998,Gerald Wilkins,SG,34,ORL,72,1252,141,434,29,109,112,325,69,98,380
1998,Aaron Williams,PF,26,SEA,65,757,115,220,0,1,115,219,66,85,296
1998,Alvin Williams,SG,23,TOT,54,1071,125,282,9,28,116,254,65,90,324
1998,Alvin Williams,SG,23,POR,41,864,109,238,7,24,102,214,58,79,283
1998,Alvin Williams,SG,23,TOR,13,207,16,44,2,4,14,40,7,11,41
1998,Brandon Williams,SG,22,GSW,9,140,16,50,3,9,13,41,2,4,37
1998,Buck Williams,PF,37,NYK,41,738,75,149,0,0,75,149,52,71,202
1998,Eric Williams,SF,25,DEN,4,145,24,61,0,0,24,61,31,45,79
1998,Herb Williams,PF,39,NYK,27,178,18,43,0,0,18,43,1,8,37
1998,Hot Rod,C,35,PHO,71,1333,95,202,0,0,95,202,65,93,255
1998,Jayson Williams,C,29,NJN,65,2343,321,645,0,4,321,641,195,293,837
1998,Jerome Williams,PF,24,DET,77,1305,151,288,0,1,151,287,108,166,410
1998,Lorenzo Williams,PF,28,WAS,14,111,13,17,0,0,13,17,0,2,26
1998,Micheal Williams,PG,31,MIN,25,161,16,48,0,4,16,44,32,33,64
1998,Monty Williams,SF,26,SAS,72,1314,165,368,1,2,164,366,122,182,453
1998,Scott Williams,C,29,PHI,58,801,93,213,0,5,93,208,51,63,237
1998,Travis Williams,SF,28,CHH,39,365,56,119,0,1,56,118,24,46,136
1998,Walt Williams,SF,27,TOT,59,1470,210,544,80,219,130,325,108,125,608
1998,Walt Williams,SF,27,TOR,28,876,125,319,49,129,76,190,49,60,348
1998,Walt Williams,SF,27,POR,31,594,85,225,31,90,54,135,59,65,260
1998,Corliss Williamson,SF,24,SAC,79,2819,561,1134,0,9,561,1125,279,443,1401
1998,Kevin Willis,PF,35,HOU,81,2528,531,1041,1,7,530,1034,242,305,1305
1998,David Wingate,SG,34,SEA,58,546,66,140,3,7,63,133,15,29,150
1998,Dontonio Wingfield,SF,23,POR,3,9,0,3,0,0,0,3,1,2,1
1998,Joe Wolf,PF,33,DEN,57,621,40,121,2,10,38,111,5,10,87
1998,Lorenzen Wright,C,22,LAC,69,2067,241,542,0,2,241,540,141,214,623
1998,Sharone Wright,C,25,TOR,7,44,7,14,0,0,7,14,2,4,16
1998,George Zidek,C,24,TOT,12,64,7,29,1,2,6,27,14,16,29
1998,George Zidek,C,24,DEN,6,42,4,15,0,0,4,15,10,12,18
1998,George Zidek,C,24,SEA,6,22,3,14,1,2,2,12,4,4,11
,,,,,,,,,,,,,,,
1999,Tariq Abdul-Wahad,SG,24,SAC,49,1205,177,407,6,21,171,386,94,136,454
1999,Shareef Abdur-Rahim,SF,22,VAN,50,2021,386,893,11,36,375,857,369,439,1152
1999,Cory Alexander,PG,25,DEN,36,778,97,260,30,105,67,155,37,44,261
1999,Ray Allen,SG,23,MIL,50,1719,303,673,74,208,229,465,176,195,856
1999,Peter Aluma,C,25,SAC,2,5,1,2,0,0,1,2,0,0,2
1999,Derek Anderson,SG,24,CLE,38,978,125,314,21,69,104,245,138,165,409
1999,Kenny Anderson,PG,28,BOS,34,1010,161,357,6,24,155,333,84,101,412
1999,Nick Anderson,SF,31,ORL,47,1581,253,640,96,277,157,363,99,162,701
1999,Shandon Anderson,SG,25,UTA,50,1072,162,363,14,41,148,322,89,125,427
1999,Chris Anstey,C,24,DAL,41,470,50,139,0,7,50,132,34,48,134
1999,Greg Anthony,PG,31,POR,50,806,104,251,49,125,55,126,62,89,319
1999,B.J. Armstrong,PG,31,TOT,32,358,40,88,7,15,33,73,18,21,105
1999,B.J. Armstrong,PG,31,CHH,10,178,21,43,6,8,15,35,9,10,57
1999,B.J. Armstrong,PG,31,ORL,22,180,19,45,1,7,18,38,9,11,48
1999,Darrell Armstrong,PG,30,ORL,50,1502,230,522,69,189,161,333,161,178,690
1999,Keith Askins,SF,31,MIA,33,415,20,62,8,29,12,33,5,8,53
1999,Stacey Augmon,SF,30,POR,48,874,78,174,0,2,78,172,52,76,208
1999,Isaac Austin,C,29,ORL,49,1259,185,453,2,7,183,446,105,157,477
1999,Anthony Avent,PF,29,UTA,5,44,4,13,0,0,4,13,1,2,9
1999,Thurl Bailey,PF,37,UTA,43,543,78,175,0,2,78,173,25,34,181
1999,Toby Bailey,SG,23,PHO,27,249,34,86,1,5,33,81,9,13,78
1999,LaMark Baker,PG,29,TOR,1,2,0,1,0,0,0,1,0,0,0
1999,Vin Baker,PF,27,SEA,34,1162,198,437,0,3,198,434,72,160,468
1999,Charles Barkley*,PF,35,HOU,42,1526,240,502,4,25,236,477,192,267,676
1999,Dana Barros,PG,31,BOS,50,1156,168,371,64,160,104,211,64,73,464
1999,Brent Barry,SG,27,CHI,37,1181,141,356,52,172,89,184,78,101,412
1999,Drew Barry,SG,25,SEA,17,183,10,32,8,24,2,8,9,13,37
1999,Jon Barry,SG,29,SAC,43,736,59,138,24,79,35,59,71,84,213
1999,Tony Battie,C,22,BOS,50,1121,147,283,0,3,147,280,41,61,335
1999,Corey Beck,PG,27,TOT,24,180,18,39,1,1,17,38,8,15,45
1999,Corey Beck,PG,27,DET,8,30,4,8,0,0,4,8,2,2,10
1999,Corey Beck,PG,27,CHH,16,150,14,31,1,1,13,30,6,13,35
1999,Benoit Benjamin,C,34,PHI,6,33,2,7,0,0,2,7,0,0,4
1999,Corey Benjamin,PG,20,CHI,31,320,44,117,3,14,41,103,27,40,118
1999,Mario Bennett,PF,25,CHI,3,19,2,6,0,0,2,6,3,4,7
1999,Travis Best,PG,26,IND,49,1043,127,305,22,59,105,246,70,83,346
1999,Mike Bibby,PG,20,VAN,50,1758,260,605,15,74,245,531,127,169,662
1999,Chauncey Billups,SG,22,DEN,45,1488,191,495,85,235,106,260,157,172,624
1999,Mookie Blaylock,PG,31,ATL,48,1763,247,651,77,251,170,400,69,91,640
1999,Corie Blount,PF,30,TOT,34,530,36,100,0,1,36,99,28,54,100
1999,Corie Blount,PF,30,LAL,14,162,13,33,0,1,13,32,6,12,32
1999,Corie Blount,PF,30,CLE,20,368,23,67,0,0,23,67,22,42,68
1999,Muggsy Bogues,PG,34,GSW,36,714,76,154,0,6,76,148,31,36,183
1999,Etdrick Bohannon,SF,25,WAS,2,4,0,0,0,0,0,0,0,0,0
1999,Keith Booth,SF,24,CHI,39,432,49,151,1,10,48,141,21,42,120
1999,Bruce Bowen,SF,27,BOS,30,494,26,93,7,26,19,67,11,24,70
1999,Earl Boykins,PG,22,TOT,22,221,30,79,3,18,27,61,2,3,65
1999,Earl Boykins,PG,22,NJN,5,51,10,21,1,5,9,16,0,0,21
1999,Earl Boykins,PG,22,CLE,17,170,20,58,2,13,18,45,2,3,44
1999,Shawn Bradley,C,26,DAL,49,1294,167,348,0,4,167,344,86,115,420
1999,Terrell Brandon,PG,28,TOT,36,1217,212,507,12,47,200,460,65,78,501
1999,Terrell Brandon,PG,28,MIL,15,505,85,208,7,28,78,180,26,31,203
1999,Terrell Brandon,PG,28,MIN,21,712,127,299,5,19,122,280,39,47,298
1999,Chucky Brown,PF,30,CHH,48,1192,176,373,15,40,161,333,40,59,407
1999,Dee Brown,PG,30,TOR,49,1377,187,495,135,349,52,146,40,55,549
1999,Gerald Brown,SG,23,PHO,33,236,33,89,3,10,30,79,11,14,80
1999,P.J. Brown,PF,29,MIA,50,1611,229,477,0,0,229,477,113,146,571
1999,Randy Brown,PG,30,CHI,39,1139,132,319,0,10,132,309,78,103,342
1999,Rick Brunson,PG,26,NYK,17,95,6,21,0,5,6,16,5,18,17
1999,Kobe Bryant,SG,20,LAL,50,1896,362,779,27,101,335,678,245,292,996
1999,Mark Bryant,PF,33,CHI,45,1204,168,348,0,1,168,347,71,110,407
1999,Jud Buechler,SF,30,DET,50,1056,100,240,61,148,39,92,13,18,274
1999,Matt Bullard,PF,31,HOU,41,413,43,114,24,62,19,52,7,10,117
1999,Scott Burrell,SF,28,NJN,32,706,75,208,28,72,47,136,34,42,212
1999,Willie Burton,SF,30,CHH,3,18,1,7,0,1,1,6,2,4,4
1999,Mitchell Butler,SG,28,CLE,31,418,67,139,11,29,56,110,23,32,168
1999,Jason Caffey,PF,25,GSW,35,876,123,277,0,1,123,276,62,98,308
1999,Marcus Camby,C,24,NYK,46,945,136,261,0,0,136,261,57,103,329
1999,Elden Campbell,C,30,TOT,49,1459,222,465,0,1,222,464,172,269,616
1999,Elden Campbell,C,30,LAL,17,325,44,101,0,0,44,101,38,62,126
1999,Elden Campbell,C,30,CHH,32,1134,178,364,0,1,178,363,134,207,490
1999,Antoine Carr,PF,37,HOU,18,152,21,52,0,1,21,51,5,7,47
1999,Chris Carr,SG,24,TOT,39,445,76,205,28,75,48,130,27,40,207
1999,Chris Carr,SG,24,MIN,11,81,9,26,3,9,6,17,2,4,23
1999,Chris Carr,SG,24,NJN,28,364,67,179,25,66,42,113,25,36,184
1999,Cory Carr,SG,23,CHI,42,624,71,216,5,30,66,186,24,32,171
1999,Vince Carter,SF,22,TOR,50,1760,345,766,19,66,326,700,204,268,913
1999,Sam Cassell,PG,29,TOT,8,199,39,93,2,10,37,83,47,50,127
1999,Sam Cassell,PG,29,NJN,4,100,21,49,1,7,20,42,29,31,72
1999,Sam Cassell,PG,29,MIL,4,99,18,44,1,3,17,41,18,19,55
1999,Kelvin Cato,C,24,POR,43,545,58,129,1,1,57,128,34,67,151
1999,Duane Causwell,C,30,MIA,19,137,20,35,0,0,20,35,4,12,44
1999,Cedric Ceballos,SF,29,DAL,13,352,59,140,11,28,48,112,34,49,163
1999,Rex Chapman,SG,31,PHO,38,1183,165,459,53,151,112,308,76,91,459
1999,Calbert Cheaney,SG,27,WAS,50,1266,172,415,8,37,164,378,33,67,385
1999,Pete Chilcutt,PF,30,VAN,46,697,63,172,26,68,37,104,14,17,166
1999,Chris Childs,PG,31,NYK,48,1297,114,267,36,94,78,173,64,78,328
1999,Doug Christie,SG,28,TOR,50,1768,252,650,49,161,203,489,207,246,760
1999,Keon Clark,C,23,DEN,28,409,36,80,0,1,36,79,21,37,93
1999,Keith Closs,C,22,LAC,15,87,12,23,0,1,12,22,8,10,32
1999,John Coker,C,27,WAS,14,98,13,31,0,0,13,31,5,6,31
1999,Derrick Coleman,PF,31,CHH,37,1178,168,406,7,33,161,373,143,190,486
1999,Bimbo Coles,PG,30,GSW,48,1272,183,414,6,25,177,389,83,101,455
1999,Marty Conlon,C,31,MIA,7,35,3,13,0,0,3,13,2,2,8
1999,Tyrone Corbin,SF,36,ATL,47,1066,131,335,38,119,93,216,52,80,352
1999,James Cotton,SG,23,SEA,10,59,6,18,0,3,6,15,13,18,25
1999,Chris Crawford,PF,23,ATL,42,784,110,255,11,33,99,222,57,70,288
1999,Austin Croshere,PF,23,IND,27,249,32,75,8,29,24,46,20,23,92
1999,John Crotty,PG,29,TOT,27,382,51,124,14,36,37,88,43,50,159
1999,John Crotty,PG,29,POR,3,19,4,8,1,1,3,7,3,3,12
1999,John Crotty,PG,29,SEA,24,363,47,116,13,35,34,81,40,47,147
1999,Terry Cummings,PF,37,GSW,50,1011,186,424,1,1,185,423,81,114,454
1999,William Cunningham,C,24,TOT,16,162,3,18,0,0,3,18,0,2,6
1999,William Cunningham,C,24,TOR,1,1,0,0,0,0,0,0,0,0,0
1999,William Cunningham,C,24,NJN,15,161,3,18,0,0,3,18,0,2,6
1999,Bill Curley,PF,26,MIN,35,372,29,72,1,5,28,67,19,22,78
1999,Dell Curry,SG,34,MIL,42,864,163,336,69,145,94,191,28,34,423
1999,Michael Curry,SF,30,MIL,50,1146,90,206,1,15,89,191,63,79,244
1999,Erick Dampier,C,23,GSW,50,1414,161,414,0,0,161,414,120,204,442
1999,Antonio Daniels,PG,23,SAS,47,614,83,183,5,17,78,166,49,65,220
1999,Kornel David,SF,27,CHI,50,902,109,243,0,1,109,242,90,111,308
1999,Antonio Davis,PF,30,IND,49,1271,164,348,0,0,164,348,135,192,463
1999,Ben Davis,PF,26,NYK,8,21,7,17,0,0,7,17,3,6,17
1999,Dale Davis,PF,29,IND,50,1374,161,302,0,0,161,302,76,123,398
1999,Hubert Davis,SG,28,DAL,50,1378,174,397,65,144,109,253,44,50,457
1999,Mark Davis,SF,25,MIA,4,35,2,6,0,0,2,6,5,6,9
1999,Ricky Davis,SG,19,CHH,46,557,81,200,2,12,79,188,45,59,209
1999,Terry Davis,C,31,WAS,37,578,49,92,0,0,49,92,28,38,126
1999,Andrew DeClercq,C,25,TOT,47,1102,138,276,0,0,138,276,95,141,371
1999,Andrew DeClercq,C,25,BOS,14,258,28,57,0,0,28,57,19,29,75
1999,Andrew DeClercq,C,25,CLE,33,844,110,219,0,0,110,219,76,112,296
1999,Terry Dehere,SG-PG,27,TOT,26,291,31,85,16,39,15,46,5,7,83
1999,Terry Dehere,PG,27,SAC,4,20,4,11,1,5,3,6,0,0,9
1999,Terry Dehere,SG,27,VAN,22,271,27,74,15,34,12,40,5,7,74
1999,Vinny Del,PG,32,MIL,48,1093,114,270,13,30,101,240,40,50,281
1999,Bison Dele,C,29,DET,49,1177,216,431,0,1,216,430,81,118,513
1999,Tony Delk,PG,25,GSW,36,630,92,253,16,66,76,187,46,71,246
1999,Michael Dickerson,SG,23,HOU,50,1558,215,462,71,164,144,298,46,72,547
1999,Vlade Divac,C,30,SAC,50,1761,262,557,11,43,251,514,179,255,714
1999,Michael Doleac,C,21,ORL,49,780,125,267,0,0,125,267,54,80,304
1999,Sherman Douglas,PG,32,LAC,30,842,96,219,0,11,96,208,55,87,247
1999,Bryce Drew,PG,24,HOU,34,441,47,129,16,49,31,80,8,8,118
1999,Chris Dudley,C,33,NYK,46,685,48,109,0,0,48,109,19,40,115
1999,Joe Dumars*,SG,35,DET,38,1116,144,350,89,221,55,129,51,61,428
1999,Tim Duncan,PF,22,SAS,50,1963,418,845,1,7,417,838,247,358,1084
1999,Blue Edwards,SF,33,MIA,24,283,32,72,4,10,28,62,9,13,77
1999,Howard Eisley,PG,26,UTA,50,1038,140,314,21,50,119,264,67,80,368
1999,Mario Elie,SG,35,SAS,47,1291,156,331,40,107,116,224,103,119,455
1999,Sean Elliott,SF,30,SAS,50,1509,208,507,39,119,169,388,106,140,561
1999,Dale Ellis,SF,38,SEA,48,1232,174,395,94,217,80,178,53,70,495
1999,LaPhonso Ellis,PF,28,ATL,20,539,80,190,1,5,79,185,43,61,204
1999,Brian Evans,SF,25,TOT,16,145,13,44,4,13,9,31,4,4,34
1999,Brian Evans,SF,25,NJN,11,121,11,34,4,11,7,23,4,4,30
1999,Brian Evans,SF,25,MIN,5,24,2,10,0,2,2,8,0,0,4
1999,Patrick Ewing*,C,36,NYK,38,1300,247,568,0,2,247,566,163,231,657
1999,Jamie Feick,PF-C,24,TOT,28,852,67,134,0,0,67,134,43,60,177
1999,Jamie Feick,C,24,MIL,2,3,0,1,0,0,0,1,0,0,0
1999,Jamie Feick,PF,24,NJN,26,849,67,133,0,0,67,133,43,60,177
1999,Duane Ferrell,SF,33,GSW,8,46,1,14,0,0,1,14,3,4,5
1999,Danny Ferry,PF,32,CLE,50,1058,141,296,38,97,103,199,29,33,349
1999,Michael Finley,SF,25,DAL,50,2051,389,876,45,136,344,740,186,226,1009
1999,Derek Fisher,PG,24,LAL,50,1131,99,263,38,97,61,166,60,79,296
1999,Danny Fortson,PF,22,DEN,50,1417,191,386,0,3,191,383,168,231,550
1999,Greg Foster,PF,30,UTA,42,458,52,138,1,4,51,134,13,21,118
1999,Rick Fox,SF,29,LAL,44,944,148,330,32,95,116,235,66,89,394
1999,Adonal Foyle,C,23,GSW,44,614,52,121,0,0,52,121,25,51,129
1999,Todd Fuller,C,24,UTA,42,462,56,124,0,0,56,124,30,50,142
1999,Lawrence Funderburke,PF,28,SAC,47,936,167,299,1,5,166,294,85,120,420
1999,Kevin Garnett,PF,22,MIN,47,1780,414,900,4,14,410,886,145,206,977
1999,Marlon Garnett,PG,23,BOS,24,205,15,51,6,23,9,28,15,20,51
1999,Dean Garrett,C,32,MIN,49,1054,116,231,0,0,116,231,38,51,270
1999,Pat Garrity,PF,22,PHO,39,538,85,170,7,18,78,152,40,56,217
1999,Chris Gatling,C,31,TOT,48,775,117,265,1,8,116,257,37,93,272
1999,Chris Gatling,C,31,NJN,18,281,36,97,0,1,36,96,12,24,84
1999,Chris Gatling,C,31,MIL,30,494,81,168,1,7,80,161,25,69,188
1999,Andrew Gaze,SG,33,SAS,19,58,8,25,5,16,3,9,0,0,21
1999,Matt Geiger,C,29,PHI,50,1540,266,555,1,5,265,550,141,177,674
1999,Kendall Gill,SF,30,NJN,50,1606,236,593,2,17,234,576,114,167,588
1999,Armen Gilliam,PF,34,MIL,34,668,101,223,0,1,101,222,79,101,281
1999,Brian Grant,PF,26,POR,48,1525,183,382,0,0,183,382,184,226,550
1999,Gary Grant,PG,33,POR,2,7,0,1,0,0,0,1,0,0,0
1999,Harvey Grant,PF,33,PHI,47,798,62,168,1,6,61,162,21,29,146
1999,Horace Grant,PF,33,ORL,50,1660,198,456,0,2,198,454,47,70,443
1999,Paul Grant,C,25,TOT,6,13,2,6,0,0,2,6,0,0,4
1999,Paul Grant,C,25,MIN,4,8,1,4,0,0,1,4,0,0,2
1999,Paul Grant,C,25,MIL,2,5,1,2,0,0,1,2,0,0,2
1999,Ed Gray,SG,23,ATL,30,337,53,182,12,42,41,140,28,37,146
1999,A.C. Green,PF,35,DAL,50,924,108,256,0,8,108,248,30,52,246
1999,Litterial Green,PG,28,CLE,1,2,0,1,0,0,0,1,0,0,0
1999,Tom Gugliotta,PF,29,PHO,43,1563,277,573,2,7,275,566,173,218,729
1999,Tom Hammonds,PF,31,MIN,49,716,82,179,0,0,82,179,48,75,212
1999,Anfernee Hardaway,SG,27,ORL,50,1944,301,717,40,140,261,577,149,211,791
1999,Tim Hardaway,PG,32,MIA,48,1772,301,752,112,311,189,441,121,149,835
1999,Derek Harper,PG,37,LAL,45,1120,120,291,43,117,77,174,26,32,309
1999,Ron Harper,SG,35,CHI,35,1107,147,390,27,85,120,305,71,101,392
1999,Matt Harpring,SF,22,ORL,50,1114,148,320,10,25,138,295,102,143,408
1999,Al Harrington,PF,18,IND,21,160,18,56,0,5,18,51,9,15,45
1999,Othella Harrington,PF,25,HOU,41,903,156,304,0,0,156,304,88,122,400
1999,Lucious Harris,SG,28,NJN,36,602,73,181,11,50,62,131,36,48,193
1999,Hersey Hawkins,SG,32,SEA,50,1644,171,408,55,180,116,228,119,132,516
1999,Michael Hawkins,PG,26,SAC,24,203,14,40,5,19,9,21,3,3,36
1999,Alan Henderson,SF,26,ATL,38,1142,187,423,0,1,187,422,100,149,474
1999,Cedric Henderson,SF,23,CLE,50,1517,189,453,2,12,187,441,74,91,454
1999,J.R. Henderson,SF,22,VAN,30,331,35,96,2,5,33,91,25,45,97
1999,Mark Hendrickson,PF,24,NJN,22,399,39,88,0,1,39,87,42,50,120
1999,Steve Henson,PG,30,DET,4,25,1,2,0,0,1,2,2,2,4
1999,Carl Herrera,PF,32,TOT,28,307,30,76,0,1,30,75,5,11,65
1999,Carl Herrera,PF,32,VAN,4,42,3,13,0,0,3,13,0,2,6
1999,Carl Herrera,PF,32,DEN,24,265,27,63,0,1,27,62,5,9,59
1999,Grant Hill,SF,26,DET,50,1852,384,802,0,14,384,788,285,379,1053
1999,Tyrone Hill,PF,30,TOT,38,1104,122,268,0,0,122,268,81,150,325
1999,Tyrone Hill,PF,30,MIL,17,517,50,118,0,0,50,118,46,81,146
1999,Tyrone Hill,PF,30,PHI,21,587,72,150,0,0,72,150,35,69,179
1999,Fred Hoiberg,SG,26,IND,12,87,6,21,1,9,5,12,6,6,19
1999,Jerald Honeycutt,PF,24,TOT,16,102,9,32,5,17,4,15,7,10,30
1999,Jerald Honeycutt,PF,24,MIL,3,12,2,5,0,3,2,2,1,2,5
1999,Jerald Honeycutt,PF,24,PHI,13,90,7,27,5,14,2,13,6,8,25
1999,Jeff Hornacek,SG,35,UTA,48,1435,214,449,34,81,180,368,125,140,587
1999,Robert Horry,PF,28,LAL,38,744,67,146,20,45,47,101,34,46,188
1999,Allan Houston,SG,27,NYK,50,1815,294,703,57,140,237,563,168,195,813
1999,Juwan Howard,SF,25,WAS,36,1430,286,604,0,3,286,601,110,146,682
1999,Troy Hudson,PG,22,LAC,25,524,60,150,15,47,45,103,34,38,169
1999,Larry Hughes,PG,20,PHI,50,988,170,414,8,52,162,362,107,151,455
1999,Lindsey Hunter,PG,28,DET,49,1755,228,524,59,153,169,371,67,89,582
1999,Zydrunas Ilgauskas,C,23,CLE,5,171,29,57,0,0,29,57,18,30,76
1999,Allen Iverson*,SG,23,PHI,48,1990,435,1056,58,199,377,857,356,474,1284
1999,Bobby Jackson,PG,25,MIN,50,941,141,348,10,27,131,321,61,79,353
1999,Jaren Jackson,SG,31,SAS,47,861,108,284,53,147,55,137,32,39,301
1999,Jim Jackson,SG,28,POR,49,1175,152,370,25,90,127,280,85,101,414
1999,Mark Jackson,PG,33,IND,49,1382,138,329,32,103,106,226,65,79,373
1999,Randell Jackson,PF,23,WAS,27,271,46,108,1,7,45,101,21,32,114
1999,Sam Jacobson,PG,23,LAL,2,12,3,5,0,1,3,4,2,2,8
1999,Jerome James,C,23,SAC,16,42,9,24,0,0,9,24,6,12,24
1999,Antawn Jamison,SF,22,GSW,47,1058,178,394,3,10,175,384,90,153,449
1999,Anthony Johnson,PG,24,ATL,49,885,91,225,5,19,86,206,57,82,244
1999,Avery Johnson,PG,33,SAS,50,1672,218,461,1,12,217,449,50,88,487
1999,Eddie Johnson,SF,39,HOU,3,18,6,13,0,1,6,12,0,0,12
1999,Ervin Johnson,C,31,MIL,50,1027,96,189,0,0,96,189,64,105,256
1999,Larry Johnson,PF,29,NYK,49,1639,210,458,33,92,177,366,134,164,587
1999,Charles Jones,SG,23,CHI,29,476,39,123,19,61,20,62,11,22,108
1999,Damon Jones,PG,22,TOT,24,344,43,119,25,62,18,57,14,17,125
1999,Damon Jones,PG,22,NJN,11,131,14,44,10,29,4,15,11,13,49
1999,Damon Jones,PG,22,BOS,13,213,29,75,15,33,14,42,3,4,76
1999,Eddie Jones,SF-SG,27,TOT,50,1881,260,595,48,142,212,453,212,271,780
1999,Eddie Jones,SG,27,LAL,20,724,96,227,20,64,76,163,59,80,271
1999,Eddie Jones,SF,27,CHH,30,1157,164,368,28,78,136,290,153,191,509
1999,Popeye Jones,PF,28,BOS,18,206,20,51,0,1,20,50,14,17,54
1999,Adonis Jordan,PG,28,MIL,4,18,2,4,0,2,2,2,2,4,6
1999,Reggie Jordan,SG,31,MIN,27,296,15,54,0,0,15,54,21,38,51
1999,Adam Keefe,PF,28,UTA,44,642,56,124,0,4,56,120,62,89,174
1999,Shawn Kemp,PF,29,CLE,42,1475,277,575,1,2,276,573,307,389,862
1999,Jonathan Kerner,C,24,ORL,1,5,0,1,0,0,0,1,0,0,0
1999,Steve Kerr,PG,33,SAS,44,734,68,174,25,80,43,94,31,35,192
1999,Jerome Kersey,SF,36,SAS,45,699,68,200,3,14,65,186,6,14,145
1999,Jason Kidd,PG,25,PHO,50,2060,310,698,45,123,265,575,181,239,846
1999,Chris King,SF,29,UTA,8,42,2,7,0,0,2,7,0,4,4
1999,Gerard King,SF,26,SAS,19,63,6,14,0,0,6,14,11,18,23
1999,Kerry Kittles,SG,24,NJN,46,1570,227,613,50,158,177,455,88,114,592
1999,Joe Kleine,C,37,PHO,31,374,30,74,0,2,30,72,8,12,68
1999,Brevin Knight,PG,23,CLE,39,1186,134,315,0,5,134,310,105,141,373
1999,Negele Knight,PG,31,TOR,6,56,3,8,0,1,3,7,2,4,8
1999,Travis Knight,C,24,LAL,37,525,67,130,0,1,67,129,22,29,156
1999,Toni Kukoc,SF,30,CHI,44,1654,315,750,39,137,276,613,159,215,828
1999,Christian Laettner,PF,29,DET,16,337,38,106,1,3,37,103,44,57,121
1999,Raef LaFrentz,C,22,DEN,12,387,59,129,12,31,47,98,36,48,166
1999,Andrew Lang,C,32,CHI,21,386,32,99,0,0,32,99,16,23,80
1999,Antonio Lang,PF,26,CLE,10,65,4,6,0,0,4,6,5,9,13
1999,Rusty LaRue,PG,25,CHI,43,732,78,217,30,89,48,128,17,17,203
1999,Tim Legler,SG,32,WAS,30,377,51,115,14,35,37,80,3,6,119
1999,Voshon Lenard,SG,25,MIA,12,190,31,79,12,35,19,44,8,11,82
1999,Rashard Lewis,SF,19,SEA,20,145,19,52,1,6,18,46,8,14,47
1999,Randy Livingston,PG,23,PHO,1,22,5,8,0,0,5,8,2,2,12
1999,Grant Long,PF,32,ATL,50,1380,151,359,3,18,148,341,184,235,489
1999,Luc Longley,C,30,PHO,39,933,140,290,0,0,140,290,59,76,339
1999,Felipe Lopez,SG,24,VAN,47,1218,169,379,12,44,157,335,87,135,437
1999,Tyronn Lue,PG,21,LAL,15,188,28,65,7,16,21,49,12,21,75
1999,George Lynch,SF,28,PHI,43,1315,147,349,9,23,138,326,53,84,356
1999,Sam Mack,SF,28,TOT,44,1083,167,384,87,219,80,165,51,58,472
1999,Sam Mack,SF,28,VAN,19,577,86,212,42,108,44,104,28,30,242
1999,Sam Mack,SF,28,HOU,25,506,81,172,45,111,36,61,23,28,230
1999,Don MacLean,PF,29,SEA,17,365,63,159,9,33,54,126,50,80,185
1999,Mark Macon,SG,29,DET,7,69,4,20,1,3,3,17,0,0,9
1999,Rick Mahorn,PF,40,PHI,16,127,5,18,0,0,5,18,3,8,13
1999,Dan Majerle,SG,33,MIA,48,1624,118,298,68,203,50,95,33,46,337
1999,Karl Malone*,PF,35,UTA,49,1832,393,797,0,1,393,796,378,480,1164
1999,Matt Maloney,PG,27,HOU,15,186,5,28,1,15,4,13,10,11,21
1999,Danny Manning,PF,32,PHO,50,1184,187,386,1,9,186,377,78,112,453
1999,Stephon Marbury,PG,21,TOT,49,1895,378,883,66,197,312,686,222,278,1044
1999,Stephon Marbury,PG,21,MIN,18,661,124,304,8,39,116,265,63,87,319
1999,Stephon Marbury,PG,21,NJN,31,1234,254,579,58,158,196,421,159,191,725
1999,Sean Marks,PF,23,TOR,8,28,5,8,0,0,5,8,1,2,11
1999,Donyell Marshall,SF,25,GSW,48,1250,208,494,26,72,182,422,88,121,530
1999,Darrick Martin,PG,27,LAC,37,941,102,278,31,106,71,172,61,76,296
1999,Jamal Mashburn,SF,26,MIA,24,855,134,297,13,30,121,267,75,104,356
1999,Tony Massenburg,PF,31,VAN,43,1143,189,388,0,2,189,386,103,155,481
1999,Vernon Maxwell,SG,33,SAC,46,1007,164,421,80,231,84,190,84,114,492
1999,Lee Mayberry,PG,28,VAN,9,126,7,19,2,10,5,9,4,5,20
1999,Kelly McCarty,SG,23,DEN,2,4,2,3,0,0,2,3,0,0,4
1999,Walter McCarty,PF,24,BOS,32,659,64,177,13,50,51,127,40,57,181
1999,George McCloud,SF,31,PHO,48,1245,142,324,69,166,73,158,75,87,428
1999,Jelani McCoy,C,21,SEA,26,331,56,76,0,0,56,76,21,42,133
1999,Antonio McDyess,C,24,DEN,50,1937,415,882,1,9,414,873,230,338,1061
1999,Tracy McGrady,SF,19,TOR,49,1106,168,385,8,35,160,350,114,157,458
1999,Jim McIlvaine,C,26,NJN,22,269,22,51,0,0,22,51,4,6,48
1999,Jeff McInnis,PG,24,WAS,35,427,50,134,9,35,41,99,21,28,130
1999,Derrick McKey,SF,32,IND,13,244,23,52,0,1,23,51,14,17,60
1999,Aaron McKie,SG,26,PHI,50,959,95,237,6,31,89,206,44,62,240
1999,Roshown McLeod,SF,23,ATL,34,348,62,163,1,10,61,153,37,45,162
1999,Ron Mercer,SG,22,BOS,41,1551,305,707,5,30,300,677,83,105,698
1999,Loren Meyer,C,26,DEN,14,70,7,28,1,5,6,23,1,2,16
1999,Marko Milic,SG,21,PHO,11,53,8,20,0,1,8,19,0,0,16
1999,Anthony Miller,PF,27,HOU,29,249,28,60,0,1,28,59,14,22,70
1999,Brad Miller,C,22,CHH,38,469,78,138,1,2,77,136,81,102,238
1999,Oliver Miller,C,28,SAC,4,35,5,11,0,0,5,11,0,0,10
1999,Reggie Miller*,SG,33,IND,50,1787,294,671,106,275,188,396,226,247,920
1999,Chris Mills,SF,29,GSW,47,1395,186,453,32,115,154,338,79,96,483
1999,Terry Mills,PF,31,MIA,1,29,3,8,2,4,1,4,1,2,9
1999,Greg Minor,SG,27,BOS,44,765,85,204,8,28,77,176,36,48,214
1999,Sam Mitchell,SF,35,MIN,50,1344,213,522,9,38,204,484,126,165,561
1999,Cuttino Mobley,PG,23,HOU,49,1456,172,405,53,148,119,257,90,110,487
1999,Nazr Mohammed,C,21,PHI,26,121,15,42,0,0,15,42,12,21,42
1999,Eric Montross,C,27,DET,46,577,42,80,0,1,42,79,11,32,95
1999,Mikki Moore,C,23,DET,2,6,1,1,0,0,1,1,2,2,4
1999,Chris Morris,SF,33,PHO,44,535,64,149,16,56,48,93,40,46,184
1999,Alonzo Mourning*,C,28,MIA,46,1753,324,634,0,2,324,632,276,423,924
1999,Chris Mullin*,SF,35,IND,50,1179,177,371,73,157,104,214,80,92,507
1999,Eric Murdock,PG,30,NJN,15,401,45,114,8,22,37,92,21,26,119
1999,Gheorghe Muresan,C,27,NJN,1,1,0,1,0,0,0,1,0,0,0
1999,Lamond Murray,SF,25,LAC,50,1317,226,578,34,103,192,475,126,157,612
1999,Tracy Murray,SF,27,WAS,36,653,83,237,33,103,50,134,34,42,233
1999,Dikembe Mutombo*,C,32,ATL,50,1829,173,338,0,0,173,338,195,285,541
1999,Makhtar N'Diaye,PF,25,VAN,4,27,1,4,0,0,1,4,3,4,5
1999,Steve Nash,PG,24,DAL,40,1269,114,314,49,131,65,183,38,46,315
1999,Tyrone Nesby,SF,23,LAC,50,1288,182,405,35,96,147,309,104,133,503
1999,Rasho Nesterovic,C,22,MIN,2,30,3,12,0,0,3,12,2,2,8
1999,Johnny Newman,SF,35,CLE,50,949,106,251,23,61,83,190,68,84,303
1999,Moochie Norris,PG,25,SEA,12,140,13,40,6,15,7,25,6,16,38
1999,Dirk Nowitzki,PF,20,DAL,47,958,136,336,14,68,122,268,99,128,385
1999,Charles O'Bannon,SG,23,DET,18,165,24,56,0,1,24,55,8,8,56
1999,Jermaine O'Neal,PF,20,POR,36,311,36,83,0,1,36,82,18,35,90
1999,Shaquille O'Neal*,C,26,LAL,49,1705,510,885,0,1,510,884,269,498,1289
1999,Charles Oakley,PF,35,TOR,50,1633,140,327,1,5,139,322,67,83,348
1999,Hakeem Olajuwon*,C,36,HOU,50,1784,373,725,4,13,369,712,195,272,945
1999,Jimmy Oliver,SG,29,PHO,2,11,1,3,1,1,0,2,0,0,3
1999,Kevin Ollie,PG,26,TOT,8,72,4,14,0,0,4,14,5,7,13
1999,Kevin Ollie,PG,26,SAC,7,68,4,13,0,0,4,13,4,5,12
1999,Kevin Ollie,PG,26,ORL,1,4,0,1,0,0,0,1,1,2,1
1999,Michael Olowokandi,C,23,LAC,45,1279,172,399,0,0,172,399,57,118,401
1999,Greg Ostertag,C,25,UTA,48,1340,99,208,0,0,99,208,75,121,273
1999,Bo Outlaw,PF,27,ORL,31,851,84,154,0,3,84,151,35,81,203
1999,Doug Overton,PG,29,TOT,24,244,36,84,2,7,34,77,18,20,92
1999,Doug Overton,PG,29,ORL,6,33,6,12,0,2,6,10,6,6,18
1999,Doug Overton,PG,29,NJN,8,174,25,57,2,4,23,53,12,14,64
1999,Doug Overton,PG,29,PHI,10,37,5,15,0,1,5,14,0,0,10
1999,Billy Owens,SF,29,SEA,21,451,65,165,5,11,60,154,28,35,163
1999,Robert Pack,PG,29,DAL,25,468,75,174,0,4,75,170,72,88,222
1999,Anthony Parker,SG,23,PHI,2,3,1,1,0,0,1,1,0,0,2
1999,Cherokee Parks,C,26,VAN,48,1118,118,275,0,1,118,274,30,55,266
1999,Andrae Patterson,PF,23,MIN,35,284,43,97,0,5,43,92,28,36,114
1999,Ruben Patterson,SF,23,LAL,24,144,21,51,1,6,20,45,22,31,65
1999,Gary Payton*,PG,30,SEA,50,2008,401,923,83,281,318,642,199,276,1084
1999,Anthony Peeler,SG,29,MIN,28,810,103,272,34,114,69,158,30,41,270
1999,Will Perdue,C,33,SAS,37,445,38,60,0,0,38,60,14,26,90
1999,Sam Perkins,PF,37,IND,48,789,80,200,35,90,45,110,43,60,238
1999,Elliot Perry,PG,29,TOT,35,290,39,103,10,24,29,79,10,14,98
1999,Elliot Perry,PG,29,MIL,5,47,9,17,1,1,8,16,1,2,20
1999,Elliot Perry,PG,29,NJN,30,243,30,86,9,23,21,63,9,12,78
1999,Chuck Person,SF,34,CHH,50,990,112,289,55,157,57,132,24,32,303
1999,Wesley Person,SG,27,CLE,45,1342,198,437,75,200,123,237,32,53,503
1999,Bobby Phills,SG,29,CHH,43,1574,215,497,68,172,147,325,115,168,613
1999,Eric Piatkowski,SG,28,LAC,49,1242,180,417,65,165,115,252,88,102,513
1999,Paul Pierce,SF,21,BOS,48,1632,284,647,84,204,200,443,139,195,791
1999,Scottie Pippen*,SF,33,HOU,50,2011,261,604,72,212,189,392,132,183,726
1999,Scot Pollard,C,23,SAC,16,259,33,61,0,0,33,61,16,23,82
1999,Olden Polynice,C,34,SEA,48,1481,169,358,1,1,168,357,29,94,368
1999,Mark Pope,SF,26,IND,4,26,1,7,0,4,1,3,0,1,2
1999,Terry Porter,PG,35,MIA,50,1365,172,370,58,141,114,229,123,148,525
1999,Vitaly Potapenko,C,23,TOT,50,1394,204,412,0,1,204,411,91,155,499
1999,Vitaly Potapenko,C,23,CLE,17,467,55,126,0,1,55,125,33,49,143
1999,Vitaly Potapenko,C,23,BOS,33,927,149,286,0,0,149,286,58,106,356
1999,Brent Price,PG,30,HOU,40,806,100,207,46,112,54,95,46,61,292
1999,Theo Ratliff,PF,25,PHI,50,1627,197,419,0,0,197,419,166,229,560
1999,Eldridge Recasner,PG,31,CHH,44,708,82,184,24,60,58,124,34,39,222
1999,Bryant Reeves,C,25,VAN,25,702,102,251,0,1,102,250,67,116,271
1999,Khalid Reeves,PG,26,DET,11,112,8,21,1,3,7,18,8,14,25
1999,Don Reid,PF,25,DET,47,935,97,174,0,0,97,174,48,79,242
1999,J.R. Reid,PF,30,TOT,41,1029,132,277,0,1,132,276,105,137,369
1999,J.R. Reid,PF,30,CHH,16,556,88,169,0,0,88,169,67,84,243
1999,J.R. Reid,PF,30,LAL,25,473,44,108,0,1,44,107,38,53,126
1999,Shawn Respert,SG,26,PHO,12,99,13,36,4,13,9,23,7,10,37
1999,Rodrick Rhodes,SG-SF,25,TOT,13,156,13,52,1,7,12,45,16,25,43
1999,Rodrick Rhodes,SF,25,HOU,3,33,2,8,0,0,2,8,5,6,9
1999,Rodrick Rhodes,SG,25,VAN,10,123,11,44,1,7,10,37,11,19,34
1999,Glen Rice,SF,31,LAL,27,985,171,396,53,135,118,261,77,90,472
1999,Pooh Richardson,PG,32,LAC,11,130,12,36,0,6,12,30,4,4,28
1999,Mitch Richmond*,SG,33,WAS,50,1912,331,803,70,221,261,582,251,293,983
1999,Isaiah Rider,SG,27,POR,47,1385,249,605,42,111,207,494,111,147,651
1999,Eric Riley,C,28,BOS,35,337,28,54,0,0,28,54,22,31,78
1999,Stanley Roberts,C,28,HOU,6,33,5,13,0,0,5,13,4,8,14
1999,Clifford Robinson,SF,32,PHO,50,1740,299,629,58,139,241,490,163,234,819
1999,David Robinson*,C,33,SAS,49,1554,268,527,0,1,268,526,239,363,775
1999,Glenn Robinson,SF,26,MIL,47,1579,347,756,31,79,316,677,140,161,865
1999,James Robinson,PG,28,TOT,31,506,67,185,21,74,46,111,28,41,183
1999,James Robinson,PG,28,LAC,14,280,39,98,8,30,31,68,20,27,106
1999,James Robinson,PG,28,MIN,17,226,28,87,13,44,15,43,8,14,77
1999,Dennis Rodman*,PF,37,LAL,23,657,16,46,0,2,16,44,17,39,49
1999,Carlos Rogers,PF,27,POR,2,8,2,2,0,0,2,2,1,4,5
1999,Rodney Rogers,SF,27,LAC,47,968,131,297,18,63,113,234,68,101,348
1999,Sean Rooks,C,29,LAL,36,315,32,79,0,2,32,77,34,48,98
1999,Jalen Rose,SF,26,IND,49,1238,200,496,17,65,183,431,125,158,542
1999,Malik Rose,PF,24,SAS,47,608,93,201,0,1,93,200,98,146,284
1999,Bryon Russell,SF,28,UTA,50,1770,217,468,52,147,165,321,136,171,622
1999,Arvydas Sabonis*,C,34,POR,50,1349,232,478,7,24,225,454,135,175,606
1999,Jason Sasser,SF,25,VAN,6,39,5,11,0,0,5,11,1,2,11
1999,Danny Schayes,C,39,ORL,19,143,11,29,0,0,11,29,6,8,28
1999,Dwayne Schintzius,C,30,BOS,16,67,4,16,0,0,4,16,3,4,11
1999,Detlef Schrempf,SF,36,SEA,50,1765,259,549,34,86,225,463,200,243,752
1999,Dennis Scott,SF,30,TOT,36,738,87,213,37,97,50,116,23,31,234
1999,Dennis Scott,SF,30,NYK,15,206,17,56,8,29,9,27,1,4,43
1999,Dennis Scott,SF,30,MIN,21,532,70,157,29,68,41,89,22,27,191
1999,Malik Sealy,SF,28,MIN,31,731,95,231,6,23,89,208,55,61,251
1999,Rony Seikaly,C,33,NJN,9,88,4,20,0,0,4,20,7,18,15
1999,Charles Shackleford,C,32,CHH,32,367,44,90,0,0,44,90,19,29,107
1999,Brian Shaw,PG,32,POR,1,5,0,1,0,0,0,1,0,0,0
1999,Casey Shaw,C,23,PHI,9,14,1,8,0,0,1,8,0,0,2
1999,Jeffrey Sheppard,SG,24,ATL,18,185,15,39,2,7,13,32,8,13,40
1999,Miles Simon,SG,23,ORL,5,19,1,5,0,2,1,3,0,0,2
1999,Dickey Simpkins,C,26,CHI,50,1448,150,324,0,1,150,323,156,242,456
1999,Alvin Sims,SG,24,PHO,4,25,4,10,1,1,3,9,2,5,11
1999,Brian Skinner,PF,22,LAC,21,258,33,71,0,0,33,71,20,33,86
1999,Reggie Slater,PF,28,TOR,30,263,31,81,0,0,31,81,53,85,115
1999,Charles Smith,SG,23,LAC,23,317,35,97,7,33,28,64,7,16,84
1999,Joe Smith,C,23,MIN,43,1418,223,522,0,3,223,519,142,188,588
1999,Michael Smith,PF,26,VAN,48,1098,77,144,0,1,77,143,76,128,230
1999,Steve Smith,SG,29,ATL,36,1314,217,540,47,139,170,401,191,225,672
1999,Rik Smits,C,32,IND,49,1271,310,633,0,2,310,631,108,132,728
1999,Eric Snow,PG,25,PHI,48,1716,149,348,5,21,144,327,110,150,413
1999,Felton Spencer,C,31,GSW,26,159,15,33,0,0,15,33,12,26,42
1999,Latrell Sprewell,SF,28,NYK,37,1233,215,518,21,77,194,441,155,191,606
1999,Ryan Stack,PF,23,CLE,18,199,14,37,0,0,14,37,19,20,47
1999,Jerry Stackhouse,SG,24,DET,42,1188,181,488,35,126,146,362,210,247,607
1999,John Starks,SG,33,GSW,50,1686,269,728,78,269,191,459,74,100,690
1999,Vladimir Stepania,C,22,SEA,23,313,53,125,0,3,53,122,21,40,127
1999,Michael Stewart,C,23,TOR,42,394,22,53,0,0,22,53,17,25,61
1999,Bryant Stith,SG,28,DEN,46,1194,114,290,31,106,83,184,61,71,320
1999,John Stockton*,PG,36,UTA,50,1410,200,410,16,50,184,360,137,169,553
1999,Peja Stojakovic,SF,21,SAC,48,1025,141,373,57,178,84,195,63,74,402
1999,Damon Stoudamire,PG,25,POR,50,1673,249,629,44,142,205,487,89,122,631
1999,Erick Strickland,SG,25,DAL,33,567,89,221,18,59,71,162,53,65,249
1999,Mark Strickland,PF,28,MIA,32,357,50,101,0,1,50,100,19,26,119
1999,Rod Strickland,PG,32,WAS,44,1632,251,603,12,42,239,561,176,236,690
1999,Derek Strong,PF,30,ORL,44,695,76,180,0,2,76,178,71,99,223
1999,Bruno Sundov,C,18,DAL,3,11,2,7,0,0,2,7,0,0,4
1999,Bob Sura,PG,25,CLE,50,841,70,210,9,45,61,165,65,103,214
1999,Johnny Taylor,SF,24,DEN,36,724,82,198,26,68,56,130,17,23,207
1999,Maurice Taylor,PF,22,LAC,46,1505,311,675,1,6,310,669,150,206,773
1999,John Thomas,C,23,TOR,39,593,71,123,0,1,71,122,27,48,169
1999,Kurt Thomas,PF,26,NYK,50,1182,170,368,0,1,170,367,66,108,406
1999,Tim Thomas,SF,21,TOT,50,812,132,279,21,68,111,211,73,112,358
1999,Tim Thomas,SF,21,PHI,17,188,27,67,5,19,22,48,19,24,78
1999,Tim Thomas,SF,21,MIL,33,624,105,212,16,49,89,163,54,88,280
1999,Otis Thorpe,PF,36,WAS,49,1539,240,440,0,2,240,438,74,106,554
1999,Robert Traylor,C,21,MIL,49,786,108,201,0,1,108,200,43,80,259
1999,Gary Trent,PF,24,DAL,45,1362,287,602,0,5,287,597,145,235,719
1999,Nick Van,PG,27,DEN,50,1802,306,769,72,234,234,535,142,175,826
1999,Keith Van,PF,23,NJN,42,1576,322,752,16,53,306,699,256,298,916
1999,David Vaughn,PF,25,NJN,10,103,13,24,0,0,13,24,8,10,34
1999,Jacque Vaughn,PG,23,UTA,19,87,11,30,2,8,9,22,20,24,44
1999,Loy Vaught,PF,30,DET,37,481,59,155,0,1,59,154,9,14,127
1999,Stojko Vrankovic,C,35,LAC,2,12,1,4,0,0,1,4,0,0,2
1999,Antoine Walker,PF,22,BOS,42,1549,303,735,65,176,238,559,113,202,784
1999,Samaki Walker,PF,22,DAL,39,568,88,190,0,1,88,189,53,98,229
1999,Ben Wallace,C,24,WAS,46,1231,115,199,0,0,115,199,47,132,277
1999,John Wallace,SF,24,TOR,48,812,153,354,0,0,153,354,105,150,411
1999,Rasheed Wallace,PF,24,POR,49,1414,242,476,13,31,229,445,131,179,628
1999,Rex Walters,SG,28,MIA,33,506,35,95,12,38,23,57,19,23,101
1999,Charlie Ward,PG,28,NYK,50,1556,135,334,53,149,82,185,55,78,378
1999,Eric Washington,SG,24,DEN,38,761,73,184,37,97,36,87,22,32,205
1999,Jamie Watson,SF,26,MIA,3,18,1,2,0,0,1,2,0,0,2
1999,Clarence Weatherspoon,SF,28,MIA,49,1040,141,264,0,0,141,264,115,143,397
1999,Chris Webber,PF,25,SAC,42,1719,378,778,4,34,374,744,79,174,839
1999,Bonzi Wells,SF,22,POR,7,35,11,20,1,3,10,17,8,18,31
1999,Bill Wennington,C,35,CHI,38,451,62,178,1,1,61,177,18,22,143
1999,David Wesley,PG,28,CHH,50,1848,243,545,61,170,182,375,159,191,706
1999,Doug West,SG,31,VAN,14,294,31,65,0,2,31,63,19,25,81
1999,Mark West,C,38,ATL,49,499,22,59,0,0,22,59,16,45,60
1999,DeJuan Wheat,PG,25,VAN,46,590,73,193,22,60,51,133,40,55,208
1999,Tyson Wheeler,PG,23,DEN,1,3,1,1,1,1,0,0,1,2,4
1999,Jahidi White,PF,22,WAS,20,191,17,32,0,0,17,32,15,35,49
1999,Chris Whitney,PG,27,WAS,39,441,64,156,32,95,32,61,27,31,187
1999,Dominique Wilkins*,SF,39,ORL,27,252,50,132,5,19,45,113,29,42,134
1999,Gerald Wilkins,SG,35,ORL,3,28,0,9,0,0,0,9,2,2,2
1999,Aaron Williams,PF,27,SEA,40,458,52,123,0,1,52,122,54,74,158
1999,Alvin Williams,PG,24,TOR,50,1051,95,237,14,42,81,195,44,52,248
1999,Brandon Williams,SG,23,SAS,3,4,0,0,0,0,0,0,2,4,2
1999,Eric Williams,SF,26,DEN,38,780,80,219,6,26,74,193,111,139,277
1999,Herb Williams,C,40,NYK,6,34,4,8,0,0,4,8,2,2,10
1999,Hot Rod,C,36,DAL,25,403,11,33,0,0,11,33,7,10,29
1999,Jason Williams,PG,23,SAC,50,1805,231,617,100,323,131,294,79,105,641
1999,Jayson Williams,C,30,NJN,30,1020,97,218,0,2,97,216,48,85,242
1999,Jerome Williams,PF,25,DET,50,1154,124,248,0,0,124,248,107,159,355
1999,Micheal Williams,PG,32,TOR,2,15,1,5,0,0,1,5,0,0,2
1999,Monty Williams,SF,27,DEN,1,6,0,2,0,0,0,2,1,2,1
1999,Scott Williams,C,30,TOT,7,46,5,17,0,0,5,17,4,7,14
1999,Scott Williams,C,30,PHI,2,17,0,2,0,0,0,2,0,0,0
1999,Scott Williams,C,30,MIL,5,29,5,15,0,0,5,15,4,7,14
1999,Shammond Williams,PG,23,ATL,2,4,0,1,0,0,0,1,3,4,3
1999,Travis Williams,SF,29,CHH,8,62,6,13,0,0,6,13,3,4,15
1999,Walt Williams,SF,28,POR,48,1044,147,347,63,144,84,203,89,107,446
1999,Corliss Williamson,SF,25,SAC,50,1374,269,555,1,5,268,550,120,188,659
1999,Kevin Willis,C,36,TOR,42,1216,187,447,0,2,187,445,130,155,504
1999,David Wingate,SG,35,NYK,20,92,7,16,0,0,7,16,0,0,14
1999,Trevor Winter,C,25,MIN,1,5,0,0,0,0,0,0,0,0,0
1999,Joe Wolf,PF,34,CHH,3,12,0,1,0,0,0,1,0,2,0
1999,Haywoode Workman,PG,33,MIL,29,815,73,170,17,47,56,123,37,47,200
1999,Lorenzen Wright,C,23,LAC,48,1135,119,260,0,1,119,259,81,117,319
1999,Korleone Young,SF,20,DET,3,15,5,10,1,4,4,6,2,2,13
,,,,,,,,,,,,,,,
2000,Tariq Abdul-Wahad,SG,25,TOT,61,1578,274,646,3,23,271,623,146,193,697
2000,Tariq Abdul-Wahad,SG,25,ORL,46,1205,223,515,2,21,221,494,115,151,563
2000,Tariq Abdul-Wahad,SG,25,DEN,15,373,51,131,1,2,50,129,31,42,134
2000,Shareef Abdur-Rahim,SF,23,VAN,82,3223,594,1277,29,96,565,1181,446,551,1663
2000,Cory Alexander,PG,26,DEN,29,329,28,98,9,35,19,63,17,22,82
2000,Ray Allen,SG,24,MIL,82,3070,642,1411,172,407,470,1004,353,398,1809
2000,Rafer Alston,PG,23,MIL,27,361,27,95,3,14,24,81,3,4,60
2000,John Amaechi,C,29,ORL,80,1684,306,700,1,6,305,694,223,291,836
2000,Derek Anderson,SG,25,LAC,64,2201,377,860,55,178,322,682,271,309,1080
2000,Kenny Anderson,PG,29,BOS,82,2593,434,986,85,220,349,766,196,253,1149
2000,Nick Anderson,SG,32,SAC,72,2094,306,782,132,397,174,385,37,76,781
2000,Shandon Anderson,SF,26,HOU,82,2700,368,778,79,225,289,553,194,253,1009
2000,Chris Anstey,C,25,CHI,73,1007,161,364,1,6,160,358,116,147,439
2000,Greg Anthony,PG,32,POR,82,1548,169,416,88,233,81,183,88,114,514
2000,B.J. Armstrong,PG,32,CHI,27,583,83,186,13,29,70,157,22,25,201
2000,Darrell Armstrong,PG,31,ORL,82,2590,484,1119,137,403,347,716,225,247,1330
2000,Chucky Atkins,PG,25,ORL,82,1626,314,741,57,163,257,578,97,133,782
2000,Stacey Augmon,SG,31,POR,59,692,83,175,0,2,83,173,37,55,203
2000,Isaac Austin,C,30,WAS,59,1173,151,352,1,4,150,348,94,137,397
2000,Anthony Avent,PF,30,LAC,49,377,29,96,0,0,29,96,23,32,81
2000,William Avery,PG,20,MIN,59,484,56,181,18,63,38,118,24,36,154
2000,Toby Bailey,SG,24,PHO,46,449,58,140,2,10,56,130,45,65,163
2000,Vin Baker,C,28,SEA,79,2849,514,1129,2,8,512,1121,281,412,1311
2000,Charles Barkley*,PF,36,HOU,20,620,106,222,6,26,100,196,71,110,289
2000,Dana Barros,PG,32,BOS,72,1139,196,435,59,144,137,291,66,76,517
2000,Brent Barry,SG,28,SEA,80,2726,327,707,164,399,163,308,127,157,945
2000,Drew Barry,PG,26,TOT,16,159,15,33,7,18,8,15,4,5,41
2000,Drew Barry,PG,26,GSW,8,85,9,18,3,9,6,9,1,2,22
2000,Drew Barry,PG,26,ATL,8,74,6,15,4,9,2,6,3,3,19
2000,Jon Barry,SG,30,SAC,62,1281,161,346,66,154,95,192,107,116,495
2000,Tony Battie,C,23,BOS,82,1505,219,459,1,8,218,451,102,151,541
2000,Jonathan Bender,SF,19,IND,24,130,23,70,2,12,21,58,16,24,64
2000,Benoit Benjamin,C,35,CLE,3,8,1,3,0,0,1,3,0,0,2
2000,Corey Benjamin,SG,21,CHI,48,862,145,350,31,89,114,261,49,82,370
2000,Mario Bennett,PF,26,LAC,1,3,0,3,0,0,0,3,0,0,0
2000,Travis Best,PG,27,IND,82,1691,271,561,35,93,236,468,156,190,733
2000,Mike Bibby,PG,21,VAN,82,3155,459,1031,77,212,382,819,195,250,1190
2000,Chauncey Billups,SG,23,DEN,13,305,34,101,7,41,27,60,37,44,112
2000,Mookie Blaylock,PG,32,GSW,73,2459,327,837,101,301,226,536,67,95,822
2000,Corie Blount,PF,31,PHO,38,446,44,89,0,2,44,87,19,33,107
2000,Muggsy Bogues,PG,35,TOR,80,1731,157,358,17,51,140,307,79,87,410
2000,Etdrick Bohannon,PF,26,TOT,13,118,7,13,0,0,7,13,15,24,29
2000,Etdrick Bohannon,PF,26,NYK,2,5,0,0,0,0,0,0,3,4,3
2000,Etdrick Bohannon,PF,26,LAC,11,113,7,13,0,0,7,13,12,20,26
2000,Calvin Booth,C,23,WAS,11,143,16,46,0,0,16,46,10,14,42
2000,Lazaro Borrell,SF,27,SEA,17,167,28,63,0,3,28,60,6,11,62
2000,Cal Bowdler,SF,22,ATL,46,423,49,115,0,1,49,114,24,38,122
2000,Bruce Bowen,SF,28,TOT,69,878,72,194,27,58,45,136,25,43,196
2000,Bruce Bowen,SF,28,PHI,42,311,26,73,1,2,25,71,6,12,59
2000,Bruce Bowen,SF,28,MIA,27,567,46,121,26,56,20,65,19,31,137
2000,Ryan Bowen,SF,24,DEN,52,589,46,117,1,9,45,108,38,53,131
2000,Ira Bowman,SG,26,PHI,11,20,2,2,0,0,2,2,1,2,5
2000,Earl Boykins,PG,23,TOT,26,261,56,116,8,20,48,96,18,23,138
2000,Earl Boykins,PG,23,ORL,1,8,3,4,0,0,3,4,0,0,6
2000,Earl Boykins,PG,23,CLE,25,253,53,112,8,20,45,92,18,23,132
2000,Shawn Bradley,C,27,DAL,77,1901,266,555,1,5,265,550,114,149,647
2000,A.J. Bramlett,C,23,CLE,8,61,4,21,0,0,4,21,0,0,8
2000,Elton Brand,PF,20,CHI,81,2999,630,1306,0,2,630,1304,367,536,1627
2000,Terrell Brandon,PG,29,MIN,71,2587,486,1042,53,132,433,910,187,208,1212
2000,Chucky Brown,PF,31,TOT,63,1096,148,328,2,10,146,318,36,52,334
2000,Chucky Brown,PF,31,SAS,30,602,82,176,1,3,81,173,25,31,190
2000,Chucky Brown,PF,31,CHH,33,494,66,152,1,7,65,145,11,21,144
2000,Dee Brown,PG,31,TOR,38,673,93,258,67,187,26,71,11,16,264
2000,Marcus Brown,SG,25,DET,6,45,4,14,0,7,4,7,2,2,10
2000,P.J. Brown,PF,30,MIA,80,2302,322,671,0,1,322,670,120,159,764
2000,Randy Brown,PG,31,CHI,59,1625,157,435,3,6,154,429,62,84,379
2000,Rick Brunson,PG,27,NYK,37,289,29,70,2,13,27,57,11,18,71
2000,Kobe Bryant,SG,21,LAL,66,2524,554,1183,46,144,508,1039,331,403,1485
2000,Mark Bryant,PF,34,CLE,75,1712,174,346,0,0,174,346,76,94,424
2000,Greg Buckner,SG,23,DAL,48,923,111,233,10,26,101,207,43,63,275
2000,Jud Buechler,SF,31,DET,58,657,55,156,18,83,37,73,2,7,130
2000,Rodney Buford,SG,22,MIA,34,386,62,151,7,29,55,122,16,22,147
2000,Matt Bullard,PF,32,HOU,56,1024,139,340,79,177,60,163,25,30,382
2000,Scott Burrell,SF,29,NJN,74,1336,165,419,82,232,83,187,39,50,451
2000,Jason Caffey,PF,26,GSW,71,2159,323,675,0,2,323,673,206,345,852
2000,Michael Cage,C,38,NJN,20,242,12,24,0,0,12,24,3,3,27
2000,Marcus Camby,C,25,NYK,59,1548,226,471,1,2,225,469,148,221,601
2000,Elden Campbell,C,31,CHH,78,2538,370,829,0,6,370,823,247,358,987
2000,Antoine Carr,SF,38,VAN,21,221,28,64,0,0,28,64,11,14,67
2000,Chris Carr,SF-SG,25,TOT,57,1166,196,496,32,101,164,395,107,125,531
2000,Chris Carr,SG,25,GSW,7,74,11,33,1,8,10,25,16,19,39
2000,Chris Carr,SF,25,CHI,50,1092,185,463,31,93,154,370,91,106,492
2000,Anthony Carter,PG,24,MIA,79,1859,201,509,3,23,198,486,93,124,498
2000,Vince Carter,SF,23,TOR,82,3126,788,1696,95,236,693,1460,436,551,2107
2000,Sam Cassell,PG,30,MIL,81,2899,545,1170,26,90,519,1080,390,445,1506
2000,Kelvin Cato,C,25,HOU,65,1581,216,402,0,4,216,398,135,208,567
2000,Duane Causwell,C,31,MIA,25,185,20,37,0,0,20,37,26,38,66
2000,Cedric Ceballos,SF,30,DAL,69,2064,447,1002,44,134,403,868,209,248,1147
2000,John Celestand,PG,22,LAL,16,185,15,45,2,9,13,36,5,6,37
2000,Rex Chapman,SG,32,PHO,53,957,124,320,41,123,83,197,59,78,348
2000,Calbert Cheaney,SG,28,BOS,67,1309,120,273,18,54,102,219,9,21,267
2000,Pete Chilcutt,PF,31,TOT,56,601,53,127,6,26,47,101,8,8,120
2000,Pete Chilcutt,PF,31,UTA,26,224,22,62,1,10,21,52,2,2,47
2000,Pete Chilcutt,PF,31,CLE,6,30,0,2,0,0,0,2,0,0,0
2000,Pete Chilcutt,PF,31,LAC,24,347,31,63,5,16,26,47,6,6,73
2000,Chris Childs,PG,32,NYK,71,1675,146,357,37,104,109,253,47,59,376
2000,Doug Christie,SG,29,TOR,73,2264,311,764,99,275,212,489,182,216,903
2000,Keon Clark,C,24,DEN,81,1850,286,528,1,8,285,520,121,176,694
2000,Keith Closs,C,23,LAC,57,820,96,197,0,3,96,194,46,78,238
2000,Derrick Coleman,PF,32,CHH,74,2347,446,979,51,141,395,838,296,377,1239
2000,Bimbo Coles,PG,31,ATL,80,1924,276,607,8,39,268,568,85,104,645
2000,Marty Conlon,C,32,LAC,3,9,1,2,0,0,1,2,0,0,2
2000,Tyrone Corbin,SF,37,SAC,54,941,88,247,10,44,78,203,33,39,219
2000,Chris Crawford,PF,24,ATL,55,668,91,229,7,27,84,202,63,81,252
2000,Austin Croshere,PF,24,IND,81,1885,288,653,63,174,225,479,196,231,835
2000,John Crotty,PG,30,DET,69,937,106,251,33,80,73,171,80,93,325
2000,Terry Cummings,PF,38,GSW,22,398,76,177,0,0,76,177,32,39,184
2000,Vonteego Cummings,PG,23,GSW,75,1793,265,655,49,151,216,504,127,169,706
2000,Bill Curley,SF-PF,27,TOT,28,309,29,68,0,1,29,67,18,25,76
2000,Bill Curley,PF,27,HOU,4,50,6,11,0,0,6,11,0,0,12
2000,Bill Curley,SF,27,GSW,24,259,23,57,0,1,23,56,18,25,64
2000,Dell Curry,SG,35,TOR,67,1095,194,454,95,242,99,212,24,32,507
2000,Michael Curry,SG,31,DET,82,1611,182,379,1,5,181,374,141,168,506
2000,Erick Dampier,C,24,GSW,21,495,70,173,0,0,70,173,27,51,167
2000,Antonio Daniels,SG,24,SAS,68,1195,163,344,22,66,141,278,72,101,420
2000,Kornel David,SF,28,TOT,32,474,67,157,0,3,67,154,45,56,179
2000,Kornel David,SF,28,CHI,26,443,63,148,0,3,63,145,42,52,168
2000,Kornel David,SF,28,CLE,6,31,4,9,0,0,4,9,3,4,11
2000,Antonio Davis,C,31,TOR,79,2479,313,712,0,0,313,712,284,371,910
2000,Baron Davis,PG,20,CHH,82,1523,182,433,25,111,157,322,97,153,486
2000,Ben Davis,PF,27,PHO,5,22,2,6,0,0,2,6,0,0,4
2000,Dale Davis,C,30,IND,74,2127,302,602,0,0,302,602,139,203,743
2000,Emanual Davis,PG,31,SEA,54,701,80,220,31,103,49,117,26,38,217
2000,Hubert Davis,PG,29,DAL,79,1817,217,464,82,167,135,297,67,77,583
2000,Mark Davis,SF,26,GSW,23,464,56,137,0,2,56,135,31,47,143
2000,Ricky Davis,SG,20,CHH,48,570,94,187,0,4,94,183,39,51,227
2000,Todd Day,SG,30,PHO,58,941,130,330,64,165,66,165,72,108,396
2000,Andrew DeClercq,C,26,CLE,82,1831,225,443,0,0,225,443,94,160,544
2000,Vinny Del,PG,33,MIL,67,1211,153,325,8,24,145,301,35,39,349
2000,Tony Delk,PG,26,SAC,46,682,120,279,9,40,111,239,47,59,296
2000,Derrick Dial,SG,24,SAS,8,95,17,46,3,12,14,34,3,5,40
2000,Michael Dickerson,SG,24,VAN,82,3103,554,1270,119,291,435,979,269,324,1496
2000,Vlade Divac,C,31,SAC,82,2374,384,764,7,26,377,738,230,333,1005
2000,Michael Doleac,C,22,ORL,81,1335,242,535,1,2,241,533,80,95,565
2000,Sherman Douglas,PG,33,NJN,20,309,45,90,5,16,40,74,25,28,120
2000,Bryce Drew,PG,25,HOU,72,1293,158,413,59,163,99,250,45,53,420
2000,Chris Dudley,C,34,NYK,47,459,23,67,0,0,23,67,9,27,55
2000,Tim Duncan,PF,23,SAS,74,2875,628,1281,1,11,627,1270,459,603,1716
2000,Howard Eisley,PG,27,UTA,82,2096,282,675,60,163,222,512,84,102,708
2000,Obinna Ekezie,PF,24,VAN,39,351,41,88,0,0,41,88,43,64,125
2000,Mario Elie,SF,36,SAS,79,2217,195,457,74,186,121,271,126,149,590
2000,Sean Elliott,SF,31,SAS,19,391,38,106,13,37,25,69,25,32,114
2000,Dale Ellis,SG,39,TOT,42,564,66,159,37,100,29,59,9,13,178
2000,Dale Ellis,SG,39,MIL,18,324,47,101,23,65,24,36,6,9,123
2000,Dale Ellis,SG,39,CHH,24,240,19,58,14,35,5,23,3,4,55
2000,LaPhonso Ellis,PF,29,ATL,58,1309,209,464,3,21,206,443,66,95,487
2000,Pervis Ellison,C,32,BOS,30,269,19,43,0,0,19,43,15,21,53
2000,Evan Eschmeyer,C,24,NJN,31,373,38,72,0,0,38,72,15,30,91
2000,Patrick Ewing*,C,37,NYK,62,2035,361,775,0,2,361,773,207,283,929
2000,Tony Farmer,PF,30,GSW,74,1199,127,312,8,44,119,268,203,265,465
2000,Jamie Feick,C,25,NJN,81,2241,181,423,3,3,178,420,94,133,459
2000,Danny Ferry,PF,33,CLE,63,1326,189,380,33,75,156,305,52,57,463
2000,Michael Finley,SF,26,DAL,82,3464,748,1636,99,247,649,1389,260,317,1855
2000,Derek Fisher,PG,25,LAL,78,1803,167,483,52,166,115,317,105,145,491
2000,Danny Fortson,PF,23,BOS,55,856,140,265,0,0,140,265,139,189,419
2000,Greg Foster,PF,31,SEA,60,718,91,224,3,15,88,209,18,28,203
2000,Jeff Foster,C,23,IND,19,86,13,23,0,1,13,22,17,25,43
2000,Rick Fox,SF,30,LAL,82,1473,206,498,59,181,147,317,63,78,534
2000,Adonal Foyle,C,24,GSW,76,1654,193,380,0,0,193,380,34,90,420
2000,Steve Francis,PG,22,HOU,77,2776,497,1117,107,310,390,807,287,365,1388
2000,Todd Fuller,C,25,CHH,41,399,51,122,0,0,51,122,32,53,134
2000,Lawrence Funderburke,PF,29,SAC,75,1026,184,352,0,2,184,350,115,163,483
2000,Kevin Garnett,PF,23,MIN,81,3243,759,1526,30,81,729,1445,309,404,1857
2000,Dean Garrett,C,33,MIN,56,604,48,108,0,0,48,108,18,26,114
2000,Kiwane Garris,SG,25,ORL,3,23,2,10,0,1,2,9,0,0,4
2000,Pat Garrity,SF,23,ORL,82,1479,258,585,79,197,179,388,80,111,675
2000,Chris Gatling,PF,32,TOT,85,1811,365,802,18,70,347,732,266,373,1014
2000,Chris Gatling,PF,32,ORL,45,1041,210,462,7,23,203,439,171,245,598
2000,Chris Gatling,PF,32,DEN,40,770,155,340,11,47,144,293,95,128,416
2000,Matt Geiger,C,30,PHI,65,1406,260,589,0,4,260,585,109,140,629
2000,Devean George,SF,22,LAL,49,345,56,144,16,47,40,97,27,41,155
2000,Kendall Gill,SF,31,NJN,76,2355,396,956,20,78,376,878,181,255,993
2000,Armen Gilliam,PF,35,UTA,50,782,133,305,0,1,133,304,67,86,333
2000,Dion Glover,SG,21,ATL,30,446,66,171,12,45,54,126,51,70,195
2000,Brian Grant,PF,27,POR,63,1322,173,352,1,2,172,350,112,166,459
2000,Gary Grant,PG,34,POR,3,24,6,14,0,0,6,14,0,0,12
2000,Horace Grant,PF,34,SEA,76,2688,266,599,0,4,266,595,80,111,612
2000,Devin Gray,SF,27,HOU,21,124,15,37,0,0,15,37,19,29,49
2000,A.C. Green,PF,36,LAL,82,1929,173,387,1,4,172,383,66,95,413
2000,Adrian Griffin,SG,25,BOS,72,1927,175,413,16,57,159,356,119,158,485
2000,Tom Gugliotta,PF,30,PHO,54,1767,310,645,1,8,309,637,117,151,738
2000,Darvin Ham,SF,26,MIL,35,792,71,128,0,1,71,127,35,78,177
2000,Richard Hamilton,SG,21,WAS,71,1373,254,605,28,77,226,528,103,133,639
2000,Thomas Hamilton,C,24,HOU,22,273,35,79,0,0,35,79,12,23,82
2000,Tom Hammonds,PF,32,MIN,56,372,42,97,0,0,42,97,33,56,117
2000,Anfernee Hardaway,SG,28,PHO,60,2253,378,798,33,102,345,696,226,286,1015
2000,Tim Hardaway,PG,33,MIA,52,1672,246,638,94,256,152,382,110,133,696
2000,Ron Harper,PG,36,LAL,80,2042,212,531,33,106,179,425,100,147,557
2000,Matt Harpring,SF,23,ORL,4,63,4,17,2,2,2,15,6,7,16
2000,Al Harrington,PF,19,IND,50,854,121,264,8,34,113,230,78,111,328
2000,Othella Harrington,PF,26,VAN,82,2677,420,830,0,2,420,828,236,298,1076
2000,Lucious Harris,SG,29,NJN,77,1510,198,463,38,115,160,348,79,99,513
2000,Antonio Harvey,PF,29,POR,19,137,17,30,0,0,17,30,7,12,41
2000,Hersey Hawkins,SG,33,CHI,61,1622,159,375,55,141,104,234,107,119,480
2000,Michael Hawkins,PG,27,CHH,12,36,3,13,1,5,2,8,1,2,8
2000,Alan Henderson,PF,27,ATL,82,2775,429,930,1,10,428,920,224,334,1083
2000,Cedric Henderson,SF,24,CLE,61,1107,129,326,1,15,128,311,69,104,328
2000,Mark Hendrickson,PF,25,TOT,15,71,5,8,0,0,5,8,3,4,13
2000,Mark Hendrickson,PF,25,CLE,10,47,5,7,0,0,5,7,2,2,12
2000,Mark Hendrickson,PF,25,NJN,5,24,0,1,0,0,0,1,1,2,1
2000,Chris Herren,PG,24,DEN,45,597,45,124,24,67,21,57,27,40,141
2000,Grant Hill,SF,27,DET,74,2776,696,1422,34,98,662,1324,480,604,1906
2000,Tyrone Hill,PF,31,PHI,68,2155,318,656,0,1,318,655,179,259,815
2000,Fred Hoiberg,SG,27,CHI,31,845,89,230,32,94,57,136,69,76,279
2000,Derek Hood,PF,23,CHH,2,4,0,3,0,0,0,3,0,0,0
2000,Jeff Hornacek,SG,36,UTA,77,2133,358,728,66,138,292,590,171,180,953
2000,Robert Horry,PF,29,LAL,76,1685,159,363,29,94,130,269,89,113,436
2000,Allan Houston,SG,28,NYK,82,3169,614,1271,106,243,508,1028,280,334,1614
2000,Juwan Howard,PF,26,WAS,82,2909,509,1108,0,7,509,1101,202,275,1220
2000,Troy Hudson,PG,23,LAC,62,1592,204,541,60,193,144,348,77,95,545
2000,Larry Hughes,SG,21,TOT,82,2324,459,1147,29,125,430,1022,279,377,1226
2000,Larry Hughes,SG,21,PHI,50,1018,192,461,11,51,181,410,106,142,501
2000,Larry Hughes,SG,21,GSW,32,1306,267,686,18,74,249,612,173,235,725
2000,Rick Hughes,PF,26,DAL,21,224,35,72,0,1,35,71,12,26,82
2000,Lindsey Hunter,PG,29,DET,82,2919,379,892,168,389,211,503,117,154,1043
2000,Allen Iverson*,SG,24,PHI,70,2853,729,1733,89,261,640,1472,442,620,1989
2000,Bobby Jackson,PG,26,MIN,73,1034,140,346,13,46,127,300,76,98,369
2000,Jaren Jackson,SG,32,SAS,81,1691,186,488,108,306,78,182,33,51,513
2000,Jermaine Jackson,SG,23,DET,7,73,1,11,0,1,1,10,5,8,7
2000,Jim Jackson,SF,29,ATL,79,2767,507,1235,117,303,390,932,186,212,1317
2000,Mark Jackson,PG,34,IND,81,2190,246,570,89,221,157,349,79,98,660
2000,Randell Jackson,PF,24,DAL,1,1,0,0,0,0,0,0,0,0,0
2000,Sam Jacobson,PG,24,TOT,52,681,108,212,9,24,99,188,30,41,255
2000,Sam Jacobson,PG,24,LAL,3,18,5,9,0,0,5,9,0,2,10
2000,Sam Jacobson,PG,24,GSW,49,663,103,203,9,24,94,179,30,39,245
2000,Tim James,SF,23,MIA,4,23,5,14,0,0,5,14,1,3,11
2000,Antawn Jamison,SF,23,GSW,43,1556,356,756,2,7,354,749,127,208,841
2000,Harold Jamison,PF,23,MIA,12,74,7,20,0,0,7,20,4,18,18
2000,Anthony Johnson,PG,25,TOT,56,637,62,164,2,11,60,153,28,39,154
2000,Anthony Johnson,PG,25,ATL,38,423,36,103,1,6,35,97,19,24,92
2000,Anthony Johnson,PG,25,ORL,18,214,26,61,1,5,25,56,9,15,62
2000,Avery Johnson,PG,34,SAS,82,2571,402,850,1,9,401,841,114,155,919
2000,DeMarco Johnson,PF,24,NYK,5,37,3,9,0,0,3,9,0,0,6
2000,Ervin Johnson,C,32,MIL,80,2129,144,279,0,1,144,278,95,157,383
2000,Kevin Johnson,PG,33,PHO,6,113,16,28,1,1,15,27,7,7,40
2000,Larry Johnson,PF,30,NYK,70,2281,282,652,58,174,224,478,128,167,750
2000,Charles Jones,PG,24,LAC,56,662,66,201,39,118,27,83,17,23,188
2000,Damon Jones,PG,23,TOT,55,612,80,208,41,114,39,94,32,48,233
2000,Damon Jones,PG,23,GSW,13,196,25,54,11,23,14,31,7,9,68
2000,Damon Jones,PG,23,DAL,42,416,55,154,30,91,25,63,25,39,165
2000,Eddie Jones,SG,28,CHH,72,2807,478,1119,128,341,350,778,362,419,1446
2000,Jumaine Jones,SF,20,PHI,33,138,22,58,2,4,20,54,11,18,57
2000,Popeye Jones,PF,29,DEN,40,330,44,104,2,3,42,101,14,19,104
2000,Reggie Jordan,PG,32,WAS,36,243,17,53,0,1,17,52,7,13,41
2000,Adam Keefe,C,29,UTA,62,604,53,130,0,1,53,129,29,36,135
2000,Shawn Kemp,C,30,CLE,82,2492,484,1160,2,6,482,1154,493,635,1463
2000,Steve Kerr,PG,34,SAS,32,268,32,74,16,31,16,43,9,11,89
2000,Jerome Kersey,SF,37,SAS,72,1310,146,354,0,9,146,345,29,41,321
2000,Lari Ketner,PF,22,TOT,22,132,13,32,0,0,13,32,8,12,34
2000,Lari Ketner,PF,22,CHI,6,41,4,10,0,0,4,10,2,2,10
2000,Lari Ketner,PF,22,CLE,16,91,9,22,0,0,9,22,6,10,24
2000,Jason Kidd,PG,26,PHO,67,2616,350,855,56,166,294,689,203,245,959
2000,Gerard King,SF,27,WAS,62,1060,139,277,0,0,139,277,49,66,327
2000,Kerry Kittles,SG,25,NJN,62,1896,305,698,96,240,209,458,101,127,807
2000,Joe Kleine,C,38,POR,7,31,4,11,0,0,4,11,3,3,11
2000,Brevin Knight,PG,24,CLE,65,1754,230,558,2,10,228,548,140,184,602
2000,Travis Knight,C,25,LAL,63,410,46,118,0,0,46,118,17,28,109
2000,Toni Kukoc,SF,31,TOT,56,1784,297,728,44,168,253,560,192,265,830
2000,Toni Kukoc,SF,31,CHI,24,868,148,388,18,78,130,310,118,155,432
2000,Toni Kukoc,SF,31,PHI,32,916,149,340,26,90,123,250,74,110,398
2000,Christian Laettner,C,30,DET,82,2443,379,801,7,24,372,777,237,292,1002
2000,Raef LaFrentz,C,23,DEN,81,2435,392,879,60,183,332,696,162,236,1006
2000,Andrew Lang,C,33,NYK,19,244,28,64,0,0,28,64,3,7,59
2000,Antonio Lang,SF,27,TOT,10,38,1,6,0,0,1,6,4,5,6
2000,Antonio Lang,SF,27,TOR,7,32,0,5,0,0,0,5,3,4,3
2000,Antonio Lang,SF,27,PHI,3,6,1,1,0,0,1,1,1,1,3
2000,Trajan Langdon,SG,23,CLE,10,145,15,40,8,19,7,21,11,11,49
2000,Rusty LaRue,PG,26,CHI,4,129,15,43,2,14,13,29,5,7,37
2000,Tim Legler,SG,33,GSW,23,284,28,78,7,21,21,57,14,18,77
2000,Voshon Lenard,SG,26,MIA,53,1434,228,560,89,228,139,332,84,106,629
2000,Quincy Lewis,SG,22,UTA,74,896,111,298,23,63,88,235,38,52,283
2000,Rashard Lewis,SF,20,SEA,82,1575,275,566,40,120,235,446,84,123,674
2000,Randy Livingston,PG,24,PHO,79,1081,155,373,19,55,136,318,52,62,381
2000,Grant Long,PF,33,VAN,42,920,74,167,0,4,74,163,55,71,203
2000,Luc Longley,C,31,PHO,72,1417,186,399,0,0,186,399,80,97,452
2000,Felipe Lopez,SG,25,VAN,65,781,111,261,3,18,108,243,67,109,292
2000,Tyronn Lue,PG,22,LAL,8,146,19,39,4,8,15,31,6,8,48
2000,George Lynch,SF,29,PHI,75,2416,297,644,15,36,282,608,113,183,722
2000,Todd MacCulloch,C,24,PHI,56,528,89,161,0,0,89,161,28,54,206
2000,Sam Mack,SF,29,GSW,23,333,37,122,21,64,16,58,19,20,114
2000,Don MacLean,PF,30,PHO,16,143,18,49,2,6,16,43,4,6,42
2000,Corey Maggette,SF,20,ORL,77,1370,224,469,2,11,222,458,196,261,646
2000,Dan Majerle,SG,34,MIA,69,2308,170,422,110,304,60,118,56,69,506
2000,Karl Malone*,PF,36,UTA,82,2947,752,1476,2,8,750,1468,589,739,2095
2000,Matt Maloney,PG,28,CHI,51,1175,114,318,62,174,52,144,37,45,327
2000,Danny Manning,PF,33,MIL,72,1217,149,339,1,4,148,335,34,52,333
2000,Stephon Marbury,PG,22,NJN,74,2881,569,1317,66,233,503,1084,436,536,1640
2000,Shawn Marion,SF,21,PHO,51,1260,222,471,4,22,218,449,72,85,520
2000,Sean Marks,PF,24,TOR,5,12,2,6,0,1,2,5,4,4,8
2000,Donny Marshall,SF,27,CLE,6,39,3,11,0,3,3,8,5,6,11
2000,Donyell Marshall,PF,26,GSW,64,2071,331,840,49,138,282,702,199,255,910
2000,Darrick Martin,PG,28,SAC,71,893,133,350,38,124,95,226,98,119,402
2000,Jamal Mashburn,SF,27,MIA,76,2828,515,1158,112,278,403,880,186,239,1328
2000,Anthony Mason,SF,33,CHH,82,3133,317,661,0,1,317,660,314,421,948
2000,Tony Massenburg,PF,32,HOU,10,109,16,36,0,0,16,36,14,16,46
2000,Vernon Maxwell,SG,34,SEA,47,989,169,490,67,223,102,267,108,148,513
2000,Walter McCarty,PF,25,BOS,61,879,78,230,34,110,44,120,39,54,229
2000,George McCloud,SF,32,DEN,78,2118,266,638,107,283,159,355,148,181,787
2000,Jelani McCoy,C,22,SEA,58,746,102,177,0,0,102,177,45,91,249
2000,Antonio McDyess,PF,25,DEN,81,2698,614,1211,0,2,614,1209,323,516,1551
2000,Tracy McGrady,SF,20,TOR,79,2462,459,1018,18,65,441,953,277,392,1213
2000,Jim McIlvaine,C,27,NJN,66,1048,64,154,0,0,64,154,29,56,157
2000,Jeff McInnis,PG,25,LAC,25,597,80,186,7,21,73,165,13,17,180
2000,Derrick McKey,SF,33,IND,32,634,43,108,10,23,33,85,43,56,139
2000,Aaron McKie,SG,27,PHI,82,1952,244,593,44,121,200,472,121,146,653
2000,Roshown McLeod,SF,24,ATL,44,860,131,332,2,13,129,319,54,70,318
2000,Ron Mercer,SG,23,TOT,68,2377,460,1080,15,48,445,1032,213,270,1148
2000,Ron Mercer,SG,23,DEN,37,1408,272,612,15,39,257,573,119,151,678
2000,Ron Mercer,SG,23,ORL,31,969,188,468,0,9,188,459,94,119,470
2000,Andre Miller,PG,23,CLE,82,2093,339,755,10,49,329,706,226,292,914
2000,Anthony Miller,PF,28,HOU,35,476,52,97,0,0,52,97,26,51,130
2000,Brad Miller,C,23,CHH,55,961,135,293,0,2,135,291,153,195,423
2000,Oliver Miller,C,29,PHO,51,1088,137,233,0,0,137,233,49,73,323
2000,Reggie Miller*,SG,34,IND,81,2987,466,1041,165,404,301,637,373,406,1470
2000,Chris Mills,SF,30,GSW,20,649,123,292,8,30,115,262,68,84,322
2000,Terry Mills,PF,32,DET,82,1842,214,488,95,242,119,246,25,34,548
2000,Jason Miskiri,PG,24,CHH,1,3,0,1,0,1,0,0,0,0,0
2000,Sam Mitchell,SF,36,MIN,66,1227,168,376,10,23,158,353,81,92,427
2000,Cuttino Mobley,SG,24,HOU,81,2496,437,1016,104,292,333,724,299,353,1277
2000,Nazr Mohammed,C,22,PHI,28,190,21,54,0,0,21,54,12,22,54
2000,Eric Montross,C,28,DET,51,332,17,55,0,0,17,55,6,12,40
2000,Mikki Moore,C,24,DET,29,488,87,140,0,0,87,140,54,68,228
2000,Alonzo Mourning*,C,29,MIA,79,2748,652,1184,0,4,652,1180,414,582,1718
2000,Chris Mullin*,SG,36,IND,47,582,80,187,45,110,35,77,37,41,242
2000,Eric Murdock,PG,31,LAC,40,693,79,205,16,42,63,163,51,80,225
2000,Gheorghe Muresan,C,28,NJN,30,267,41,90,0,0,41,90,23,38,105
2000,Lamond Murray,SF,26,CLE,74,2365,460,1019,51,139,409,880,204,268,1175
2000,Tracy Murray,SF,28,WAS,80,1831,290,670,113,263,177,407,120,141,813
2000,Dikembe Mutombo*,C,33,ATL,82,2984,322,573,0,0,322,573,298,421,942
2000,Steve Nash,PG,25,DAL,56,1532,173,363,60,149,113,214,75,85,481
2000,Tyrone Nesby,SG,24,LAC,73,2317,364,915,94,281,270,634,151,191,973
2000,Rasho Nesterovic,C,23,MIN,82,1723,206,433,0,2,206,431,59,103,471
2000,Johnny Newman,SF,36,NJN,82,1763,278,623,72,190,206,433,192,229,820
2000,Moochie Norris,PG,26,HOU,30,502,69,159,12,29,57,130,57,73,207
2000,Dirk Nowitzki,PF,21,DAL,82,2938,515,1118,116,306,399,812,289,348,1435
2000,Jermaine O'Neal,C,21,POR,70,859,108,222,0,1,108,221,57,98,273
2000,Shaquille O'Neal*,C,27,LAL,79,3163,956,1665,0,1,956,1664,432,824,2344
2000,Charles Oakley,PF,36,TOR,80,2431,234,560,14,41,220,519,66,85,548
2000,Lamar Odom,SF,20,LAC,76,2767,449,1024,59,164,390,860,302,420,1259
2000,Hakeem Olajuwon*,C,37,HOU,44,1049,193,421,0,2,193,419,69,112,455
2000,Kevin Ollie,PG,27,PHI,40,290,22,49,0,0,22,49,28,37,72
2000,Michael Olowokandi,C,24,LAC,80,2493,330,756,0,0,330,756,123,189,783
2000,Greg Ostertag,C,26,UTA,81,1606,124,267,0,1,124,266,119,187,367
2000,Bo Outlaw,PF,28,ORL,82,2326,204,339,0,3,204,336,82,162,490
2000,Doug Overton,PG,30,BOS,48,432,61,154,10,28,51,126,20,21,152
2000,Billy Owens,PF-SF,30,TOT,62,1305,150,358,11,34,139,324,63,106,374
2000,Billy Owens,PF,30,PHI,46,919,112,258,9,27,103,231,38,64,271
2000,Billy Owens,SF,30,GSW,16,386,38,100,2,7,36,93,25,42,103
2000,Robert Pack,PG,30,DAL,29,665,96,230,4,11,92,219,63,78,259
2000,Scott Padgett,PF,23,UTA,47,432,44,140,13,44,31,96,19,27,120
2000,Milt Palacio,PG,21,VAN,53,394,43,98,0,2,43,96,22,37,108
2000,Anthony Parker,SG,24,ORL,16,185,24,57,1,14,23,43,8,11,57
2000,Cherokee Parks,C,27,VAN,56,808,72,145,0,1,72,144,24,37,168
2000,Andrae Patterson,PF,24,MIN,5,20,3,4,0,0,3,4,0,0,6
2000,Ruben Patterson,SF,24,SEA,81,2097,354,661,12,27,342,634,222,321,942
2000,Gary Payton*,PG,31,SEA,82,3425,747,1666,177,520,570,1146,311,423,1982
2000,Anthony Peeler,SG,30,MIN,82,2073,316,725,85,255,231,470,87,109,804
2000,Will Perdue,C,34,CHI,67,1012,59,168,0,0,59,168,50,105,168
2000,Sam Perkins,PF,38,IND,81,1620,184,441,89,218,95,223,80,97,537
2000,Elliot Perry,PG,30,NJN,60,803,128,294,11,39,117,255,50,62,317
2000,Chuck Person,SF,35,SEA,37,340,37,123,24,95,13,28,4,8,102
2000,Wesley Person,SG,28,CLE,79,2056,280,654,106,250,174,404,61,77,727
2000,Bobby Phills,SG,30,CHH,28,825,152,335,30,91,122,244,47,65,381
2000,Eric Piatkowski,SF,29,LAC,75,1712,238,573,93,243,145,330,85,100,654
2000,Paul Pierce,SF,22,BOS,73,2583,486,1099,96,280,390,819,359,450,1427
2000,Scottie Pippen*,SF,34,POR,82,2749,388,860,86,263,302,597,160,223,1022
2000,Scot Pollard,C,24,SAC,76,1336,149,283,0,0,149,283,114,159,412
2000,Olden Polynice,C,35,UTA,82,1819,203,398,1,2,202,396,28,90,435
2000,Terry Porter,PG,36,SAS,68,1613,207,463,90,207,117,256,137,170,641
2000,James Posey,SF,23,DEN,81,2052,230,536,82,220,148,316,120,150,662
2000,Vitaly Potapenko,C,24,BOS,79,1797,307,615,0,1,307,614,109,160,723
2000,Brent Price,PG,31,VAN,41,424,41,119,25,68,16,51,34,39,141
2000,Laron Profit,SG,22,WAS,33,225,21,59,3,17,18,42,4,10,49
2000,Aleksandar Radojevic,C,23,TOR,3,24,2,7,0,0,2,7,3,6,7
2000,Theo Ratliff,PF,26,PHI,57,1795,247,491,0,0,247,491,182,236,676
2000,Eldridge Recasner,PG,32,CHH,7,28,3,7,1,4,2,3,0,0,7
2000,Bryant Reeves,C,26,VAN,69,1773,252,562,0,4,252,558,107,165,611
2000,Khalid Reeves,PG,27,CHI,3,48,3,12,0,3,3,9,5,5,11
2000,Don Reid,PF,26,TOT,38,498,60,112,0,0,60,112,24,34,144
2000,Don Reid,PF,26,DET,21,165,16,34,0,0,16,34,3,6,35
2000,Don Reid,PF,26,WAS,17,333,44,78,0,0,44,78,21,28,109
2000,J.R. Reid,PF,31,MIL,34,602,53,127,1,7,52,120,43,56,150
2000,Rodrick Rhodes,SF,26,DAL,1,8,0,3,0,0,0,3,0,0,0
2000,Glen Rice,SF,32,LAL,80,2530,421,980,84,229,337,751,346,396,1272
2000,Mitch Richmond*,SG,34,WAS,74,2397,447,1049,93,241,354,808,298,340,1285
2000,Isaiah Rider,SG,28,ATL,60,2084,449,1072,56,180,393,892,204,260,1158
2000,Stanley Roberts,C,29,PHI,5,51,5,16,0,1,5,15,0,3,10
2000,Ryan Robertson,SG,23,SAC,1,25,2,6,0,2,2,4,1,1,5
2000,Clifford Robinson,SF,33,PHO,80,2839,530,1142,120,324,410,818,298,381,1478
2000,David Robinson*,C,34,SAS,80,2557,528,1031,0,2,528,1029,371,511,1427
2000,Eddie Robinson,SF,23,CHH,67,1112,212,386,0,4,212,382,47,64,471
2000,Glenn Robinson,SF,27,MIL,81,2909,690,1461,86,237,604,1224,227,283,1693
2000,Dennis Rodman*,PF,38,DAL,12,389,12,31,0,1,12,30,10,14,34
2000,Carlos Rogers,C,28,HOU,53,1101,170,324,1,14,169,310,81,137,422
2000,Rodney Rogers,PF,28,PHO,82,2286,428,881,115,262,313,619,159,249,1130
2000,Roy Rogers,PF,26,DEN,40,355,35,88,0,1,35,87,19,41,89
2000,Sean Rooks,C,30,DAL,71,1001,122,283,0,0,122,283,65,89,309
2000,Jalen Rose,SF,27,IND,80,2978,563,1196,77,196,486,1000,254,307,1457
2000,Malik Rose,PF,25,SAS,74,1341,176,385,1,3,175,382,143,198,496
2000,Michael Ruffin,PF,23,CHI,71,975,58,138,0,0,58,138,43,88,159
2000,Bryon Russell,SF,29,UTA,82,2900,408,914,106,268,302,646,237,316,1159
2000,Arvydas Sabonis*,C,35,POR,66,1688,302,598,7,19,295,579,167,198,778
2000,John Salley,C,35,LAL,45,303,25,69,0,0,25,69,21,28,71
2000,Detlef Schrempf,SF,37,POR,77,1662,187,433,21,52,166,381,179,215,574
2000,Dennis Scott,SF,31,VAN,66,1263,125,333,71,189,54,144,48,57,369
2000,Malik Sealy,SF,29,MIN,82,2392,371,780,10,35,361,745,177,218,929
2000,Brian Shaw,SG,33,LAL,74,1249,123,322,18,58,105,264,41,54,305
2000,Dickey Simpkins,PF,27,CHI,69,1651,111,274,0,1,111,273,65,120,287
2000,Brian Skinner,PF,23,LAC,33,775,68,134,0,0,68,134,43,65,179
2000,Joe Smith,C,24,MIN,78,1975,289,623,1,1,288,622,195,258,774
2000,Michael Smith,SF,27,WAS,46,1145,108,192,0,1,108,191,73,101,289
2000,Steve Smith,SG,30,POR,82,2689,420,900,96,241,324,659,289,340,1225
2000,Rik Smits,C,33,IND,79,1852,431,890,0,1,431,889,156,211,1018
2000,Eric Snow,PG,26,PHI,82,2866,257,597,11,45,246,552,126,177,651
2000,Felton Spencer,C,32,SAS,26,149,15,33,0,0,15,33,20,30,50
2000,Latrell Sprewell,SF,29,NYK,82,3276,568,1305,44,127,524,1178,344,397,1524
2000,Ryan Stack,PF,24,CLE,25,198,17,51,0,1,17,50,18,27,52
2000,Jerry Stackhouse,SG,25,DET,82,3148,619,1447,83,288,536,1159,618,758,1939
2000,John Starks,SG,34,TOT,37,1190,203,542,59,171,144,371,50,59,515
2000,John Starks,SG,34,GSW,33,1108,192,508,56,161,136,347,45,54,485
2000,John Starks,SG,34,CHI,4,82,11,34,3,10,8,24,5,5,30
2000,Vladimir Stepania,C,23,SEA,30,202,29,79,0,6,29,73,17,36,75
2000,Joe Stephens,SF,27,VAN,13,181,19,51,0,8,19,43,3,4,41
2000,Michael Stewart,C,24,TOR,42,389,20,53,0,0,20,53,18,32,58
2000,Bryant Stith,SG,29,DEN,45,691,86,189,17,56,69,133,64,77,253
2000,John Stockton*,PG,37,UTA,82,2432,363,725,43,121,320,604,221,257,990
2000,Peja Stojakovic,SF,22,SAC,74,1749,321,717,100,267,221,450,135,153,877
2000,Damon Stoudamire,PG,26,POR,78,2372,386,894,80,212,306,682,122,145,974
2000,Erick Strickland,SG,26,DAL,68,2025,316,730,73,186,243,544,162,195,867
2000,Mark Strickland,SF,29,MIA,58,663,122,224,0,0,122,224,40,56,284
2000,Rod Strickland,PG,33,WAS,69,2188,327,762,1,21,326,741,214,305,869
2000,Derek Strong,PF,31,ORL,20,148,21,48,1,4,20,44,11,14,54
2000,Bruno Sundov,C,19,DAL,14,61,12,31,0,0,12,31,2,2,26
2000,Bob Sura,SG,26,CLE,73,2216,356,815,122,332,234,483,175,251,1009
2000,Wally Szczerbiak,SF,22,MIN,73,2171,342,669,28,78,314,591,133,161,845
2000,Zan Tabak,C,29,IND,18,114,16,34,0,0,16,34,5,8,37
2000,Johnny Taylor,SF,25,TOT,6,34,5,14,1,1,4,13,0,0,11
2000,Johnny Taylor,SF,25,DEN,1,5,0,2,0,0,0,2,0,0,0
2000,Johnny Taylor,SF,25,ORL,5,29,5,12,1,1,4,11,0,0,11
2000,Maurice Taylor,PF,23,LAC,62,2227,458,988,1,8,457,980,143,201,1060
2000,Jason Terry,PG,22,ATL,81,1888,249,600,46,157,203,443,113,140,657
2000,Jamel Thomas,SF,26,TOT,7,46,8,18,0,3,8,15,1,1,17
2000,Jamel Thomas,SF,26,BOS,3,19,5,10,0,1,5,9,1,1,11
2000,Jamel Thomas,SF,26,GSW,4,27,3,8,0,2,3,6,0,0,6
2000,John Thomas,C,24,TOR,55,477,49,107,0,1,49,106,16,41,114
2000,Kenny Thomas,PF,22,HOU,72,1797,212,531,32,122,180,409,138,209,594
2000,Kurt Thomas,PF,27,NYK,80,1971,270,535,1,3,269,532,100,128,641
2000,Tim Thomas,SF,22,MIL,80,2093,347,753,63,182,284,571,188,243,945
2000,Otis Thorpe,PF,37,MIA,51,777,125,243,0,3,125,240,29,48,279
2000,Robert Traylor,PF,22,MIL,44,447,58,122,0,4,58,118,41,68,157
2000,Gary Trent,SF,25,DAL,11,301,70,142,0,2,70,140,11,21,151
2000,Mirsad Turkcan,PF,23,TOT,17,90,14,38,0,6,14,32,5,8,33
2000,Mirsad Turkcan,PF,23,NYK,7,25,2,10,0,2,2,8,0,0,4
2000,Mirsad Turkcan,PF,23,MIL,10,65,12,28,0,4,12,24,5,8,29
2000,Wayne Turner,PG,23,BOS,3,41,1,6,0,0,1,6,2,6,4
2000,Nick Van,PG,28,DEN,79,2950,473,1213,133,401,340,812,196,240,1275
2000,Keith Van,PF,24,NJN,80,2782,559,1257,84,228,475,1029,333,393,1535
2000,Jacque Vaughn,PG,24,UTA,78,884,109,262,14,34,95,228,57,76,289
2000,Loy Vaught,PF,31,DET,43,292,32,89,0,3,32,86,11,16,75
2000,Fred Vinson,SG,29,SEA,8,40,5,17,2,7,3,10,1,2,13
2000,Antoine Walker,PF,23,BOS,82,3003,648,1506,73,285,575,1221,311,445,1680
2000,Samaki Walker,PF,23,SAS,71,980,137,305,0,0,137,305,86,126,360
2000,Ben Wallace,PF,25,ORL,81,1959,168,334,0,0,168,334,54,114,390
2000,John Wallace,SF,25,NYK,60,798,155,332,0,3,155,329,82,102,392
2000,Rasheed Wallace,PF,25,POR,81,2845,542,1045,8,50,534,995,233,331,1325
2000,Rex Walters,PG,29,MIA,33,389,38,91,5,20,33,71,12,16,93
2000,Charlie Ward,PG,29,NYK,72,1986,189,447,102,264,87,183,48,58,528
2000,Clarence Weatherspoon,PF,29,MIA,78,1615,215,419,0,0,215,419,135,183,565
2000,Chris Webber,PF,26,SAC,75,2880,748,1548,27,95,721,1453,311,414,1834
2000,Bonzi Wells,SF,23,POR,66,1162,236,480,20,53,216,427,88,129,580
2000,Bill Wennington,C,36,SAC,7,57,6,19,0,0,6,19,2,2,14
2000,David Wesley,PG,29,CHH,82,2760,407,955,88,248,319,707,214,275,1116
2000,Doug West,SG,32,VAN,38,581,59,145,0,3,59,142,34,40,152
2000,Mark West,C,39,PHO,22,127,5,12,0,0,5,12,5,8,15
2000,Jahidi White,C,23,WAS,80,1537,228,450,0,0,228,450,113,211,569
2000,Chris Whitney,PG,28,WAS,82,1627,217,521,96,255,121,266,112,132,642
2000,Aaron Williams,PF,28,WAS,81,1545,235,450,0,3,235,447,146,201,616
2000,Alvin Williams,PG,25,TOR,55,779,114,287,16,55,98,232,48,65,292
2000,Eric Williams,SF,27,BOS,68,1378,165,386,25,72,140,314,134,169,489
2000,Jason Williams,PG,24,SAC,81,2760,363,973,145,505,218,468,128,170,999
2000,Jerome Williams,PF,26,DET,82,2102,257,456,0,3,257,453,175,284,689
2000,Lorenzo Williams,PF,30,WAS,8,76,7,9,0,0,7,9,0,0,14
2000,Monty Williams,SF,28,ORL,75,1501,263,538,2,5,261,533,123,166,651
2000,Scott Williams,C,31,MIL,68,1488,213,426,0,0,213,426,94,129,520
2000,Shammond Williams,PG,24,SEA,43,517,84,225,24,81,60,144,33,51,225
2000,Walt Williams,SF,29,HOU,76,1859,312,681,102,261,210,420,101,123,827
2000,Corliss Williamson,SF,26,SAC,76,1707,311,622,0,0,311,622,163,212,785
2000,Kevin Willis,PF,37,TOR,79,1679,236,569,1,3,235,566,131,164,604
2000,Dedric Willoughby,PG,25,CHI,25,508,61,179,29,98,32,81,39,51,190
2000,David Wingate,SG,36,NYK,7,32,1,9,0,0,1,9,0,0,2
2000,Haywoode Workman,PG,34,TOT,36,350,31,90,14,43,17,47,10,15,86
2000,Haywoode Workman,PG,34,MIL,23,248,23,62,11,29,12,33,9,13,66
2000,Haywoode Workman,PG,34,TOR,13,102,8,28,3,14,5,14,1,2,20
2000,Metta World,SF,20,CHI,72,2238,309,759,60,191,249,568,188,279,866
2000,Lorenzen Wright,C,24,ATL,75,1205,180,361,1,3,179,358,87,135,448
2000,Tim Young,C,23,GSW,25,137,13,39,0,0,13,39,28,36,54
,,,,,,,,,,,,,,,
2001,Mahmoud Abdul-Rauf,PG,31,VAN,41,486,120,246,4,14,116,232,22,29,266
2001,Tariq Abdul-Wahad,SG,26,DEN,29,420,43,111,4,10,39,101,21,36,111
2001,Shareef Abdur-Rahim,SF,24,VAN,81,3241,604,1280,12,64,592,1216,443,531,1663
2001,Cory Alexander,PG,27,ORL,26,227,18,56,4,16,14,40,12,18,52
2001,Courtney Alexander,PG,23,TOT,65,1382,239,573,17,46,222,527,123,150,618
2001,Courtney Alexander,PG,23,DAL,38,472,62,178,3,10,59,168,33,45,160
2001,Courtney Alexander,PG,23,WAS,27,910,177,395,14,36,163,359,90,105,458
2001,Ray Allen,SG,25,MIL,82,3129,628,1309,202,467,426,842,348,392,1806
2001,Rafer Alston,PG,24,MIL,37,288,30,84,8,30,22,54,9,13,77
2001,John Amaechi,C,30,ORL,82,1710,237,592,0,7,237,585,176,279,650
2001,Derek Anderson,SG,26,SAS,82,2859,413,993,101,253,312,740,342,402,1269
2001,Kenny Anderson,PG,30,BOS,33,849,88,227,11,33,77,194,59,71,246
2001,Nick Anderson,SG,33,SAC,21,169,14,57,10,39,4,18,0,0,38
2001,Shandon Anderson,SG,27,HOU,82,2396,263,590,46,170,217,420,138,188,710
2001,Greg Anthony,PG,33,POR,58,856,97,253,65,159,32,94,23,35,282
2001,Darrell Armstrong,PG,32,ORL,75,2767,413,1002,143,403,270,599,220,249,1189
2001,Chucky Atkins,PG,26,DET,81,2363,380,952,121,339,259,613,90,130,971
2001,Stacey Augmon,SG,32,POR,66,1182,127,266,0,4,127,262,57,87,311
2001,Isaac Austin,C,31,VAN,52,845,96,270,6,24,90,246,28,40,226
2001,William Avery,PG,21,MIN,55,463,55,144,16,59,39,85,28,36,154
2001,Dalibor Bagaric,C,20,CHI,35,259,17,65,0,1,17,64,13,28,47
2001,Vin Baker,PF,29,SEA,76,2129,347,822,1,16,346,806,232,321,927
2001,Erick Barkley,PG,22,POR,8,38,8,22,3,8,5,14,0,0,19
2001,Dana Barros,PG,33,DET,60,1079,183,412,44,105,139,307,68,80,478
2001,Brent Barry,SG,29,SEA,67,1778,198,401,109,229,89,172,84,103,589
2001,Jon Barry,SG,31,SAC,62,1010,103,255,46,132,57,123,64,73,316
2001,Tony Battie,C,24,BOS,40,845,108,201,0,3,108,198,44,69,260
2001,Raja Bell,SG,24,PHI,5,30,2,7,1,3,1,4,0,0,5
2001,Jonathan Bender,SF,20,IND,59,574,66,186,11,41,55,145,50,68,193
2001,Corey Benjamin,PG,22,CHI,65,857,115,302,21,81,94,221,56,83,307
2001,David Benoit,SF,32,UTA,49,446,71,147,5,13,66,134,31,39,178
2001,Travis Best,PG,28,IND,77,2457,347,788,37,97,310,691,187,226,918
2001,Mike Bibby,PG,22,VAN,82,3190,525,1157,108,285,417,872,143,188,1301
2001,Chauncey Billups,SG,24,MIN,77,1790,248,587,73,194,175,393,144,171,713
2001,Mookie Blaylock,PG,33,GSW,69,2352,317,801,73,225,244,576,53,76,760
2001,Corie Blount,PF,32,TOT,68,1305,130,294,2,8,128,286,51,83,313
2001,Corie Blount,PF,32,PHO,30,387,23,47,0,0,23,47,8,15,54
2001,Corie Blount,PF,32,GSW,38,918,107,247,2,8,105,239,43,68,259
2001,Mark Blount,C,25,BOS,64,1098,101,200,0,0,101,200,46,66,248
2001,Muggsy Bogues,PG,36,TOR,3,34,0,2,0,1,0,1,0,0,0
2001,Etdrick Bohannon,PF,27,CLE,6,19,2,4,0,0,2,4,4,4,8
2001,Calvin Booth,C,24,TOT,55,933,120,252,0,0,120,252,53,78,293
2001,Calvin Booth,C,24,WAS,40,640,74,168,0,0,74,168,33,45,181
2001,Calvin Booth,C,24,DAL,15,293,46,84,0,0,46,84,20,33,112
2001,Cal Bowdler,SF,23,ATL,44,375,53,114,1,5,52,109,33,40,140
2001,Bruce Bowen,SF,29,MIA,82,2685,211,581,103,307,108,274,98,161,623
2001,Ryan Bowen,SF,25,DEN,57,696,80,144,4,11,76,133,27,44,191
2001,Ira Bowman,PG,27,ATL,3,19,0,2,0,0,0,2,0,0,0
2001,Earl Boykins,PG,24,LAC,10,149,25,63,1,8,24,55,14,17,65
2001,Shawn Bradley,C,28,DAL,82,2001,219,447,1,6,218,441,140,178,579
2001,Elton Brand,PF,21,CHI,74,2906,578,1215,0,2,578,1213,334,472,1490
2001,Terrell Brandon,PG,30,MIN,78,2821,511,1134,33,91,478,1043,195,224,1250
2001,Chucky Brown,SF,32,TOT,26,339,40,95,0,3,40,92,22,34,102
2001,Chucky Brown,SF,32,GSW,6,74,9,20,0,2,9,18,6,10,24
2001,Chucky Brown,SF,32,CLE,20,265,31,75,0,1,31,74,16,24,78
2001,Dee Brown,PG,32,ORL,7,155,16,44,12,32,4,12,4,5,48
2001,P.J. Brown,C,31,CHH,80,2811,249,561,0,4,249,557,178,209,676
2001,Randy Brown,PG,32,BOS,54,1238,100,237,0,3,100,234,23,40,223
2001,Rick Brunson,PG,28,TOT,22,208,18,54,2,14,16,40,8,15,46
2001,Rick Brunson,PG,28,BOS,7,142,10,35,2,11,8,24,4,9,26
2001,Rick Brunson,PG,28,NYK,15,66,8,19,0,3,8,16,4,6,20
2001,Kobe Bryant,SG,22,LAL,68,2783,701,1510,61,200,640,1310,475,557,1938
2001,Mark Bryant,PF,35,DAL,18,101,8,20,0,0,8,20,3,5,19
2001,Greg Buckner,SG,24,DAL,37,820,84,192,2,7,82,185,59,81,229
2001,Jud Buechler,SF,32,DET,57,737,76,164,32,77,44,87,9,12,193
2001,Rodney Buford,SF,23,PHI,47,573,104,241,16,38,88,203,24,29,248
2001,Matt Bullard,PF,33,HOU,61,1000,129,305,86,213,43,92,10,14,354
2001,Scott Burrell,SF,30,CHH,4,41,7,15,2,6,5,9,1,4,17
2001,Jason Caffey,PF,27,MIL,70,1460,179,367,0,0,179,367,142,211,500
2001,Marcus Camby,C,26,NYK,63,2127,304,580,1,8,303,572,150,225,759
2001,Elden Campbell,PF,32,CHH,78,2337,367,834,0,6,367,828,288,406,1022
2001,Brian Cardinal,PF,23,DET,15,126,10,31,0,5,10,26,11,18,31
2001,Chris Carr,SG,26,BOS,35,309,53,112,17,37,36,75,46,60,169
2001,Anthony Carter,PG,25,MIA,72,1630,195,480,6,40,189,440,65,103,461
2001,Vince Carter,SF,24,TOR,75,2979,762,1656,162,397,600,1259,384,502,2070
2001,Sam Cassell,PG,31,MIL,76,2709,537,1132,30,98,507,1034,277,323,1381
2001,Kelvin Cato,C,26,HOU,35,624,64,111,0,0,64,111,37,57,165
2001,Duane Causwell,C,32,MIA,31,384,32,85,0,0,32,85,12,25,76
2001,Cedric Ceballos,SF,31,TOT,40,559,101,229,22,73,79,156,37,43,261
2001,Cedric Ceballos,SF,31,DET,13,166,28,71,11,40,17,31,8,10,75
2001,Cedric Ceballos,SF,31,MIA,27,393,73,158,11,33,62,125,29,33,186
2001,Calbert Cheaney,SG,29,DEN,9,153,10,30,0,0,10,30,1,2,21
2001,Chris Childs,PG,33,TOT,77,1859,135,335,32,106,103,229,60,71,362
2001,Chris Childs,PG,33,NYK,51,1309,93,222,20,64,73,158,39,46,245
2001,Chris Childs,PG,33,TOR,26,550,42,113,12,42,30,71,21,25,117
2001,Doug Christie,SG,30,SAC,81,2939,311,788,94,250,217,538,280,312,996
2001,Keon Clark,PF,25,TOT,81,1720,249,519,0,1,249,518,142,240,640
2001,Keon Clark,PF,25,DEN,35,752,82,199,0,0,82,199,63,105,227
2001,Keon Clark,PF,25,TOR,46,968,167,320,0,1,167,319,79,135,413
2001,Mateen Cleaves,PG,23,DET,78,1268,160,400,5,17,155,383,97,137,422
2001,John Coker,C,29,GSW,6,32,1,8,0,0,1,8,0,0,2
2001,Derrick Coleman,PF,33,CHH,34,683,97,255,20,51,77,204,63,92,277
2001,Bimbo Coles,PG,32,CLE,47,804,91,239,2,16,89,223,48,56,232
2001,Jason Collier,C,23,HOU,23,222,27,71,0,1,27,70,17,24,71
2001,Sean Colson,PG,25,TOT,13,44,6,24,1,5,5,19,2,4,15
2001,Sean Colson,PG,25,ATL,3,14,0,5,0,1,0,4,0,0,0
2001,Sean Colson,PG,25,HOU,10,30,6,19,1,4,5,15,2,4,15
2001,Tyrone Corbin,SF,38,TOR,15,117,9,38,0,5,9,33,2,4,20
2001,Chris Crawford,PF,25,ATL,47,901,122,270,6,22,116,248,68,83,318
2001,Jamal Crawford,PG,20,CHI,61,1050,107,304,41,117,66,187,27,34,282
2001,Austin Croshere,PF,25,IND,81,1874,276,701,70,207,206,494,200,231,822
2001,John Crotty,PG,31,UTA,31,264,22,65,4,7,18,58,17,19,65
2001,Vonteego Cummings,PG,24,GSW,66,1495,178,517,48,143,130,374,79,116,483
2001,Bill Curley,PF,28,TOT,20,192,25,47,1,2,24,45,12,19,63
2001,Bill Curley,PF,28,DAL,5,15,1,4,0,1,1,3,1,4,3
2001,Bill Curley,PF,28,GSW,15,177,24,43,1,1,23,42,11,15,60
2001,Dell Curry,SG,36,TOR,71,956,162,382,62,145,100,237,43,51,429
2001,Michael Curry,SG,32,DET,68,1485,145,319,4,9,141,310,62,73,356
2001,Erick Dampier,C,25,GSW,43,1038,126,314,0,2,126,312,67,126,319
2001,Antonio Daniels,PG,25,SAS,79,2060,275,588,74,183,201,405,121,156,745
2001,Kornel David,SF,29,TOT,27,209,25,51,0,0,25,51,12,13,62
2001,Kornel David,SF,29,TOR,17,140,15,29,0,0,15,29,12,13,42
2001,Kornel David,SF,29,DET,10,69,10,22,0,0,10,22,0,0,20
2001,Antonio Davis,C,32,TOR,78,2729,375,866,0,1,375,865,319,423,1069
2001,Baron Davis,PG,21,CHH,82,3192,409,957,85,274,324,683,228,337,1131
2001,Dale Davis,C,31,POR,81,2162,242,487,0,4,242,483,96,152,580
2001,Emanual Davis,SG,32,SEA,62,1290,133,318,50,127,83,191,45,55,361
2001,Hubert Davis,PG,30,TOT,66,1692,196,433,78,171,118,262,54,62,524
2001,Hubert Davis,PG,30,DAL,51,1261,139,314,58,133,81,181,35,41,371
2001,Hubert Davis,PG,30,WAS,15,431,57,119,20,38,37,81,19,21,153
2001,Ricky Davis,SG,21,MIA,7,70,12,29,1,1,11,28,7,8,32
2001,Terry Davis,PF,33,DEN,19,228,12,25,0,0,12,25,9,22,33
2001,Todd Day,SG,31,MIN,31,345,44,118,26,69,18,49,18,23,132
2001,Andrew DeClercq,C,27,ORL,67,903,107,193,0,0,107,193,47,82,261
2001,Vinny Del,PG,34,TOT,65,922,106,234,1,13,105,221,41,44,254
2001,Vinny Del,PG,34,GSW,29,396,30,90,1,9,29,81,16,16,77
2001,Vinny Del,PG,34,PHO,36,526,76,144,0,4,76,140,25,28,177
2001,Tony Delk,SG,27,PHO,82,2288,383,923,54,168,329,755,185,235,1005
2001,Derrick Dial,SG,25,SAS,33,207,36,83,2,10,34,73,12,21,86
2001,Michael Dickerson,SG,25,VAN,70,2618,425,1020,86,230,339,790,206,270,1142
2001,Vlade Divac,C,32,SAC,81,2420,364,755,4,14,360,741,242,350,974
2001,Michael Doleac,C,23,ORL,77,1398,220,527,0,3,220,524,50,59,490
2001,Keyon Dooling,PG,20,LAC,76,1237,148,362,28,80,120,282,125,179,449
2001,Sherman Douglas,PG,34,NJN,59,1094,122,303,8,40,114,263,86,115,338
2001,Bryce Drew,PG,26,CHI,48,1305,124,327,40,105,84,222,14,19,302
2001,Chris Dudley,C,35,PHO,53,613,29,73,0,0,29,73,14,36,72
2001,Tim Duncan,PF,24,SAS,82,3174,702,1406,7,27,695,1379,409,662,1820
2001,Tyus Edney,PG,27,IND,24,263,35,91,1,6,34,85,35,39,106
2001,Kevin Edwards,SG,35,VAN,46,634,56,170,5,19,51,151,43,53,160
2001,Howard Eisley,SG,28,DAL,82,2426,265,675,107,269,158,406,104,126,741
2001,Obinna Ekezie,PF,25,TOT,33,281,32,81,0,0,32,81,37,53,101
2001,Obinna Ekezie,PF,25,WAS,29,273,32,77,0,0,32,77,37,53,101
2001,Obinna Ekezie,PF,25,DAL,4,8,0,4,0,0,0,4,0,0,0
2001,Khalid El-Amin,PG,21,CHI,50,936,115,311,28,84,87,227,56,72,314
2001,Mario Elie,SG,37,PHO,68,1506,104,246,36,100,68,146,55,69,299
2001,Sean Elliott,SF,32,SAS,52,1229,147,339,55,129,92,210,60,84,409
2001,LaPhonso Ellis,PF,30,MIN,82,1948,298,642,7,22,291,620,169,214,772
2001,Pervis Ellison,C,33,SEA,9,40,2,7,0,0,2,7,2,2,6
2001,Evan Eschmeyer,C,25,NJN,74,1331,92,200,0,0,92,200,67,102,251
2001,Patrick Ewing*,C,38,SEA,79,2107,294,684,0,2,294,682,172,251,760
2001,Jamie Feick,C,26,NJN,6,149,8,23,0,0,8,23,6,12,22
2001,Danny Ferry,SF,34,SAS,80,1688,178,375,70,156,108,219,22,30,448
2001,Michael Finley,SF,27,DAL,82,3443,711,1552,91,263,620,1289,252,325,1765
2001,Derek Fisher,PG,26,LAL,20,709,77,187,25,63,52,124,50,62,229
2001,Marcus Fizer,PF,22,CHI,72,1580,278,646,10,39,268,607,117,161,683
2001,Danny Fortson,PF,24,GSW,6,203,29,50,0,0,29,50,42,54,100
2001,Greg Foster,C,32,LAL,62,451,56,133,3,9,53,124,10,14,125
2001,Jeff Foster,C,24,IND,71,1152,100,213,2,7,98,206,47,91,249
2001,Rick Fox,SF,31,LAL,82,2291,287,646,118,300,169,346,95,122,787
2001,Adonal Foyle,C,25,GSW,58,1457,156,375,0,0,156,375,30,68,342
2001,Steve Francis,PG,23,HOU,80,3194,550,1219,133,336,417,883,358,438,1591
2001,Todd Fuller,C,26,MIA,10,77,10,35,0,0,10,35,8,8,28
2001,Lawrence Funderburke,PF,30,SAC,59,698,120,242,0,0,120,242,48,77,288
2001,Ruben Garces,PF,27,TOT,13,73,7,22,0,0,7,22,2,8,16
2001,Ruben Garces,PF,27,PHO,10,62,7,15,0,0,7,15,2,8,16
2001,Ruben Garces,PF,27,GSW,3,11,0,7,0,0,0,7,0,0,0
2001,Chris Garner,PG,25,GSW,8,149,7,37,0,7,7,30,5,6,19
2001,Kevin Garnett,PF,24,MIN,81,3202,704,1475,19,66,685,1409,357,467,1784
2001,Dean Garrett,C,34,MIN,70,831,75,156,0,0,75,156,27,39,177
2001,Pat Garrity,SF,24,ORL,76,1579,223,576,97,224,126,352,85,98,628
2001,Chris Gatling,PF,33,CLE,74,1670,329,733,28,92,301,641,156,228,842
2001,Matt Geiger,C,31,PHI,35,542,88,224,0,2,88,222,37,54,213
2001,Devean George,SF,23,LAL,59,593,64,207,15,68,49,139,39,55,182
2001,Eddie Gill,PG,22,NJN,8,152,16,41,3,9,13,32,4,5,39
2001,Kendall Gill,SG,32,NJN,31,892,107,323,4,14,103,309,65,90,283
2001,Dion Glover,SG,22,ATL,57,929,141,336,9,46,132,290,47,69,338
2001,Anthony Goldwire,PG,29,DEN,20,201,30,80,9,34,21,46,13,17,82
2001,Steve Goodrich,PF,24,CHI,12,133,7,18,1,3,6,15,4,7,19
2001,Brian Grant,C,28,MIA,82,2771,484,1010,0,1,484,1009,282,354,1250
2001,Gary Grant,PG,35,POR,4,17,5,7,0,0,5,7,0,0,10
2001,Horace Grant,PF,35,LAL,77,2390,263,569,0,3,263,566,131,169,657
2001,A.C. Green,PF,37,MIA,82,1411,144,324,0,6,144,318,79,111,367
2001,Adrian Griffin,SF,26,BOS,44,377,33,97,9,26,24,71,18,24,93
2001,Tom Gugliotta,PF,31,PHO,57,1159,149,380,3,12,146,368,61,77,362
2001,A.J. Guyton,PG,22,CHI,33,630,78,192,27,69,51,123,15,18,198
2001,Darvin Ham,SF,27,MIL,29,540,39,80,2,3,37,77,29,49,109
2001,Richard Hamilton,SF,22,WAS,78,2519,547,1249,40,146,507,1103,277,319,1411
2001,Zendon Hamilton,C,25,LAC,3,19,2,9,0,0,2,9,5,8,9
2001,Tom Hammonds,PF,33,MIN,7,30,3,10,0,0,3,10,1,2,7
2001,Anfernee Hardaway,SG,29,PHO,4,112,15,36,2,8,13,28,7,11,39
2001,Tim Hardaway,PG,34,MIA,77,2613,408,1042,189,517,219,525,145,181,1150
2001,Ron Harper,PG,37,LAL,47,1139,127,271,19,72,108,199,34,48,307
2001,Matt Harpring,SG,24,CLE,56,1615,238,524,13,52,225,472,134,165,623
2001,Al Harrington,PF,20,IND,78,1892,241,543,1,7,240,536,103,157,586
2001,Othella Harrington,C,27,TOT,74,1815,247,507,0,3,247,504,171,224,665
2001,Othella Harrington,C,27,VAN,44,1267,180,386,0,3,180,383,120,154,480
2001,Othella Harrington,C,27,NYK,30,548,67,121,0,0,67,121,51,70,185
2001,Lucious Harris,SG,30,NJN,73,2071,265,624,46,132,219,492,107,139,683
2001,Jason Hart,PG,22,MIL,1,10,1,1,0,0,1,1,0,0,2
2001,Antonio Harvey,PF,30,POR,12,72,13,28,0,0,13,28,5,6,31
2001,Donnell Harvey,PF,20,DAL,18,65,8,14,0,0,8,14,6,16,22
2001,Hersey Hawkins,SG,34,CHH,59,681,56,137,17,46,39,91,54,63,183
2001,Michael Hawkins,PG,28,CLE,10,76,3,9,2,4,1,5,0,0,8
2001,Alan Henderson,PF,28,ATL,73,1810,298,671,0,1,298,670,173,271,769
2001,Cedric Henderson,SF,25,CLE,55,961,102,262,1,8,101,254,30,46,235
2001,Chris Herren,PG,25,BOS,25,408,29,96,16,55,13,41,9,12,83
2001,Grant Hill,SF,28,ORL,4,133,19,43,1,1,18,42,16,26,55
2001,Tyrone Hill,PF,32,PHI,76,2363,278,587,0,1,278,586,172,273,728
2001,Fred Hoiberg,SG,28,CHI,74,2247,217,495,103,250,114,245,136,157,673
2001,Robert Horry,PF,30,LAL,79,1587,147,380,54,156,93,224,59,83,407
2001,Eddie House,PG,22,MIA,50,550,104,247,19,55,85,192,24,35,251
2001,Allan Houston,SG,29,NYK,78,2858,542,1208,96,252,446,956,279,307,1459
2001,Juwan Howard,PF,27,TOT,81,2974,583,1218,0,3,583,1215,296,383,1462
2001,Juwan Howard,PF,27,WAS,54,1981,392,827,0,0,392,827,197,256,981
2001,Juwan Howard,PF,27,DAL,27,993,191,391,0,3,191,388,99,127,481
2001,Troy Hudson,PG,24,ORL,75,1008,125,372,22,109,103,263,85,104,357
2001,Larry Hughes,SG,22,GSW,50,1846,308,805,14,75,294,730,193,252,823
2001,Lindsey Hunter,PG,30,MIL,82,2002,298,783,152,407,146,376,77,96,825
2001,Zydrunas Ilgauskas,C,25,CLE,24,616,114,234,0,2,114,232,53,78,281
2001,Allen Iverson*,SG,25,PHI,71,2979,762,1813,98,306,664,1507,585,719,2207
2001,Bobby Jackson,PG,27,SAC,79,1648,231,526,39,104,192,422,65,88,566
2001,Jaren Jackson,SG,33,SAS,16,114,16,40,7,18,9,22,0,2,39
2001,Jim Jackson,SF,30,TOT,56,1690,239,632,26,80,213,552,139,169,643
2001,Jim Jackson,SF,30,ATL,17,550,77,217,16,38,61,179,73,85,243
2001,Jim Jackson,SF,30,CLE,39,1140,162,415,10,42,152,373,66,84,400
2001,Marc Jackson,C,26,GSW,48,1410,237,508,5,23,232,485,154,192,633
2001,Mark Jackson,PG,35,TOT,83,2588,244,583,70,207,174,376,73,93,631
2001,Mark Jackson,PG,35,TOR,54,1802,170,403,57,165,113,238,64,76,461
2001,Mark Jackson,PG,35,NYK,29,786,74,180,13,42,61,138,9,17,170
2001,Stephen Jackson,SF,22,NJN,77,1660,243,572,52,155,191,417,97,135,635
2001,Sam Jacobson,PG,25,MIN,14,59,9,18,0,0,9,18,2,3,20
2001,Tim James,SF,24,CHH,30,197,16,52,1,3,15,49,12,14,45
2001,Antawn Jamison,SF,24,GSW,82,3394,800,1812,62,205,738,1607,382,534,2044
2001,Anthony Johnson,PG,26,TOT,53,511,53,152,1,5,52,147,23,33,130
2001,Anthony Johnson,PG,26,ATL,25,279,26,71,0,3,26,68,12,17,64
2001,Anthony Johnson,PG,26,CLE,28,232,27,81,1,2,26,79,11,16,66
2001,Avery Johnson,PG,35,SAS,55,1290,134,300,1,6,133,294,41,60,310
2001,DerMarr Johnson,SF,20,ATL,78,1313,146,390,41,127,105,263,64,87,397
2001,Ervin Johnson,C,33,MIL,82,1981,108,198,0,0,108,198,50,93,266
2001,Larry Johnson,PF,31,NYK,65,2105,246,598,51,163,195,435,102,128,645
2001,Damon Jones,PG,24,VAN,71,1415,170,416,84,231,86,185,37,52,461
2001,Eddie Jones,SG,29,MIA,63,2282,388,871,90,238,298,633,228,270,1094
2001,Jumaine Jones,SF,21,PHI,65,866,122,275,20,60,102,215,40,53,304
2001,Popeye Jones,PF,30,WAS,45,638,60,153,1,6,59,147,41,55,162
2001,Garth Joseph,C,27,TOT,4,16,1,5,0,0,1,5,0,2,2
2001,Garth Joseph,C,27,TOR,2,8,1,2,0,0,1,2,0,0,2
2001,Garth Joseph,C,27,DEN,2,8,0,3,0,0,0,3,0,2,0
2001,Adam Keefe,PF,30,GSW,67,836,64,159,1,3,63,156,39,63,168
2001,Shawn Kemp,PF,31,POR,68,1083,168,413,4,11,164,402,101,131,441
2001,Steve Kerr,PG,35,SAS,55,650,67,159,33,77,34,82,14,15,181
2001,Jerome Kersey,SF,38,MIL,22,243,32,69,0,1,32,68,8,16,72
2001,Lari Ketner,PF,23,IND,3,7,0,0,0,0,0,0,0,0,0
2001,Jason Kidd,PG,27,PHO,77,3065,451,1097,69,232,382,865,328,403,1299
2001,Gerard King,SF,28,WAS,45,706,90,176,0,0,90,176,36,45,216
2001,Brevin Knight,PG,25,TOT,53,1457,139,371,1,10,138,361,54,66,333
2001,Brevin Knight,PG,25,CLE,6,93,2,15,0,0,2,15,5,6,9
2001,Brevin Knight,PG,25,ATL,47,1364,137,356,1,10,136,346,49,60,324
2001,Travis Knight,C,26,NYK,45,256,10,53,0,1,10,52,9,18,29
2001,Toni Kukoc,SF,32,TOT,65,1597,275,582,70,157,205,425,101,160,721
2001,Toni Kukoc,SF,32,PHI,48,979,151,330,32,78,119,252,52,88,386
2001,Toni Kukoc,SF,32,ATL,17,618,124,252,38,79,86,173,49,72,335
2001,Christian Laettner,C-PF,31,TOT,78,1663,277,551,4,13,273,538,170,204,728
2001,Christian Laettner,C,31,DAL,53,930,165,323,1,3,164,320,67,82,398
2001,Christian Laettner,PF,31,WAS,25,733,112,228,3,10,109,218,103,122,330
2001,Raef LaFrentz,C,24,DEN,78,2457,387,812,51,139,336,673,183,262,1008
2001,Trajan Langdon,SG,24,CLE,65,1116,135,313,51,124,84,189,68,76,389
2001,Dan Langhi,SF,23,HOU,33,241,37,99,0,1,37,98,16,29,90
2001,Voshon Lenard,SG,27,DEN,80,2331,336,846,147,382,189,464,153,192,972
2001,Quincy Lewis,SF,23,UTA,35,402,50,123,9,25,41,98,15,21,124
2001,Rashard Lewis,PF,21,SEA,78,2720,426,887,123,285,303,602,176,213,1151
2001,Randy Livingston,PG,25,GSW,2,7,0,2,0,1,0,1,0,0,0
2001,Art Long,SF,28,SAC,9,20,0,4,0,0,0,4,0,2,0
2001,Grant Long,PF,34,VAN,66,1507,140,319,4,15,136,304,112,157,396
2001,Luc Longley,C,32,NYK,25,301,18,54,0,0,18,54,13,17,49
2001,Felipe Lopez,SG-PG,26,TOT,70,1565,211,478,19,52,192,426,109,156,550
2001,Felipe Lopez,SG,26,WAS,47,1108,142,326,6,29,136,297,90,123,380
2001,Felipe Lopez,PG,26,MIN,23,457,69,152,13,23,56,129,19,33,170
2001,Tyronn Lue,PG,23,LAL,38,468,50,117,11,34,39,83,19,24,130
2001,George Lynch,SF,30,PHI,82,2649,274,616,15,57,259,559,123,171,686
2001,Todd MacCulloch,C,25,PHI,63,597,109,185,0,0,109,185,42,66,260
2001,Don MacLean,SF,31,MIA,8,76,10,20,2,2,8,18,9,12,31
2001,Mark Madsen,PF,25,LAL,70,641,55,113,1,1,54,112,26,37,137
2001,Corey Maggette,SF,21,LAC,69,1359,225,487,17,56,208,431,223,288,690
2001,Jamaal Magloire,C,22,CHH,74,1095,122,271,0,2,122,269,95,145,339
2001,Dan Majerle,SG,35,MIA,53,1306,87,259,57,181,30,78,36,44,267
2001,Karl Malone*,PF,37,UTA,81,2895,670,1345,2,5,668,1340,536,676,1878
2001,Matt Maloney,PG,29,ATL,55,1403,146,348,51,142,95,206,26,34,369
2001,Danny Manning,PF,34,UTA,82,1305,247,500,7,28,240,472,102,140,603
2001,Stephon Marbury,PG,23,NJN,67,2557,563,1277,110,335,453,942,362,458,1598
2001,Shawn Marion,SF,22,PHO,79,2857,557,1160,21,82,536,1078,234,289,1369
2001,Donyell Marshall,SF,27,UTA,81,2326,427,849,41,128,386,721,205,273,1100
2001,Darrick Martin,PG,29,SAC,31,176,29,76,14,27,15,49,31,35,103
2001,Kenyon Martin,PF,23,NJN,68,2272,346,777,1,11,345,766,121,192,814
2001,Jamal Mashburn,SF,28,CHH,76,2989,573,1388,103,289,470,1099,279,364,1528
2001,Anthony Mason,PF,34,MIA,80,3254,460,954,0,0,460,954,370,474,1290
2001,Desmond Mason,SF,23,SEA,78,1522,189,439,18,67,171,372,67,91,463
2001,Tony Massenburg,PF,33,VAN,52,823,92,199,0,0,92,199,49,70,233
2001,Vernon Maxwell,PG,35,TOT,43,660,73,223,34,111,39,112,21,32,201
2001,Vernon Maxwell,PG,35,PHI,24,375,42,125,21,64,21,61,15,22,120
2001,Vernon Maxwell,PG,35,DAL,19,285,31,98,13,47,18,51,6,10,81
2001,Walter McCarty,PF,26,BOS,60,478,45,126,19,56,26,70,22,28,131
2001,Dan McClintock,C,23,DEN,6,58,9,18,0,0,9,18,0,5,18
2001,George McCloud,SF,33,DEN,76,2007,250,655,77,234,173,421,152,181,729
2001,Jelani McCoy,C,23,SEA,70,1143,138,264,0,0,138,264,41,93,317
2001,Antonio McDyess,PF,26,DEN,70,2555,577,1165,0,0,577,1165,304,434,1458
2001,Tracy McGrady,SG,21,ORL,77,3087,788,1724,59,166,729,1558,430,587,2065
2001,Jim McIlvaine,C,28,NJN,18,193,10,28,0,0,10,28,8,12,28
2001,Jeff McInnis,PG,26,LAC,81,2831,432,933,52,144,380,789,130,161,1046
2001,Derrick McKey,SF,34,IND,66,987,60,136,4,20,56,116,21,27,145
2001,Aaron McKie,SG,28,PHI,76,2394,338,714,53,170,285,544,149,194,878
2001,Roshown McLeod,SF,25,TOT,35,922,145,332,2,22,143,310,45,51,337
2001,Roshown McLeod,SF,25,ATL,34,907,144,330,2,21,142,309,45,51,335
2001,Roshown McLeod,SF,25,PHI,1,15,1,2,0,1,1,1,0,0,2
2001,Paul McPherson,PG,22,TOT,55,595,109,216,2,12,107,204,42,58,262
2001,Paul McPherson,PG,22,PHO,33,308,47,96,0,6,47,90,18,24,112
2001,Paul McPherson,PG,22,GSW,22,287,62,120,2,6,60,114,24,34,150
2001,Stanislav Medvedenko,PF,21,LAL,7,39,12,25,1,1,11,24,7,12,32
2001,Ron Mercer,SG,24,CHI,61,2535,500,1121,14,46,486,1075,188,228,1202
2001,Chris Mihm,C,21,CLE,59,1166,173,391,0,1,173,390,100,126,446
2001,Darius Miles,SF,19,LAC,81,2133,318,630,1,19,317,611,124,238,761
2001,Andre Miller,PG,24,CLE,82,2848,452,999,17,64,435,935,375,450,1296
2001,Anthony Miller,PF,29,TOT,4,11,1,2,0,0,1,2,0,0,2
2001,Anthony Miller,PF,29,ATL,2,6,1,2,0,0,1,2,0,0,2
2001,Anthony Miller,PF,29,HOU,1,3,0,0,0,0,0,0,0,0,0
2001,Anthony Miller,PF,29,PHI,1,2,0,0,0,0,0,0,0,0,0
2001,Brad Miller,C,24,CHI,57,1434,168,386,1,5,167,381,168,226,505
2001,Mike Miller,SF,20,ORL,82,2390,368,845,148,364,220,481,91,128,975
2001,Reggie Miller*,SG,35,IND,81,3181,517,1176,170,464,347,712,323,348,1527
2001,Chris Mills,SF,31,GSW,15,493,71,191,7,25,64,166,31,36,180
2001,Terry Mills,PF,33,IND,14,113,11,34,3,17,8,17,0,0,25
2001,Sam Mitchell,SF,37,MIN,82,983,118,289,9,43,109,246,40,55,285
2001,Cuttino Mobley,SG,25,HOU,79,3002,527,1214,90,252,437,962,394,474,1538
2001,Nazr Mohammed,C,23,TOT,58,912,176,369,0,1,176,368,89,126,441
2001,Nazr Mohammed,C,23,PHI,30,196,41,88,0,0,41,88,14,28,96
2001,Nazr Mohammed,C,23,ATL,28,716,135,281,0,1,135,280,75,98,345
2001,Jerome Moiso,C,22,BOS,24,135,12,30,0,1,12,29,11,26,35
2001,Eric Montross,C,29,TOT,54,649,56,138,0,0,56,138,8,31,120
2001,Eric Montross,C,29,DET,42,568,50,121,0,0,50,121,7,26,107
2001,Eric Montross,C,29,TOR,12,81,6,17,0,0,6,17,1,5,13
2001,Mikki Moore,C,25,DET,81,1154,132,268,0,1,132,267,95,130,359
2001,Hanno Mottola,SF,24,ATL,73,989,123,277,0,3,123,274,73,90,319
2001,Alonzo Mourning*,C,30,MIA,13,306,73,141,0,1,73,140,31,55,177
2001,Chris Mullin*,SF,37,GSW,20,374,36,106,19,52,17,54,24,28,115
2001,Lamond Murray,SF,27,CLE,78,2225,391,925,61,165,330,760,155,211,998
2001,Tracy Murray,SF,29,TOT,51,588,94,248,36,103,58,145,33,42,257
2001,Tracy Murray,SF,29,DEN,13,135,17,55,7,23,10,32,9,10,50
2001,Tracy Murray,SF,29,TOR,38,453,77,193,29,80,48,113,24,32,207
2001,Dikembe Mutombo*,C,34,TOT,75,2591,269,556,0,0,269,556,211,291,749
2001,Dikembe Mutombo*,C,34,ATL,49,1716,169,354,0,0,169,354,107,154,445
2001,Dikembe Mutombo*,C,34,PHI,26,875,100,202,0,0,100,202,104,137,304
2001,Mamadou N'Diaye,C,25,TOR,3,10,1,4,0,0,1,4,2,2,4
2001,Lee Nailon,SF,25,CHH,42,469,66,136,0,1,66,135,32,43,164
2001,Eduardo Najera,PF,24,DAL,40,431,58,111,1,3,57,108,14,33,131
2001,Steve Nash,PG,26,DAL,70,2387,386,792,89,219,297,573,231,258,1092
2001,Tyrone Nesby,SF-SG,25,TOT,62,1556,189,530,49,180,140,350,85,106,512
2001,Tyrone Nesby,SG,25,LAC,14,333,40,123,10,46,30,77,18,23,108
2001,Tyrone Nesby,SF,25,WAS,48,1223,149,407,39,134,110,273,67,83,404
2001,Rasho Nesterovic,C,24,MIN,73,1233,147,319,0,1,147,318,34,65,328
2001,Ira Newble,SF,26,SAS,27,184,21,55,4,9,17,46,8,16,54
2001,Johnny Newman,SG,37,NJN,82,2049,291,695,59,176,232,519,254,297,895
2001,Moochie Norris,PG,27,HOU,82,1654,184,413,25,89,159,324,151,194,544
2001,Dirk Nowitzki,PF,22,DAL,82,3125,591,1247,151,390,440,857,451,538,1784
2001,Jermaine O'Neal,C,22,IND,81,2641,404,868,0,5,404,863,233,388,1041
2001,Shaquille O'Neal*,C,28,LAL,74,2924,813,1422,0,2,813,1420,499,972,2125
2001,Charles Oakley,PF,37,TOR,78,2767,305,786,11,49,294,737,127,152,748
2001,Lamar Odom,PF,21,LAC,76,2836,481,1046,80,253,401,793,262,386,1304
2001,Hakeem Olajuwon*,C,38,HOU,58,1545,283,568,0,1,283,567,123,198,689
2001,Kevin Ollie,PG,28,TOT,70,925,76,192,1,3,75,189,63,89,216
2001,Kevin Ollie,PG,28,NJN,19,161,5,27,0,0,5,27,12,19,22
2001,Kevin Ollie,PG,28,PHI,51,764,71,165,1,3,70,162,51,70,194
2001,Michael Olowokandi,C,25,LAC,82,2127,308,708,0,0,308,708,85,156,701
2001,Greg Ostertag,C,27,UTA,81,1491,139,281,1,2,138,279,84,151,363
2001,Bo Outlaw,PF,29,ORL,80,2534,226,368,1,2,225,366,129,225,582
2001,Doug Overton,PG,31,TOT,21,475,52,139,11,36,41,103,10,16,125
2001,Doug Overton,PG,31,BOS,7,144,15,44,1,4,14,40,7,11,38
2001,Doug Overton,PG,31,CHH,2,15,2,2,0,0,2,2,0,0,4
2001,Doug Overton,PG,31,NJN,12,316,35,93,10,32,25,61,3,5,83
2001,Billy Owens,PF,31,DET,45,793,88,230,3,20,85,210,19,40,198
2001,Olumide Oyedeji,C,19,SEA,30,221,18,37,0,0,18,37,9,12,45
2001,Robert Pack,PG,31,DEN,74,1260,181,426,12,31,169,395,105,137,479
2001,Scott Padgett,PF,24,UTA,27,127,18,43,5,9,13,34,15,20,56
2001,Milt Palacio,PG,22,BOS,58,1141,126,267,12,36,114,231,78,92,342
2001,Andy Panko,SF,23,ATL,1,1,0,0,0,0,0,0,0,0,0
2001,Cherokee Parks,C,28,TOT,65,1054,134,274,0,6,134,268,31,44,299
2001,Cherokee Parks,C,28,WAS,13,178,18,38,0,0,18,38,12,17,48
2001,Cherokee Parks,C,28,LAC,52,876,116,236,0,6,116,230,19,27,251
2001,Ruben Patterson,SF,25,SEA,76,2059,370,749,2,36,368,713,246,361,988
2001,Gary Payton*,PG,32,SEA,79,3244,725,1591,102,272,623,1319,271,354,1823
2001,Anthony Peeler,SG,31,MIN,75,2126,308,732,100,256,208,476,75,87,791
2001,Mike Penberthy,PG,26,LAL,53,851,92,222,55,139,37,83,28,31,267
2001,Will Perdue,C,35,POR,13,58,6,9,0,0,6,9,2,4,14
2001,Sam Perkins,PF,39,IND,64,999,86,226,38,110,48,116,32,38,242
2001,Elliot Perry,PG,31,TOT,49,499,65,140,1,5,64,135,16,22,147
2001,Elliot Perry,PG,31,ORL,6,39,5,11,0,1,5,10,0,0,10
2001,Elliot Perry,PG,31,PHO,43,460,60,129,1,4,59,125,16,22,137
2001,Wesley Person,SG,29,CLE,44,958,128,292,34,84,94,208,24,30,314
2001,Morris Peterson,SG,23,TOR,80,1809,290,673,63,165,227,508,104,145,747
2001,Eric Piatkowski,SG,30,LAC,81,2144,291,672,120,297,171,375,158,181,860
2001,Paul Pierce,SF,23,BOS,82,3120,687,1513,147,384,540,1129,550,738,2071
2001,Scottie Pippen*,SF,35,POR,64,2133,269,596,64,186,205,410,119,161,721
2001,Scot Pollard,C,25,SAC,77,1658,185,395,0,2,185,393,128,171,498
2001,Olden Polynice,C,36,UTA,81,1619,206,415,0,1,206,414,17,65,429
2001,Mark Pope,PF,28,MIL,63,942,62,142,5,24,57,118,22,35,151
2001,Chris Porter,SF,22,GSW,51,1147,173,445,0,5,173,440,94,141,440
2001,Terry Porter,PG,37,SAS,80,1678,197,440,87,205,110,235,92,116,573
2001,James Posey,SF,24,DEN,82,2255,243,590,65,217,178,373,115,141,666
2001,Lavor Postell,SG,22,NYK,26,169,17,54,3,11,14,43,22,27,59
2001,Vitaly Potapenko,C,25,BOS,82,1901,248,521,0,0,248,521,115,158,611
2001,Brent Price,PG,32,VAN,6,30,3,11,1,4,2,7,6,7,13
2001,Laron Profit,PG,23,WAS,35,605,56,142,7,26,49,116,33,45,152
2001,Joel Przybilla,C,21,MIL,33,270,12,35,0,0,12,35,3,11,27
2001,Theo Ratliff,C,27,PHI,50,1800,228,457,0,0,228,457,165,217,621
2001,Eldridge Recasner,PG,33,CHH,43,403,38,114,13,39,25,75,14,18,103
2001,Michael Redd,SG,21,MIL,6,35,5,19,0,3,5,16,3,6,13
2001,Bryant Reeves,C,27,VAN,75,1832,254,552,1,4,253,548,113,142,622
2001,Don Reid,PF,27,ORL,65,764,82,145,0,0,82,145,46,75,210
2001,J.R. Reid,PF,32,CLE,6,39,2,5,0,0,2,5,6,8,10
2001,Glen Rice,SF,33,NYK,75,2212,331,752,82,211,249,541,155,182,899
2001,Quentin Richardson,SG,20,LAC,76,1358,232,525,50,151,182,374,99,158,613
2001,Mitch Richmond*,SG,35,WAS,37,1216,205,504,45,133,160,371,143,160,598
2001,Isaiah Rider,SG,29,LAL,67,1206,201,472,34,92,167,380,71,83,507
2001,Terrance Roberson,SF,24,CHH,3,13,0,2,0,1,0,1,0,0,0
2001,Clifford Robinson,PF,34,PHO,82,2751,501,1186,90,249,411,937,253,357,1345
2001,David Robinson*,C,35,SAS,80,2371,400,823,0,1,400,822,351,470,1151
2001,Eddie Robinson,SF,24,CHH,67,1201,216,407,2,4,214,403,64,88,498
2001,Glenn Robinson,SF,28,MIL,76,2813,684,1460,55,184,629,1276,251,306,1674
2001,Jamal Robinson,SF,27,MIA,6,72,3,22,0,2,3,20,0,0,6
2001,James Robinson,PG,30,ORL,6,50,4,11,2,5,2,6,0,0,10
2001,Larry Robinson,PG-SG,33,TOT,34,632,67,184,44,116,23,68,21,24,199
2001,Larry Robinson,SG,33,CLE,1,1,0,0,0,0,0,0,0,0,0
2001,Larry Robinson,PG,33,ATL,33,631,67,184,44,116,23,68,21,24,199
2001,Carlos Rogers,C,29,HOU,39,544,75,110,0,1,75,109,29,52,179
2001,Rodney Rogers,SF,29,PHO,82,2183,377,876,56,189,321,687,188,247,998
2001,Sean Rooks,C,31,LAC,82,1553,169,395,1,2,168,393,107,143,446
2001,Jalen Rose,SF,28,IND,72,2943,567,1242,59,174,508,1068,285,344,1478
2001,Malik Rose,PF,26,SAS,57,1219,160,368,3,17,157,351,114,160,437
2001,Michael Ruffin,PF,24,CHI,45,879,40,90,0,0,40,90,39,77,119
2001,Bryon Russell,SF,30,UTA,78,2473,308,700,95,230,213,470,222,285,933
2001,Arvydas Sabonis*,C,36,POR,61,1299,247,516,1,15,246,501,121,156,616
2001,Soumaila Samake,C,22,NJN,34,226,18,48,0,0,18,48,10,24,46
2001,Pepe Sanchez,PG,23,TOT,29,150,9,28,0,1,9,27,2,2,20
2001,Pepe Sanchez,PG,23,ATL,5,34,0,7,0,0,0,7,0,0,0
2001,Pepe Sanchez,PG,23,PHI,24,116,9,21,0,1,9,20,2,2,20
2001,Daniel Santiago,C,24,PHO,54,581,64,134,0,0,64,134,42,61,170
2001,Detlef Schrempf,SF,38,POR,26,397,39,95,3,8,36,87,23,27,104
2001,Shawnelle Scott,C,28,SAS,27,144,17,41,0,0,17,41,9,22,43
2001,Brian Shaw,SG,34,LAL,80,1833,164,411,42,135,122,276,51,64,421
2001,Brian Skinner,PF,24,LAC,39,584,64,161,0,0,64,161,32,59,160
2001,Reggie Slater,PF,30,MIN,55,686,90,175,0,0,90,175,74,110,254
2001,Jabari Smith,C,23,SAC,9,66,11,22,0,0,11,22,4,6,26
2001,Joe Smith,PF,25,DET,69,1941,308,765,0,5,308,760,231,287,847
2001,Michael Smith,PF,28,WAS,79,1610,106,218,0,1,106,217,89,154,301
2001,Mike Smith,SF,24,WAS,17,180,19,59,3,18,16,41,10,16,51
2001,Steve Smith,SG,31,POR,81,2542,359,788,78,230,281,558,309,347,1105
2001,Tony Smith,SG,32,ATL,6,78,8,23,0,2,8,21,1,2,17
2001,Eric Snow,PG,27,PHI,50,1740,182,435,5,19,177,416,122,154,491
2001,Felton Spencer,C,33,NYK,18,113,12,20,0,0,12,20,15,25,39
2001,Latrell Sprewell,SF,30,NYK,77,3017,524,1219,41,135,483,1084,275,351,1364
2001,Jerry Stackhouse,SG,26,DET,80,3215,774,1927,166,473,608,1454,666,810,2380
2001,John Starks,SG,35,UTA,75,2122,273,686,64,182,209,504,89,111,699
2001,Vladimir Stepania,C,24,NJN,29,280,28,88,1,4,27,84,25,34,82
2001,DeShawn Stevenson,SG,19,UTA,40,293,31,91,1,12,30,79,26,38,89
2001,Michael Stewart,C,25,TOR,26,123,11,34,0,0,11,34,11,18,33
2001,Bryant Stith,SG,30,BOS,78,2504,245,611,91,242,154,369,175,207,756
2001,John Stockton*,PG,38,UTA,82,2397,328,651,61,132,267,519,227,278,944
2001,Peja Stojakovic,SF,23,SAC,75,2905,559,1189,144,360,415,829,267,312,1529
2001,Damon Stoudamire,PG,27,POR,82,2655,406,935,82,219,324,716,172,207,1066
2001,Erick Strickland,PG,27,TOT,50,830,81,267,30,95,51,172,68,79,260
2001,Erick Strickland,PG,27,NYK,28,421,40,131,16,47,24,84,24,28,120
2001,Erick Strickland,PG,27,VAN,22,409,41,136,14,48,27,88,44,51,140
2001,Mark Strickland,SF,30,TOT,55,719,103,239,1,2,102,237,45,70,252
2001,Mark Strickland,SF,30,DEN,46,517,82,185,0,1,82,184,37,59,201
2001,Mark Strickland,SF,30,NJN,9,202,21,54,1,1,20,53,8,11,51
2001,Rod Strickland,PG,34,TOT,54,1371,182,429,4,17,178,412,130,173,498
2001,Rod Strickland,PG,34,WAS,33,1020,141,331,4,16,137,315,115,147,401
2001,Rod Strickland,PG,34,POR,21,351,41,98,0,1,41,97,15,26,97
2001,Derek Strong,PF,32,LAC,28,491,45,117,0,1,45,116,28,37,118
2001,Bruno Sundov,C,20,IND,11,120,20,41,0,4,20,37,3,5,43
2001,Bob Sura,SG,27,GSW,53,1684,202,518,47,172,155,346,135,189,586
2001,Stromile Swift,PF,21,VAN,80,1312,153,339,0,4,153,335,85,141,391
2001,Wally Szczerbiak,SF,23,MIN,82,2856,469,920,26,77,443,843,181,208,1145
2001,Zan Tabak,C,30,IND,55,777,98,186,0,0,98,186,20,47,216
2001,Dragan Tarlac,C,27,CHI,43,598,39,99,0,0,39,99,25,33,103
2001,Maurice Taylor,SF,24,HOU,69,1972,390,797,0,4,390,793,119,162,899
2001,Jason Terry,SG,23,ATL,82,3089,596,1367,124,314,472,1053,303,358,1619
2001,Jamel Thomas,SF,27,NJN,5,56,6,19,1,3,5,16,0,0,13
2001,Kenny Thomas,PF,23,HOU,74,1820,206,465,25,92,181,373,91,126,528
2001,Kurt Thomas,PF,28,NYK,77,2125,314,614,1,3,313,611,171,210,800
2001,Tim Thomas,PF,23,MIL,76,2086,326,758,107,260,219,498,195,253,954
2001,Otis Thorpe,PF,38,CHH,49,647,59,131,0,0,59,131,20,24,138
2001,Robert Traylor,C,23,CLE,70,1212,161,324,0,2,161,322,80,141,402
2001,Gary Trent,PF,26,DAL,33,319,57,130,0,1,57,129,19,36,133
2001,Jake Tsakalidis,C,21,PHO,57,947,101,215,0,0,101,215,54,91,256
2001,Hedo Turkoglu,SF,21,SAC,74,1245,138,335,28,86,110,249,87,112,391
2001,Nick Van,PG,29,DEN,71,2688,460,1112,135,358,325,754,204,249,1259
2001,Keith Van,SF,25,NJN,49,1733,308,708,65,170,243,538,150,186,831
2001,David Vanterpool,PG,27,WAS,22,411,46,110,0,6,46,104,30,50,122
2001,Jacque Vaughn,PG,25,UTA,82,1620,170,393,30,78,140,315,128,164,498
2001,Loy Vaught,PF,32,TOT,51,549,80,169,0,0,80,169,8,10,168
2001,Loy Vaught,PF,32,DAL,37,392,55,121,0,0,55,121,4,6,114
2001,Loy Vaught,PF,32,WAS,14,157,25,48,0,0,25,48,4,4,54
2001,Jake Voskuhl,C,23,CHI,16,143,11,25,0,0,11,25,8,14,30
2001,Antoine Walker,PF,24,BOS,81,3396,711,1720,221,603,490,1117,249,348,1892
2001,Samaki Walker,PF,24,SAS,61,963,121,252,1,3,120,249,78,124,321
2001,Ben Wallace,C,26,DET,80,2760,215,439,1,4,214,435,80,238,511
2001,John Wallace,SF,26,DET,40,527,100,236,2,15,98,221,35,45,237
2001,Rasheed Wallace,PF,26,POR,77,2940,590,1178,52,162,538,1016,245,320,1477
2001,Charlie Ward,PG,30,NYK,61,1492,155,373,67,175,88,198,56,70,433
2001,Clarence Weatherspoon,PF,30,CLE,82,2774,347,692,0,0,347,692,230,291,924
2001,Chris Webber,PF,27,SAC,70,2836,786,1635,2,28,784,1607,324,461,1898
2001,Bonzi Wells,SF,24,POR,75,1995,387,726,17,50,370,676,159,240,950
2001,David Wesley,SG,30,CHH,82,3106,523,1239,97,258,426,981,271,339,1414
2001,Doug West,SG,33,VAN,15,171,11,38,0,2,11,36,6,7,28
2001,Jahidi White,C,24,WAS,68,1609,203,408,0,1,203,407,177,312,583
2001,Chris Whitney,PG,29,WAS,59,1532,182,470,93,248,89,222,101,113,558
2001,Aaron Williams,PF,29,NJN,82,2336,297,650,0,2,297,648,244,310,838
2001,Alvin Williams,SG,26,TOR,82,2394,330,767,33,108,297,659,109,145,802
2001,Eric Williams,SF,28,BOS,81,1745,162,448,46,139,116,309,165,231,535
2001,Jason Williams,PG,25,SAC,77,2290,281,690,98,311,183,379,60,76,720
2001,Jerome Williams,PF,27,TOT,59,1182,136,294,0,3,136,291,100,135,372
2001,Jerome Williams,PF,27,DET,33,804,88,201,0,2,88,199,65,90,241
2001,Jerome Williams,PF,27,TOR,26,378,48,93,0,1,48,92,35,45,131
2001,Monty Williams,SF,29,ORL,82,1211,162,364,1,13,161,351,85,133,410
2001,Scott Williams,C,32,MIL,66,1272,171,361,1,4,170,357,60,70,403
2001,Shammond Williams,PG,25,SEA,69,1238,161,368,61,133,100,235,84,96,467
2001,Walt Williams,SF,30,HOU,72,1583,202,513,98,248,104,265,97,126,599
2001,Corliss Williamson,SF,27,TOT,69,1686,325,647,0,2,325,645,151,237,801
2001,Corliss Williamson,SF,27,TOR,42,886,153,325,0,2,153,323,84,130,390
2001,Corliss Williamson,SF,27,DET,27,800,172,322,0,0,172,322,67,107,411
2001,Kevin Willis,C,38,TOT,78,1830,304,690,1,6,303,684,113,147,722
2001,Kevin Willis,C,38,TOR,35,771,124,269,0,2,124,267,61,81,309
2001,Kevin Willis,C,38,DEN,43,1059,180,421,1,4,179,417,52,66,413
2001,David Wingate,SG,37,SEA,1,9,3,3,0,0,3,3,0,0,6
2001,Ruben Wolkowyski,PF,27,SEA,34,305,25,79,0,2,25,77,25,34,75
2001,Metta World,SF,21,CHI,76,2363,327,815,43,148,284,667,210,280,907
2001,Lorenzen Wright,C,25,ATL,71,1988,363,811,0,2,363,809,155,216,881
2001,Wang Zhizhi,C,23,DAL,5,38,8,19,0,2,8,17,8,10,24
,,,,,,,,,,,,,,,
2002,Tariq Abdul-Wahad,SG,27,TOT,24,441,55,147,1,2,54,145,24,33,135
2002,Tariq Abdul-Wahad,SG,27,DEN,20,417,55,145,1,2,54,143,24,32,135
2002,Tariq Abdul-Wahad,SG,27,DAL,4,24,0,2,0,0,0,2,0,1,0
2002,Shareef Abdur-Rahim,PF,25,ATL,77,2980,598,1297,21,70,577,1227,419,523,1636
2002,Courtney Alexander,SG,24,WAS,56,1325,223,474,5,18,218,456,98,121,549
2002,Victor Alexander,C,32,DET,15,97,18,51,0,2,18,49,4,8,40
2002,Malik Allen,PF,23,MIA,12,161,22,51,0,1,22,50,8,10,52
2002,Ray Allen,SG,26,MIL,69,2525,530,1148,229,528,301,620,214,245,1503
2002,Rafer Alston,PG,25,MIL,50,600,66,191,27,71,39,120,18,29,177
2002,John Amaechi,PF,31,UTA,54,586,54,166,0,0,54,166,67,105,175
2002,Chris Andersen,C,23,DEN,24,262,25,74,0,4,25,70,22,28,72
2002,Derek Anderson,SG,27,POR,70,1860,247,612,85,228,162,384,178,208,757
2002,Kenny Anderson,PG,31,BOS,76,2430,312,716,9,33,303,683,98,132,731
2002,Nick Anderson,SG,34,MEM,15,219,21,76,13,48,8,28,5,9,60
2002,Shandon Anderson,SG,28,NYK,82,1596,149,373,39,141,110,232,74,107,411
2002,Greg Anthony,PG,34,TOT,60,1514,183,475,48,163,135,312,60,91,474
2002,Greg Anthony,PG,34,CHI,36,961,113,287,29,90,84,197,47,70,302
2002,Greg Anthony,PG,34,MIL,24,553,70,188,19,73,51,115,13,21,172
2002,Gilbert Arenas,PG,20,GSW,47,1155,174,384,39,113,135,271,124,160,511
2002,Brandon Armstrong,SG,21,NJN,35,196,27,85,5,17,22,68,5,10,64
2002,Darrell Armstrong,PG,33,ORL,82,2730,347,828,139,398,208,430,182,205,1015
2002,Carlos Arroyo,PG,22,TOT,37,371,49,111,0,2,49,109,13,18,111
2002,Carlos Arroyo,PG,22,TOR,17,96,13,29,0,0,13,29,4,6,30
2002,Carlos Arroyo,PG,22,DEN,20,275,36,82,0,2,36,80,9,12,81
2002,Chucky Atkins,PG,27,DET,79,2285,368,790,138,336,230,454,83,120,957
2002,Stacey Augmon,SG,33,CHH,77,1319,140,328,0,3,140,325,77,101,357
2002,Isaac Austin,C,32,MEM,21,307,36,92,0,3,36,89,4,4,76
2002,William Avery,PG,22,MIN,28,258,26,90,6,35,20,55,13,19,71
2002,Dalibor Bagaric,C,21,CHI,50,638,72,178,0,1,72,177,41,70,185
2002,Vin Baker,C,30,SEA,55,1710,315,649,1,8,314,641,143,226,774
2002,Erick Barkley,PG,23,POR,19,228,24,68,1,7,23,61,9,10,58
2002,Dana Barros,PG,34,DET,29,582,74,192,24,71,50,121,21,27,193
2002,Brent Barry,SG,30,SEA,81,3040,401,790,164,387,237,403,198,234,1164
2002,Jon Barry,SG,32,DET,82,1985,255,522,121,258,134,264,108,116,739
2002,Mengke Bateer,C,26,DEN,27,408,53,132,4,12,49,120,29,37,139
2002,Tony Battie,C,25,BOS,74,1819,211,390,0,2,211,388,88,130,510
2002,Shane Battier,SF,23,MEM,78,3097,412,961,103,276,309,685,198,283,1125
2002,Charlie Bell,SG,22,TOT,7,44,3,11,0,6,3,5,2,2,8
2002,Charlie Bell,SG,22,PHO,5,42,3,11,0,6,3,5,2,2,8
2002,Charlie Bell,SG,22,DAL,2,2,0,0,0,0,0,0,0,0,0
2002,Raja Bell,SG,25,PHI,74,890,103,240,12,44,91,196,36,48,254
2002,Jonathan Bender,SF,21,IND,78,1647,198,460,45,125,153,335,140,181,581
2002,Travis Best,PG,29,TOT,74,1747,228,518,21,59,207,459,104,116,581
2002,Travis Best,PG,29,IND,44,954,116,264,13,34,103,230,57,65,302
2002,Travis Best,PG,29,CHI,30,793,112,254,8,25,104,229,47,51,279
2002,Mike Bibby,PG,23,SAC,80,2659,446,985,51,138,395,847,155,193,1098
2002,Chauncey Billups,PG,25,MIN,82,2355,348,823,124,315,224,508,207,234,1027
2002,Mookie Blaylock,PG,34,GSW,35,599,50,146,15,42,35,104,4,8,119
2002,Corie Blount,PF,33,PHI,72,1426,115,251,0,1,115,250,29,45,259
2002,Mark Blount,C,26,BOS,44,415,32,76,0,0,32,76,30,37,94
2002,Calvin Booth,C,25,SEA,15,279,35,82,0,0,35,82,23,24,93
2002,Ruben Boumtje-Boumtje,C,23,POR,33,245,13,32,0,0,13,32,13,25,39
2002,Cal Bowdler,PF,24,ATL,52,585,61,174,1,5,60,169,39,47,162
2002,Bruce Bowen,SF,30,SAS,59,1699,155,398,56,148,99,250,46,96,412
2002,Ryan Bowen,SF,26,DEN,75,1686,147,307,1,12,146,295,69,92,364
2002,Ira Bowman,SG,28,PHI,3,29,5,7,0,1,5,6,0,0,10
2002,Earl Boykins,PG,25,LAC,68,761,110,275,13,42,97,233,47,61,280
2002,Michael Bradley,PF,22,TOR,26,118,13,25,0,2,13,23,4,8,30
2002,Shawn Bradley,C,29,DAL,53,757,78,163,0,1,78,162,59,64,215
2002,Elton Brand,PF,22,LAC,80,3020,532,1010,0,0,532,1010,389,524,1453
2002,Terrell Brandon,PG,31,MIN,32,962,155,365,4,23,151,342,83,84,397
2002,Jamison Brewer,SG,21,IND,13,43,2,5,0,1,2,4,0,0,4
2002,Primoz Brezec,C,22,IND,22,160,14,29,0,0,14,29,15,25,43
2002,Chucky Brown,SF,33,SAC,18,92,10,27,0,0,10,27,1,2,21
2002,Damone Brown,SF,22,PHI,17,67,8,21,0,1,8,20,7,8,23
2002,Dee Brown,PG,33,ORL,7,65,3,20,1,12,2,8,0,0,7
2002,Ernest Brown,C,22,MIA,3,21,1,6,0,0,1,6,1,4,3
2002,Kedrick Brown,SF,20,BOS,29,245,23,70,5,27,18,43,12,20,63
2002,Kwame Brown,PF,19,WAS,57,817,94,243,0,1,94,242,70,99,258
2002,P.J. Brown,C,32,CHH,80,2563,250,527,0,0,250,527,169,197,669
2002,Randy Brown,PG,33,BOS,1,6,0,1,0,0,0,1,0,0,0
2002,Tierre Brown,SG,22,HOU,40,403,49,115,4,12,45,103,21,28,123
2002,Rick Brunson,PG,29,POR,59,520,45,113,6,11,39,102,29,41,125
2002,Kobe Bryant,SG,23,LAL,80,3063,749,1597,33,132,716,1465,488,589,2019
2002,Mark Bryant,PF,36,SAS,30,206,25,55,0,0,25,55,6,8,56
2002,Greg Buckner,SG,25,DAL,44,885,104,198,5,16,99,182,40,58,253
2002,Jud Buechler,SF,33,TOT,66,684,44,118,21,60,23,58,2,4,111
2002,Jud Buechler,SF,33,PHO,6,54,2,6,2,6,0,0,0,0,6
2002,Jud Buechler,SF,33,ORL,60,630,42,112,19,54,23,58,2,4,105
2002,Rodney Buford,SG,24,MEM,63,1769,258,593,17,70,241,523,58,80,591
2002,Matt Bullard,PF,34,CHH,31,350,39,115,16,57,23,58,11,12,105
2002,Mitchell Butler,SG,31,POR,11,90,10,23,1,3,9,20,8,12,29
2002,Jason Caffey,PF,28,MIL,23,283,36,72,0,1,36,71,27,43,99
2002,Marcus Camby,C,27,NYK,29,1007,130,290,0,1,130,289,62,99,322
2002,Elden Campbell,PF,33,CHH,77,2156,384,794,0,2,384,792,306,384,1074
2002,Brian Cardinal,PF,24,DET,8,43,6,13,3,7,3,6,2,2,17
2002,Anthony Carter,PG,26,MIA,46,1050,89,260,1,19,88,241,19,36,198
2002,Vince Carter,SG,25,TOR,60,2385,559,1307,121,313,438,994,245,307,1484
2002,Sam Cassell,PG,32,MIL,74,2605,554,1197,71,204,483,993,282,328,1461
2002,Kelvin Cato,C,27,HOU,75,1917,190,326,0,1,190,325,113,194,493
2002,Tyson Chandler,C,19,CHI,71,1389,151,304,0,0,151,304,134,222,436
2002,Calbert Cheaney,SG,30,DEN,68,1631,224,466,0,4,224,462,46,67,494
2002,Chris Childs,PG,34,TOR,69,1576,97,296,33,120,64,176,58,71,285
2002,Doug Christie,SG,31,SAC,81,2798,338,735,90,256,248,479,206,242,972
2002,Keon Clark,C,26,TOR,81,2185,380,775,0,5,380,770,155,230,915
2002,Speedy Claxton,PG,23,PHI,67,1528,181,452,4,33,177,419,114,136,480
2002,Mateen Cleaves,PG,24,SAC,32,153,30,68,2,8,28,60,8,9,70
2002,Derrick Coleman,PF,34,PHI,58,2080,331,735,28,83,303,652,185,227,875
2002,Bimbo Coles,PG,33,CLE,47,693,56,146,4,20,52,126,33,37,149
2002,Jason Collier,C,24,HOU,25,365,41,95,0,1,41,94,24,32,106
2002,Jarron Collins,C,23,UTA,70,1440,158,343,0,1,158,342,134,181,450
2002,Jason Collins,C,23,NJN,77,1407,117,278,1,2,116,276,115,164,350
2002,Chris Crawford,PF,26,ATL,7,131,21,45,0,1,21,44,11,15,53
2002,Jamal Crawford,PG,21,CHI,23,481,89,187,26,58,63,129,10,13,214
2002,Joe Crispin,PG,22,TOT,21,156,26,68,15,39,11,29,12,13,79
2002,Joe Crispin,PG,22,LAL,6,27,3,12,0,4,3,8,4,5,10
2002,Joe Crispin,PG,22,PHO,15,129,23,56,15,35,8,21,8,8,69
2002,Austin Croshere,PF,26,IND,76,1286,185,448,49,145,136,303,97,114,516
2002,John Crotty,PG,32,UTA,41,802,98,208,31,69,67,139,57,66,284
2002,Vonteego Cummings,PG,25,PHI,58,501,78,187,12,46,66,141,24,32,192
2002,Dell Curry,SG,37,TOR,56,886,141,347,45,131,96,216,33,37,360
2002,Eddy Curry,C,19,CHI,72,1150,189,377,0,0,189,377,105,160,483
2002,Michael Curry,SG,33,DET,82,1912,125,276,7,26,118,250,72,91,329
2002,Samuel Dalembert,C,20,PHI,34,177,22,50,0,0,22,50,7,18,51
2002,Erick Dampier,C,26,GSW,73,1740,209,480,0,0,209,480,136,211,554
2002,Antonio Daniels,SG,26,SAS,82,2175,269,612,57,196,212,416,158,210,753
2002,Antonio Davis,PF,33,TOR,77,2978,410,963,0,1,410,962,293,358,1113
2002,Baron Davis,PG,22,CHH,82,3318,559,1341,170,478,389,863,196,338,1484
2002,Dale Davis,C,32,POR,78,2447,296,580,0,0,296,580,150,212,742
2002,Emanual Davis,PG,33,ATL,28,774,70,198,29,85,41,113,16,18,185
2002,Hubert Davis,SG,31,WAS,51,1231,146,326,57,126,89,200,16,21,365
2002,Ricky Davis,SF,22,CLE,82,1954,376,781,11,35,365,746,196,248,959
2002,Andrew DeClercq,C,28,ORL,61,633,67,149,0,0,67,149,28,50,162
2002,Vinny Del,PG,35,PHO,2,6,1,4,0,0,1,4,0,0,2
2002,Tony Delk,SG,28,TOT,63,1447,226,588,67,214,159,374,78,97,597
2002,Tony Delk,SG,28,PHO,41,877,166,416,47,147,119,269,56,67,435
2002,Tony Delk,SG,28,BOS,22,570,60,172,20,67,40,105,22,30,162
2002,Derrick Dial,SG,26,TOT,32,299,41,120,1,11,40,109,18,24,101
2002,Derrick Dial,SG,26,NJN,25,249,30,94,0,7,30,87,13,18,73
2002,Derrick Dial,SG,26,TOR,7,50,11,26,1,4,10,22,5,6,28
2002,Michael Dickerson,SG,26,MEM,4,124,15,48,8,21,7,27,5,6,43
2002,DeSagana Diop,C,20,CLE,18,109,12,29,0,0,12,29,1,5,25
2002,Vlade Divac,C,33,SAC,80,2420,338,716,3,13,335,703,209,340,888
2002,Michael Doleac,C,24,CLE,42,705,78,187,0,0,78,187,38,46,194
2002,Keyon Dooling,PG,21,LAC,14,155,22,57,4,14,18,43,10,12,58
2002,Bryce Drew,PG,27,CHH,61,774,78,182,31,73,47,109,23,29,210
2002,Predrag Drobnjak,C,26,SEA,64,1174,191,414,0,2,191,412,55,73,437
2002,Chris Dudley,C,36,POR,43,327,20,50,0,2,20,48,8,15,48
2002,Tim Duncan,PF,25,SAS,82,3329,764,1504,1,10,763,1494,560,701,2089
2002,Howard Eisley,PG,29,NYK,39,609,59,175,14,58,45,117,39,49,171
2002,Obinna Ekezie,PF,26,LAC,29,152,13,39,0,0,13,39,28,40,54
2002,LaPhonso Ellis,SF,31,MIA,66,1684,189,452,38,124,151,328,53,84,469
2002,Evan Eschmeyer,C,26,DAL,31,299,21,50,0,0,21,50,20,33,62
2002,Maurice Evans,SG,23,MIN,10,45,9,19,0,3,9,16,3,4,21
2002,Patrick Ewing*,C,39,ORL,65,901,148,333,0,1,148,332,94,134,390
2002,Danny Ferry,SF,35,SAS,50,799,76,177,43,99,33,78,34,36,229
2002,Michael Finley,SF,28,DAL,69,2754,569,1228,76,224,493,1004,210,251,1424
2002,Derek Fisher,PG,27,LAL,70,1974,274,666,144,349,130,317,94,111,786
2002,Marcus Fizer,PF,23,CHI,76,1963,371,848,7,41,364,807,189,283,938
2002,Isaac Fontaine,SG,26,MEM,6,75,3,14,1,5,2,9,4,6,11
2002,Alton Ford,PF,20,PHO,53,452,61,118,0,0,61,118,42,57,164
2002,Joseph Forte,SG,20,BOS,8,39,1,12,0,3,1,9,4,4,6
2002,Danny Fortson,PF,25,GSW,77,2216,309,722,1,4,308,718,245,308,864
2002,Greg Foster,PF,33,MIL,6,24,2,9,0,4,2,5,3,4,7
2002,Jeff Foster,C,25,IND,82,1786,177,394,2,15,175,379,111,182,467
2002,Antonis Fotsis,PF,20,MEM,28,320,42,104,7,23,35,81,17,20,108
2002,Tremaine Fowlkes,SF,25,LAC,22,343,25,64,0,0,25,64,24,31,74
2002,Rick Fox,SF,32,LAL,82,2289,255,605,65,208,190,397,70,85,645
2002,Adonal Foyle,C,26,GSW,79,1485,171,385,0,0,171,385,37,93,379
2002,Steve Francis,PG,24,HOU,57,2343,420,1007,68,210,352,797,326,422,1234
2002,Lawrence Funderburke,PF,31,SAC,56,722,115,245,0,3,115,242,34,56,264
2002,Kevin Garnett,PF,25,MIN,81,3175,659,1401,37,116,622,1285,359,448,1714
2002,Dean Garrett,C,35,TOT,34,183,18,55,0,0,18,55,0,3,36
2002,Dean Garrett,C,35,MIN,29,152,14,40,0,0,14,40,0,3,28
2002,Dean Garrett,C,35,GSW,5,31,4,15,0,0,4,15,0,0,8
2002,Pat Garrity,PF,25,ORL,80,2406,327,767,169,396,158,371,61,73,884
2002,Pau Gasol,C,21,MEM,82,3007,551,1064,1,5,550,1059,338,477,1441
2002,Chris Gatling,PF,34,MIA,54,809,131,293,1,8,130,285,82,117,345
2002,Matt Geiger,C,32,PHI,4,36,1,8,0,0,1,8,1,2,3
2002,Devean George,SF,24,LAL,82,1759,215,523,66,178,149,345,85,126,581
2002,Eddie Gill,PG,23,MEM,23,384,39,92,7,22,32,70,31,39,116
2002,Kendall Gill,SG,33,MIA,65,1410,162,422,6,44,156,378,42,62,372
2002,Dion Glover,SG,23,ATL,55,1156,192,456,30,91,162,365,78,103,492
2002,Steve Goodrich,SF,25,NJN,9,50,2,10,0,0,2,10,1,2,5
2002,Brian Grant,PF,29,MIA,72,2256,286,610,0,2,286,608,101,119,673
2002,Horace Grant,C,36,ORL,76,2210,264,515,0,0,264,515,80,111,608
2002,Adrian Griffin,SG,27,DAL,58,1383,179,359,16,54,163,305,41,49,415
2002,Eddie Griffin,PF,19,HOU,73,1896,244,666,90,273,154,393,64,86,642
2002,Tom Gugliotta,PF,32,PHO,44,1129,127,301,3,9,124,292,28,37,285
2002,A.J. Guyton,PG,23,CHI,45,607,88,244,46,123,42,121,22,27,244
2002,Darvin Ham,SF,28,MIL,70,1208,120,211,1,7,119,204,62,123,303
2002,Richard Hamilton,SG,23,WAS,63,2203,472,1084,16,42,456,1042,300,337,1260
2002,Tang Hamilton,SF,23,MIA,9,98,10,19,0,1,10,18,0,1,20
2002,Zendon Hamilton,PF,26,DEN,54,848,103,245,0,0,103,245,118,181,324
2002,Anfernee Hardaway,SG,30,PHO,80,2462,389,931,23,83,366,848,158,195,959
2002,Tim Hardaway,PG,35,TOT,68,1601,226,620,123,354,103,266,77,97,652
2002,Tim Hardaway,PG,35,DAL,54,1276,179,494,95,279,84,215,65,78,518
2002,Tim Hardaway,PG,35,DEN,14,325,47,126,28,75,19,51,12,19,134
2002,Matt Harpring,SF,25,PHI,81,2541,386,838,21,69,365,769,165,222,958
2002,Al Harrington,PF,21,IND,44,1313,230,484,1,3,229,481,115,144,576
2002,Othella Harrington,PF,28,NYK,77,1563,237,450,0,2,237,448,122,172,596
2002,Lucious Harris,SG,31,NJN,74,1553,249,537,44,118,205,419,133,158,675
2002,Jason Hart,PG,23,SAS,10,92,10,19,0,2,10,17,6,6,26
2002,Antonio Harvey,PF,31,SEA,5,47,4,12,0,0,4,12,1,2,9
2002,Donnell Harvey,PF,21,TOT,47,841,108,217,0,0,108,217,54,90,270
2002,Donnell Harvey,PF,21,DAL,18,162,14,26,0,0,14,26,10,22,38
2002,Donnell Harvey,PF,21,DEN,29,679,94,191,0,0,94,191,44,68,232
2002,Trenton Hassell,SG,22,CHI,78,2237,267,628,60,165,207,463,87,114,681
2002,Kirk Haston,PF,22,CHH,15,77,11,39,0,3,11,36,4,8,26
2002,Brendan Haywood,C,22,WAS,62,1266,109,221,0,0,109,221,97,160,315
2002,Alan Henderson,PF,29,ATL,26,422,59,116,1,1,58,115,24,45,143
2002,Cedric Henderson,SF,26,GSW,12,70,15,31,2,4,13,27,4,7,36
2002,Grant Hill,SF,29,ORL,14,512,83,195,0,2,83,193,69,80,235
2002,Tyrone Hill,PF,33,CLE,26,810,71,182,0,1,71,181,67,103,209
2002,Fred Hoiberg,SG,29,CHI,79,1408,121,291,24,92,97,199,79,94,345
2002,Robert Horry,PF,31,LAL,81,2140,183,460,76,203,107,257,108,138,550
2002,Eddie House,PG,23,MIA,64,1230,209,524,54,157,155,367,42,49,514
2002,Allan Houston,SG,30,NYK,77,2914,568,1301,136,346,432,955,295,339,1567
2002,Juwan Howard,PF,28,TOT,81,2635,462,1005,0,2,462,1003,261,343,1185
2002,Juwan Howard,PF,28,DAL,53,1659,270,585,0,1,270,584,144,191,684
2002,Juwan Howard,PF,28,DEN,28,976,192,420,0,1,192,419,117,152,501
2002,Troy Hudson,PG,25,ORL,81,1854,354,815,66,187,288,628,176,201,950
2002,Larry Hughes,SG,23,GSW,73,2049,343,810,18,93,325,717,191,259,895
2002,Lindsey Hunter,PG,31,LAL,82,1616,187,490,79,208,108,282,20,40,473
2002,Steven Hunter,C,20,ORL,53,516,67,147,0,0,67,147,55,94,189
2002,Zydrunas Ilgauskas,C,26,CLE,62,1329,241,567,0,5,241,562,208,276,690
2002,Allen Iverson*,SG,26,PHI,60,2622,665,1669,78,268,587,1401,475,585,1883
2002,Bobby Jackson,PG,28,SAC,81,1750,334,754,79,219,255,535,149,184,896
2002,Jaren Jackson,SG,34,ORL,9,144,15,37,7,20,8,17,2,4,39
2002,Jermaine Jackson,SG,25,TOR,24,280,20,42,1,2,19,40,16,24,57
2002,Jim Jackson,SF,31,MIA,55,1825,238,538,38,81,200,457,75,87,589
2002,Marc Jackson,C,27,TOT,39,495,60,164,0,1,60,163,66,80,186
2002,Marc Jackson,C,27,GSW,17,169,22,65,0,0,22,65,40,48,84
2002,Marc Jackson,C,27,MIN,22,326,38,99,0,1,38,98,26,32,102
2002,Mark Jackson,PG,36,NYK,82,2367,260,592,79,195,181,397,87,110,686
2002,Stephen Jackson,SF,23,SAS,23,227,34,91,9,36,25,55,12,17,89
2002,Jerome James,C,26,SEA,56,949,134,273,0,0,134,273,30,60,298
2002,Mike James,PG,26,MIA,15,119,15,43,8,21,7,22,4,7,42
2002,Tim James,SF,25,PHI,9,41,5,13,0,0,5,13,2,6,12
2002,Antawn Jamison,SF,25,GSW,82,3033,614,1375,68,210,546,1165,323,440,1619
2002,Harold Jamison,PF,25,LAC,25,176,22,43,0,0,22,43,10,15,54
2002,Richard Jefferson,SF,21,NJN,79,1917,270,591,13,56,257,535,189,265,742
2002,Anthony Johnson,SG,27,NJN,34,366,37,90,4,12,33,78,16,25,94
2002,Avery Johnson,PG,36,TOT,68,1352,207,432,0,5,207,427,121,163,535
2002,Avery Johnson,PG,36,DEN,51,1200,186,383,0,5,186,378,109,146,481
2002,Avery Johnson,PG,36,DAL,17,152,21,49,0,0,21,49,12,17,54
2002,DerMarr Johnson,SF,21,ATL,72,1727,214,540,89,247,125,293,85,105,602
2002,Ervin Johnson,C,34,MIL,81,1660,89,193,0,1,89,192,30,66,208
2002,Joe Johnson,SG,20,TOT,77,1916,251,584,38,130,213,454,41,53,581
2002,Joe Johnson,SG,20,BOS,48,1003,130,296,24,88,106,208,20,26,304
2002,Joe Johnson,SG,20,PHO,29,913,121,288,14,42,107,246,21,27,277
2002,Alvin Jones,C,23,PHI,23,126,8,20,0,0,8,20,10,20,26
2002,Damon Jones,PG,25,DET,67,1083,114,284,69,186,45,98,43,59,340
2002,Eddie Jones,SG,30,MIA,81,3156,517,1198,149,382,368,816,297,355,1480
2002,Jumaine Jones,PF,22,CLE,81,2142,287,640,52,168,235,472,45,68,671
2002,Popeye Jones,PF,31,WAS,79,1920,222,508,4,11,218,497,106,130,554
2002,Michael Jordan*,SF,38,WAS,60,2093,551,1324,10,53,541,1271,263,333,1375
2002,Shawn Kemp,PF,32,POR,75,1232,175,407,0,4,175,403,104,131,454
2002,Steve Kerr,PG,36,POR,65,775,102,217,26,66,76,151,39,40,269
2002,Jason Kidd,PG,28,NJN,82,3056,445,1138,117,364,328,774,201,247,1208
2002,Andrei Kirilenko,SF,20,UTA,82,2151,285,633,25,100,260,533,285,371,880
2002,Kerry Kittles,SG,27,NJN,82,2601,438,940,98,242,340,698,128,172,1102
2002,Brevin Knight,PG,26,MEM,53,1151,141,334,2,8,139,326,87,115,371
2002,Travis Knight,C,27,NYK,49,429,41,113,0,0,41,113,16,21,98
2002,Toni Kukoc,SF,33,ATL,59,1494,211,504,53,171,158,333,109,153,584
2002,Christian Laettner,PF,32,WAS,57,1441,168,362,2,10,166,352,66,76,404
2002,Raef LaFrentz,C,25,TOT,78,2455,421,920,104,268,317,652,105,151,1051
2002,Raef LaFrentz,C,25,DEN,51,1668,307,659,75,173,232,486,70,105,759
2002,Raef LaFrentz,C,25,DAL,27,787,114,261,29,95,85,166,35,46,292
2002,Trajan Langdon,SG,25,CLE,44,477,70,176,27,74,43,102,42,46,209
2002,Dan Langhi,SF,24,HOU,34,434,49,125,1,4,48,121,8,11,107
2002,Rusty LaRue,PG,28,UTA,33,542,73,185,17,50,56,135,30,35,193
2002,Voshon Lenard,SG,28,DEN,71,1665,315,769,89,240,226,529,94,120,813
2002,Quincy Lewis,SG,24,UTA,36,490,64,143,3,18,61,125,13,20,144
2002,Rashard Lewis,SF,22,SEA,71,2585,455,972,123,316,332,656,162,200,1195
2002,Randy Livingston,PG,26,SEA,13,176,15,54,1,8,14,46,10,11,41
2002,Art Long,PF,29,SEA,63,989,120,244,0,0,120,244,45,85,285
2002,Grant Long,PF,35,MEM,66,1868,164,385,3,17,161,368,86,123,417
2002,Felipe Lopez,SG,27,MIN,67,581,59,156,14,33,45,123,37,55,169
2002,Tyronn Lue,PG,24,WAS,71,1458,222,520,63,141,159,379,48,63,555
2002,George Lynch,SF,31,CHH,45,893,73,198,1,6,72,192,25,40,172
2002,Todd MacCulloch,C,26,NJN,62,1502,247,465,0,0,247,465,110,164,604
2002,Sam Mack,SF,31,MIA,12,159,14,49,7,28,7,21,5,7,40
2002,Mark Madsen,PF,26,LAL,59,650,66,146,0,2,66,144,35,54,167
2002,Corey Maggette,SG,22,LAC,63,1615,235,530,46,139,189,391,201,251,717
2002,Jamaal Magloire,C,23,CHH,82,1549,228,414,0,1,228,413,243,333,699
2002,Dan Majerle,SG,36,PHO,65,1180,99,289,79,235,20,54,23,39,300
2002,Karl Malone*,PF,38,UTA,80,3040,635,1399,9,25,626,1374,509,639,1788
2002,Danny Manning,PF,35,DAL,41,552,71,149,1,7,70,142,22,33,165
2002,Stephon Marbury,PG,24,PHO,82,3187,625,1413,71,248,554,1165,353,452,1674
2002,Shawn Marion,SF,23,PHO,81,3109,654,1395,48,122,606,1273,191,226,1547
2002,Sean Marks,C,26,MIA,21,319,38,88,0,0,38,88,20,34,96
2002,Donny Marshall,SF,29,NJN,20,118,8,29,2,4,6,25,12,18,30
2002,Donyell Marshall,SF,28,UTA,58,1750,343,661,13,42,330,619,160,226,859
2002,Darrick Martin,PG,30,DAL,3,22,0,10,0,2,0,8,1,2,1
2002,Kenyon Martin,PF,24,NJN,73,2504,445,962,15,67,430,895,181,267,1086
2002,Jamal Mashburn,SF,29,CHH,40,1601,303,744,41,112,262,632,211,241,858
2002,Anthony Mason,PF,35,MIL,82,3143,316,626,1,1,315,625,154,221,787
2002,Desmond Mason,SF,24,SEA,75,2420,357,769,16,59,341,710,201,237,931
2002,Tony Massenburg,PF,34,MEM,73,1247,159,349,1,1,158,348,84,117,403
2002,Walter McCarty,PF,27,BOS,56,718,80,180,39,99,41,81,13,19,212
2002,Amal McCaskill,C,28,SAS,27,153,20,49,0,0,20,49,12,26,52
2002,George McCloud,SF,34,DEN,69,1830,206,576,60,222,146,354,132,163,604
2002,Jelani McCoy,C,24,LAL,21,104,12,21,0,0,12,21,2,8,26
2002,Antonio McDyess,PF,27,DEN,10,236,43,75,0,0,43,75,27,33,113
2002,Tracy McGrady,SG,22,ORL,76,2912,715,1586,103,283,612,1303,415,555,1948
2002,Jeff McInnis,PG,27,LAC,81,3030,463,1121,75,234,388,887,183,219,1184
2002,Derrick McKey,SF,35,PHI,41,784,52,122,5,12,47,110,10,14,119
2002,Aaron McKie,SG,29,PHI,48,1471,220,490,51,128,169,362,96,122,587
2002,Stanislav Medvedenko,C,22,LAL,71,729,145,304,0,4,145,300,41,62,331
2002,Ron Mercer,SG,25,TOT,53,1716,311,784,18,62,293,722,95,119,735
2002,Ron Mercer,SG,25,CHI,40,1503,286,717,17,57,269,660,84,108,673
2002,Ron Mercer,SG,25,IND,13,213,25,67,1,5,24,62,11,11,62
2002,Chris Mihm,C,22,CLE,74,1659,221,526,3,7,218,519,124,179,569
2002,Darius Miles,SF,20,LAC,82,2227,309,642,3,19,306,623,158,255,779
2002,Andre Miller,PG,25,CLE,81,3023,474,1045,22,87,452,958,365,447,1335
2002,Brad Miller,C,25,TOT,76,2263,366,733,3,7,363,726,297,383,1032
2002,Brad Miller,C,25,CHI,48,1391,208,452,2,4,206,448,190,253,608
2002,Brad Miller,C,25,IND,28,872,158,281,1,3,157,278,107,130,424
2002,Mike Miller,SF,21,ORL,63,2123,351,802,116,303,235,499,138,181,956
2002,Reggie Miller*,SG,36,IND,79,2889,414,913,180,443,234,470,296,325,1304
2002,Chris Mills,SF,32,GSW,66,1237,178,427,48,127,130,300,85,107,489
2002,Sam Mitchell,SF,38,MIN,74,726,98,227,10,35,88,192,38,49,244
2002,Cuttino Mobley,SG,26,HOU,74,3116,595,1358,149,377,446,981,267,314,1606
2002,Nazr Mohammed,C,24,ATL,82,2168,329,713,0,1,329,712,137,222,795
2002,Jerome Moiso,C,23,CHH,15,76,8,20,0,0,8,20,0,0,16
2002,Eric Montross,C,30,TOR,49,655,53,132,0,1,53,131,10,31,116
2002,Mikki Moore,C,26,DET,30,217,29,61,1,2,28,59,20,26,79
2002,Terence Morris,SF,23,HOU,68,1110,111,289,15,78,96,211,18,28,255
2002,Hanno Mottola,C,25,ATL,82,1371,169,384,1,13,168,371,57,76,396
2002,Alonzo Mourning*,C,31,MIA,75,2455,447,866,1,3,446,863,283,431,1178
2002,Troy Murphy,PF,21,GSW,82,1448,178,423,3,9,175,414,121,156,480
2002,Lamond Murray,SF,28,CLE,71,2312,430,986,101,238,329,748,215,263,1176
2002,Tracy Murray,SF,30,TOR,40,473,85,207,40,104,45,103,17,21,227
2002,Dikembe Mutombo*,C,35,PHI,80,2907,321,641,0,0,321,641,278,364,920
2002,Mamadou N'Diaye,C,26,TOR,5,46,6,10,0,0,6,10,8,10,20
2002,Lee Nailon,SF,26,CHH,79,1912,369,764,1,2,368,762,112,150,851
2002,Eduardo Najera,PF,25,DAL,62,1357,150,300,0,2,150,298,100,148,400
2002,Steve Nash,PG,27,DAL,82,2837,525,1088,156,343,369,745,260,293,1466
2002,Tyrone Nesby,SF,26,WAS,70,1498,183,421,13,47,170,374,64,93,443
2002,Rasho Nesterovic,C,25,MIN,82,2218,324,657,0,1,324,656,39,71,687
2002,Ira Newble,SF,27,ATL,42,1273,131,263,1,7,130,256,75,88,338
2002,Johnny Newman,SF,38,DAL,47,724,67,148,22,57,45,91,42,58,198
2002,Moochie Norris,PG,28,HOU,82,2249,251,631,36,134,215,497,127,169,665
2002,Dirk Nowitzki,C,23,DAL,76,2891,600,1258,139,350,461,908,440,516,1779
2002,Jermaine O'Neal,PF,23,IND,72,2707,543,1133,1,14,542,1119,284,413,1371
2002,Shaquille O'Neal*,C,29,LAL,67,2422,712,1229,0,1,712,1228,398,717,1822
2002,Charles Oakley,PF,38,CHI,57,1383,97,263,1,6,96,257,21,28,216
2002,Lamar Odom,SF,22,LAC,29,999,151,360,16,84,135,276,61,93,379
2002,Hakeem Olajuwon*,C,39,TOR,61,1378,194,418,0,2,194,416,47,84,435
2002,Dean Oliver,PG,23,GSW,20,139,17,46,2,13,15,33,6,9,42
2002,Kevin Ollie,PG,29,TOT,81,1723,137,353,1,2,136,351,187,227,462
2002,Kevin Ollie,PG,29,CHI,52,1146,97,253,1,2,96,251,109,130,304
2002,Kevin Ollie,PG,29,IND,29,577,40,100,0,0,40,100,78,97,158
2002,Michael Olowokandi,C,26,LAC,80,2568,384,886,0,0,384,886,117,188,885
2002,Greg Ostertag,C,28,UTA,74,1107,91,201,0,0,91,201,63,130,245
2002,Bo Outlaw,PF,30,TOT,83,1928,166,299,1,2,165,297,43,102,376
2002,Bo Outlaw,PF,30,ORL,10,160,13,21,0,0,13,21,8,18,34
2002,Bo Outlaw,PF,30,PHO,73,1768,153,278,1,2,152,276,35,84,342
2002,Doug Overton,PG,32,LAC,18,130,14,44,7,27,7,17,4,7,39
2002,Olumide Oyedeji,C,20,SEA,36,221,22,41,0,0,22,41,11,18,55
2002,Robert Pack,PG,32,MIN,16,252,25,68,1,4,24,64,11,15,62
2002,Scott Padgett,PF,25,UTA,75,1295,188,395,49,113,139,282,75,102,500
2002,Milt Palacio,PG-SG,23,TOT,69,790,82,214,13,41,69,173,54,74,231
2002,Milt Palacio,PG,23,BOS,41,518,52,135,12,34,40,101,36,51,152
2002,Milt Palacio,SG,23,PHO,28,272,30,79,1,7,29,72,18,23,79
2002,Tony Parker,PG,19,SAS,77,2267,268,639,61,189,207,450,108,160,705
2002,Cherokee Parks,C,29,SAS,42,234,30,83,0,0,30,83,3,8,63
2002,Ruben Patterson,SF,26,POR,75,1765,319,619,9,36,310,583,192,274,839
2002,Gary Payton*,PG,33,SEA,82,3301,737,1578,74,236,663,1342,267,335,1815
2002,Anthony Peeler,SG,32,MIN,82,2060,288,684,111,283,177,401,50,58,737
2002,Mike Penberthy,PG,27,LAL,3,12,1,2,0,0,1,2,3,4,5
2002,Elliot Perry,PG,32,MEM,2,48,5,10,0,0,5,10,1,2,11
2002,Wesley Person,SG,30,CLE,78,2793,467,944,143,322,324,622,99,124,1176
2002,Morris Peterson,SF,24,TOR,63,1988,336,768,84,231,252,537,127,169,883
2002,Eric Piatkowski,SG,31,LAC,71,1718,207,471,111,238,96,233,101,113,626
2002,Paul Pierce,SG,24,BOS,82,3302,707,1598,210,520,497,1078,520,643,2144
2002,Scottie Pippen*,SF,36,POR,62,1996,246,599,54,177,192,422,113,146,659
2002,Scot Pollard,C,26,SAC,80,1881,197,358,0,0,197,358,115,166,509
2002,Mark Pope,PF,29,MIL,45,426,36,91,4,25,32,66,11,21,87
2002,Terry Porter,PG,38,SAS,72,1294,136,321,59,142,77,179,68,83,399
2002,James Posey,SF,25,DEN,73,2238,277,736,67,237,210,499,161,203,782
2002,Lavor Postell,SG,23,NYK,23,179,28,84,6,26,22,58,31,41,93
2002,Vitaly Potapenko,C,26,BOS,79,1343,137,301,0,0,137,301,89,120,363
2002,Brent Price,PG,33,SAC,20,89,9,27,4,15,5,12,9,13,31
2002,Joel Przybilla,C,22,MIL,71,1128,76,142,0,1,76,141,38,90,190
2002,Vladimir Radmanovic,PF,21,SEA,61,1230,146,354,66,157,80,197,49,72,407
2002,Zach Randolph,PF,20,POR,41,238,48,107,0,0,48,107,18,27,114
2002,Theo Ratliff,C,28,ATL,3,82,10,20,0,0,10,20,6,11,26
2002,Zeljko Rebraca,C,29,DET,74,1179,189,374,0,0,189,374,135,175,513
2002,Eldridge Recasner,PG-SG,34,TOT,6,33,2,6,0,1,2,5,1,1,5
2002,Eldridge Recasner,SG,34,CHH,1,2,0,0,0,0,0,0,0,0,0
2002,Eldridge Recasner,PG,34,LAC,5,31,2,6,0,1,2,5,1,1,5
2002,Michael Redd,SG,22,MIL,67,1417,294,609,88,198,206,411,91,115,767
2002,Don Reid,PF,28,ORL,68,714,90,190,0,0,90,190,44,68,224
2002,Glen Rice,SF,34,HOU,20,606,65,167,18,64,47,103,24,30,172
2002,Jason Richardson,SG,21,GSW,80,2629,464,1090,82,246,382,844,141,210,1151
2002,Norm Richardson,SG,22,TOT,11,67,10,26,4,8,6,18,6,9,30
2002,Norm Richardson,SG,22,IND,3,4,0,3,0,0,0,3,0,0,0
2002,Norm Richardson,SG,22,CHI,8,63,10,23,4,8,6,15,6,9,30
2002,Quentin Richardson,SG,21,LAC,81,2152,400,926,133,349,267,577,143,187,1076
2002,Mitch Richmond*,SG,36,LAL,64,709,100,247,18,62,82,185,42,44,260
2002,Isaiah Rider,SG,30,DEN,10,173,37,81,6,15,31,66,13,17,93
2002,Clifford Robinson,PF,35,DET,80,2855,454,1069,115,304,339,765,143,206,1166
2002,David Robinson*,C,36,SAS,78,2303,341,672,0,0,341,672,269,395,951
2002,Eddie Robinson,SF,25,CHI,29,653,112,247,2,5,110,242,36,48,262
2002,Glenn Robinson,SF,29,MIL,66,2346,536,1147,58,178,478,969,236,282,1366
2002,Larry Robinson,SG,34,NYK,2,10,1,4,1,2,0,2,0,0,3
2002,Carlos Rogers,C,30,IND,22,168,24,43,1,6,23,37,10,19,59
2002,Rodney Rogers,SF,30,TOT,77,1880,356,756,88,235,268,521,117,149,917
2002,Rodney Rogers,SF,30,PHO,50,1254,249,534,49,140,200,394,82,99,629
2002,Rodney Rogers,SF,30,BOS,27,626,107,222,39,95,68,127,35,50,288
2002,Sean Rooks,C,32,LAC,61,728,81,194,0,0,81,194,21,29,183
2002,Jalen Rose,SF,29,TOT,83,3153,663,1458,89,246,574,1212,281,335,1696
2002,Jalen Rose,SF,29,IND,53,1937,387,871,52,146,335,725,156,186,982
2002,Jalen Rose,SF,29,CHI,30,1216,276,587,37,100,239,487,125,149,714
2002,Malik Rose,PF,27,SAS,82,1725,293,633,1,12,292,621,185,257,772
2002,Michael Ruffin,PF,25,PHI,15,169,7,26,0,0,7,26,2,8,16
2002,Bryon Russell,SG,31,UTA,66,1998,222,584,77,226,145,358,115,140,636
2002,Daniel Santiago,C,25,PHO,3,24,4,8,0,0,4,8,0,0,8
2002,Jeryl Sasser,SG,22,ORL,7,36,3,14,0,0,3,14,4,5,10
2002,Kenny Satterfield,PG,20,DEN,36,560,73,199,7,27,66,172,36,46,189
2002,Brian Scalabrine,PF,23,NJN,28,290,23,67,3,10,20,57,11,15,60
2002,Shawnelle Scott,C,29,DEN,21,252,37,75,0,0,37,75,8,20,82
2002,Ansu Sesay,SF,25,SEA,9,142,22,44,0,0,22,44,14,20,58
2002,Brian Shaw,PG,35,LAL,58,631,61,173,29,88,32,85,18,26,169
2002,Bobby Simmons,SF,21,WAS,30,343,43,95,4,14,39,81,22,30,112
2002,Dickey Simpkins,PF,29,ATL,1,3,0,0,0,0,0,0,0,0,0
2002,Brian Skinner,PF,25,CLE,65,1107,88,162,0,0,88,162,48,79,224
2002,Reggie Slater,PF,31,TOT,8,47,7,15,0,0,7,15,7,10,21
2002,Reggie Slater,PF,31,NJN,4,10,2,2,0,0,2,2,1,1,5
2002,Reggie Slater,PF,31,ATL,4,37,5,13,0,0,5,13,6,9,16
2002,Charles Smith,SG,26,SAS,60,1141,182,428,35,131,147,297,42,65,441
2002,Jabari Smith,C,24,TOT,23,181,26,63,0,3,26,60,21,32,73
2002,Jabari Smith,C,24,SAC,12,71,6,21,0,1,6,20,6,12,18
2002,Jabari Smith,C,24,PHI,11,110,20,42,0,2,20,40,15,20,55
2002,Joe Smith,C,26,MIN,72,1922,297,581,2,3,295,578,171,206,767
2002,Leon Smith,C,21,ATL,14,100,10,26,0,0,10,26,11,17,31
2002,Steve Smith,SG,32,SAS,77,2211,310,682,116,246,194,436,159,181,895
2002,Eric Snow,PG,28,PHI,61,2225,276,624,3,27,273,597,183,227,738
2002,Will Solomon,SG,23,MEM,62,872,113,331,46,162,67,169,49,73,321
2002,Felton Spencer,C,34,NYK,32,248,6,26,0,0,6,26,17,33,29
2002,Latrell Sprewell,SF,31,NYK,81,3326,573,1419,145,403,428,1016,284,346,1575
2002,Jerry Stackhouse,SF,27,DET,76,2685,524,1319,86,300,438,1019,495,577,1629
2002,John Starks,SG,36,UTA,66,929,114,310,29,95,85,215,33,41,290
2002,Vladimir Stepania,C,25,MIA,67,884,117,249,1,2,116,247,50,104,285
2002,DeShawn Stevenson,SG,20,UTA,67,1134,143,371,2,25,141,346,37,53,325
2002,Michael Stewart,C,26,TOR,11,93,8,23,0,0,8,23,6,11,22
2002,Bryant Stith,SG,31,CLE,50,665,70,188,24,68,46,120,44,52,208
2002,John Stockton*,PG,39,UTA,82,2566,401,775,25,78,376,697,275,321,1102
2002,Peja Stojakovic,SF,24,SAC,71,2649,547,1130,129,310,418,820,283,323,1506
2002,Damon Stoudamire,PG,28,POR,75,2796,369,918,104,295,265,623,174,196,1016
2002,Erick Strickland,PG,28,BOS,79,1643,190,488,95,247,95,241,131,155,606
2002,Mark Strickland,SF,31,ATL,46,654,91,204,1,4,90,200,25,44,208
2002,Rod Strickland,PG,35,MIA,76,2294,316,714,8,26,308,688,154,201,794
2002,Bruno Sundov,C,21,IND,22,88,16,40,0,1,16,39,0,2,32
2002,Bob Sura,PG,28,GSW,78,1780,250,590,42,133,208,457,236,328,778
2002,Stromile Swift,PF,22,MEM,68,1805,293,611,0,3,293,608,217,305,803
2002,Wally Szczerbiak,SF,24,MIN,82,3117,609,1200,87,191,522,1009,226,272,1531
2002,Jason Terry,SG,24,ATL,78,2967,524,1219,172,444,352,775,284,340,1504
2002,Etan Thomas,C,23,WAS,47,618,81,151,0,0,81,151,41,74,203
2002,Kenny Thomas,PF,24,HOU,72,2484,396,829,0,16,396,813,223,336,1015
2002,Kurt Thomas,C,29,NYK,82,2771,463,938,1,6,462,932,216,265,1143
2002,Tim Thomas,SF,24,MIL,74,1987,316,753,95,291,221,462,142,179,869
2002,Jamaal Tinsley,PG,23,IND,80,2442,289,760,42,175,247,585,131,186,751
2002,Oscar Torres,SG,25,HOU,65,1075,135,341,37,126,98,215,82,105,389
2002,Robert Traylor,PF,24,CHH,61,678,87,204,1,1,86,203,53,84,228
2002,Gary Trent,PF,27,MIN,64,1140,193,381,0,2,193,379,92,144,478
2002,Jeff Trepagnier,SG,22,CLE,12,77,7,23,0,1,7,22,4,7,18
2002,Jake Tsakalidis,C,22,PHO,67,1582,190,400,0,1,190,399,111,159,491
2002,Hedo Turkoglu,SF,22,SAC,80,1970,290,687,63,171,227,516,167,230,810
2002,Nick Van,PG-SG,30,TOT,72,2496,501,1226,119,350,382,876,201,251,1322
2002,Nick Van,PG,30,DEN,45,1739,372,912,85,252,287,660,136,174,965
2002,Nick Van,SG,30,DAL,27,757,129,314,34,98,95,216,65,77,357
2002,Keith Van,SF,26,NJN,81,2465,471,1089,101,293,370,796,156,195,1199
2002,Ratko Varda,C,22,DET,1,6,2,3,0,0,2,3,1,1,5
2002,Jacque Vaughn,PG,26,ATL,82,1856,206,438,24,54,182,384,104,126,540
2002,Jake Voskuhl,C,24,PHO,59,900,107,193,0,0,107,193,82,109,296
2002,Antoine Walker,PF,25,BOS,81,3406,666,1689,222,645,444,1044,240,324,1794
2002,Samaki Walker,PF,25,LAL,69,1655,187,365,0,0,187,365,86,129,460
2002,Ben Wallace,C,27,DET,80,2921,255,480,0,3,255,477,99,234,609
2002,Gerald Wallace,SF,19,SAC,54,430,75,175,0,7,75,168,23,46,173
2002,John Wallace,SF,27,PHO,46,490,93,214,5,13,88,201,40,46,231
2002,Rasheed Wallace,PF,27,POR,79,2963,603,1287,114,317,489,970,201,274,1521
2002,Charlie Ward,PG,31,NYK,63,1058,113,303,53,164,60,139,47,58,326
2002,Earl Watson,PG,22,SEA,64,964,96,212,16,44,80,168,23,36,231
2002,Clarence Weatherspoon,PF,31,NYK,56,1728,189,452,0,0,189,452,116,146,494
2002,Chris Webber,PF,28,SAC,54,2071,532,1075,5,19,527,1056,253,338,1322
2002,Bonzi Wells,SG,25,POR,74,2348,487,1039,66,172,421,867,215,290,1255
2002,David Wesley,SG,31,CHH,67,2487,364,910,85,256,279,654,138,188,951
2002,Jahidi White,C,25,WAS,71,1346,150,279,0,0,150,279,83,154,383
2002,Rodney White,SF,21,DET,16,129,21,60,2,9,19,51,12,14,56
2002,Chris Whitney,PG,30,WAS,82,2171,274,656,131,323,143,333,154,175,833
2002,Aaron Williams,PF,30,NJN,82,1546,231,439,0,2,231,437,130,186,592
2002,Alvin Williams,PG,27,TOR,82,2927,403,971,62,193,341,778,103,140,971
2002,Eric Williams,SF,29,BOS,74,1747,144,385,24,86,120,299,160,219,472
2002,Jason Williams,PG,26,MEM,65,2236,376,985,127,430,249,555,80,101,959
2002,Jerome Williams,PF,28,TOR,68,1641,190,388,0,0,190,388,138,204,518
2002,Monty Williams,SF,30,ORL,68,1284,198,362,0,4,198,358,88,134,484
2002,Scott Williams,PF,33,DEN,41,737,86,217,0,2,86,215,30,41,202
2002,Shammond Williams,SG,26,SEA,50,603,81,193,28,75,53,118,31,39,221
2002,Walt Williams,SF,31,HOU,48,1117,166,396,78,183,88,213,40,51,450
2002,Corliss Williamson,SF,28,DET,78,1701,411,806,1,5,410,801,240,298,1063
2002,Kevin Willis,PF,39,HOU,52,865,125,284,0,1,125,283,65,87,315
2002,Loren Woods,C,23,MIN,60,516,33,96,0,2,33,94,44,60,110
2002,Metta World,SF,22,TOT,55,1642,269,636,53,170,216,466,136,204,727
2002,Metta World,SF,22,CHI,27,823,152,351,36,91,116,260,81,129,421
2002,Metta World,SF,22,IND,28,819,117,285,17,79,100,206,55,75,306
2002,Lorenzen Wright,C,26,MEM,43,1251,223,486,0,2,223,484,70,123,516
2002,Wang Zhizhi,C,24,DAL,55,600,109,248,48,116,61,132,42,57,308
,,,,,,,,,,,,,,,
2003,Tariq Abdul-Wahad,SG,28,DAL,14,204,27,58,0,1,27,57,3,6,57
2003,Shareef Abdur-Rahim,PF,26,ATL,81,3087,566,1183,21,60,545,1123,455,541,1608
2003,Courtney Alexander,PG,25,NOH,66,1360,193,505,19,57,174,448,118,146,523
2003,Malik Allen,PF,24,MIA,80,2318,335,790,0,4,335,786,97,121,767
2003,Ray Allen,SG,27,TOT,76,2880,598,1363,201,533,397,830,316,345,1713
2003,Ray Allen,SG,27,MIL,47,1683,351,803,123,311,228,492,178,195,1003
2003,Ray Allen,SG,27,SEA,29,1197,247,560,78,222,169,338,138,150,710
2003,Rafer Alston,PG,26,TOR,47,980,139,335,51,130,88,205,37,54,366
2003,John Amaechi,C,32,UTA,50,474,37,118,0,0,37,118,25,52,99
2003,Chris Andersen,C,24,DEN,59,907,114,285,0,1,114,284,77,140,305
2003,Derek Anderson,PG,28,POR,76,2556,355,832,116,331,239,501,231,269,1057
2003,Kenny Anderson,PG,32,TOT,61,1135,163,382,1,7,162,375,45,57,372
2003,Kenny Anderson,PG,32,SEA,38,689,102,232,0,5,102,227,29,35,233
2003,Kenny Anderson,PG,32,NOH,23,446,61,150,1,2,60,148,16,22,139
2003,Shandon Anderson,SF,29,NYK,82,1731,248,537,52,140,196,397,139,190,687
2003,Robert Archibald,PF,22,MEM,12,72,6,20,0,0,6,20,7,18,19
2003,Gilbert Arenas,PG,21,GSW,82,2866,509,1180,109,313,400,867,370,468,1497
2003,Brandon Armstrong,SG,22,NJN,17,69,9,27,1,6,8,21,5,6,24
2003,Darrell Armstrong,PG,34,ORL,82,2350,263,643,78,232,185,411,165,188,769
2003,Carlos Arroyo,PG,23,UTA,44,287,50,109,3,7,47,102,18,22,121
2003,Chucky Atkins,PG,28,DET,65,1398,168,465,86,242,82,223,40,49,462
2003,Stacey Augmon,SG,34,NOH,70,862,79,192,0,7,79,185,54,72,212
2003,Dalibor Bagaric,C,22,CHI,10,76,8,26,0,0,8,26,3,4,19
2003,Vin Baker,C,31,BOS,52,942,99,207,0,4,99,203,72,107,270
2003,Brent Barry,SG,31,SEA,75,2480,264,577,118,293,146,284,128,161,774
2003,Jon Barry,SG,33,DET,80,1473,191,424,87,214,104,210,86,100,555
2003,Maceo Baston,PF,27,TOR,16,106,15,25,0,0,15,25,10,12,40
2003,Mengke Bateer,C,27,SAS,12,46,4,17,1,3,3,14,0,2,9
2003,Mike Batiste,PF,25,MEM,75,1248,197,467,18,81,179,386,69,88,481
2003,Tony Battie,C,26,BOS,67,1683,199,369,1,5,198,364,88,118,487
2003,Shane Battier,SF,24,MEM,78,2383,275,569,86,216,189,353,120,145,756
2003,Lonny Baxter,C,24,CHI,55,682,96,206,0,2,96,204,70,103,262
2003,Raja Bell,SG,26,DAL,75,1173,93,211,21,51,72,160,23,34,230
2003,Jonathan Bender,SF,22,IND,46,819,112,254,19,53,93,201,60,84,303
2003,Corey Benjamin,SG,24,ATL,9,152,13,43,2,13,11,30,12,16,40
2003,Travis Best,PG,30,MIA,72,1807,231,583,36,109,195,474,105,123,603
2003,Mike Bibby,PG,24,SAC,55,1835,329,700,56,137,273,563,161,187,875
2003,Chauncey Billups,PG,26,DET,74,2327,366,870,149,380,217,490,318,362,1199
2003,Corie Blount,C,34,CHI,50,836,65,134,0,0,65,134,20,35,150
2003,Mark Blount,C,27,TOT,81,1403,150,347,0,0,150,347,101,139,401
2003,Mark Blount,C,27,DEN,54,885,105,267,0,0,105,267,71,99,281
2003,Mark Blount,C,27,BOS,27,518,45,80,0,0,45,80,30,40,120
2003,Calvin Booth,C,26,SEA,47,575,52,119,0,2,52,117,34,47,138
2003,Carlos Boozer,PF,21,CLE,81,2049,331,618,0,1,331,617,148,192,810
2003,Ruben Boumtje-Boumtje,C,24,POR,2,5,0,1,0,0,0,1,0,0,0
2003,Bruce Bowen,SF,31,SAS,82,2566,223,479,101,229,122,250,36,89,583
2003,Ryan Bowen,SG,27,DEN,62,996,97,197,2,7,95,190,27,41,223
2003,Earl Boykins,PG,26,GSW,68,1321,199,464,29,77,170,387,173,200,600
2003,Michael Bradley,PF,23,TOR,67,1314,151,314,1,6,150,308,35,67,338
2003,Shawn Bradley,C,30,DAL,81,1731,201,375,0,1,201,374,141,175,543
2003,Elton Brand,PF,23,LAC,62,2454,451,899,0,1,451,898,244,356,1146
2003,J.R. Bremer,PG,22,BOS,64,1503,171,464,101,286,70,178,85,111,528
2003,Jamison Brewer,PG,22,IND,10,80,9,17,0,2,9,15,4,9,22
2003,Primoz Brezec,C,23,IND,22,111,15,38,0,1,15,37,12,20,42
2003,Damone Brown,PF,23,TOR,5,115,11,35,0,2,11,33,6,8,28
2003,Devin Brown,SG,24,TOT,10,93,12,35,0,1,12,34,6,8,30
2003,Devin Brown,SG,24,SAS,7,22,5,10,0,0,5,10,2,2,12
2003,Devin Brown,SG,24,DEN,3,71,7,25,0,1,7,24,4,6,18
2003,Kedrick Brown,SF,21,BOS,51,666,61,171,3,39,58,132,20,32,145
2003,Kwame Brown,C,20,WAS,80,1773,224,502,0,3,224,499,145,217,593
2003,P.J. Brown,PF,33,NOH,78,2609,319,601,0,3,319,598,194,232,832
2003,Randy Brown,PG,34,PHO,32,262,16,43,0,0,16,43,9,12,41
2003,Tierre Brown,PG,23,CLE,15,168,27,59,0,1,27,58,11,14,65
2003,Rick Brunson,PG,30,CHI,17,196,23,50,4,6,19,44,10,12,60
2003,Kobe Bryant,SG,24,LAL,82,3401,868,1924,124,324,744,1600,601,713,2461
2003,Mark Bryant,PF,37,TOT,16,100,5,19,0,0,5,19,3,4,13
2003,Mark Bryant,PF,37,PHI,11,77,5,17,0,0,5,17,2,2,12
2003,Mark Bryant,PF,37,DEN,3,14,0,1,0,0,0,1,1,2,1
2003,Mark Bryant,PF,37,BOS,2,9,0,1,0,0,0,1,0,0,0
2003,Greg Buckner,SG,26,PHI,75,1514,185,398,15,55,170,343,65,81,450
2003,Pat Burke,C,29,ORL,62,783,113,296,1,7,112,289,40,58,267
2003,Caron Butler,SF,22,MIA,78,2858,429,1032,34,107,395,925,309,375,1201
2003,Rasual Butler,SG,23,MIA,72,1514,207,572,50,171,157,401,76,104,540
2003,Jason Caffey,PF,29,MIL,51,894,113,248,0,0,113,248,69,106,295
2003,Marcus Camby,C,28,DEN,29,616,93,227,2,5,91,222,33,50,221
2003,Elden Campbell,C,34,TOT,56,869,117,295,0,1,117,294,109,136,343
2003,Elden Campbell,C,34,NOH,41,685,101,247,0,1,101,246,93,115,295
2003,Elden Campbell,C,34,SEA,15,184,16,48,0,0,16,48,16,21,48
2003,Brian Cardinal,PF,25,WAS,5,15,1,4,0,1,1,3,2,2,4
2003,Anthony Carter,PG,27,MIA,49,912,83,233,0,8,83,225,33,50,199
2003,Vince Carter,SG,26,TOR,43,1471,355,760,45,131,310,629,129,160,884
2003,Sam Cassell,PG,33,MIL,78,2700,546,1162,59,163,487,999,385,447,1536
2003,Kelvin Cato,C,28,HOU,73,1247,133,256,0,4,133,252,66,124,332
2003,Tyson Chandler,C,20,CHI,75,1827,257,484,0,0,257,484,177,291,691
2003,Calbert Cheaney,SG,31,UTA,81,2351,325,651,10,25,315,626,40,69,700
2003,Chris Childs,PG,35,NJN,12,106,6,20,1,6,5,14,2,3,15
2003,Doug Christie,SG,32,SAC,80,2710,267,557,73,185,194,372,141,174,748
2003,Keon Clark,C,27,SAC,80,1780,226,451,0,4,226,447,84,128,536
2003,Speedy Claxton,PG,24,SAS,30,471,67,145,0,11,67,134,39,57,173
2003,Mateen Cleaves,PG,25,SAC,12,55,6,23,1,1,5,22,3,4,16
2003,Derrick Coleman,C,35,PHI,64,1742,223,498,22,67,201,431,134,171,602
2003,Bimbo Coles,PG,34,TOT,35,691,56,168,7,32,49,136,35,42,154
2003,Bimbo Coles,PG,34,CLE,21,516,34,119,7,25,27,94,27,34,102
2003,Bimbo Coles,PG,34,BOS,14,175,22,49,0,7,22,42,8,8,52
2003,Jason Collier,C,25,HOU,13,104,17,36,0,0,17,36,2,2,36
2003,Jarron Collins,C,24,UTA,22,421,38,86,0,1,38,85,44,62,120
2003,Jason Collins,C,24,NJN,81,1900,140,338,0,4,140,334,180,236,460
2003,Chris Crawford,PF,27,ATL,5,38,8,13,1,3,7,10,7,8,24
2003,Jamal Crawford,PG,22,CHI,80,1992,334,808,86,242,248,566,104,129,858
2003,Austin Croshere,PF,27,IND,49,633,86,209,27,69,59,140,53,65,252
2003,John Crotty,PG,33,DEN,12,180,14,41,4,13,10,28,9,15,41
2003,Eddy Curry,C,20,CHI,81,1571,335,573,0,0,335,573,179,287,849
2003,Michael Curry,SF,34,DET,78,1555,92,229,16,54,76,175,36,45,236
2003,Erick Dampier,C,27,GSW,82,1978,259,522,0,2,259,520,155,222,673
2003,Antonio Daniels,SG,27,POR,67,872,84,186,18,59,66,127,65,76,251
2003,Antonio Davis,C,34,TOR,53,1894,261,641,0,0,261,641,216,280,738
2003,Baron Davis,PG,23,NOH,50,1889,332,798,99,283,233,515,93,131,856
2003,Dale Davis,C,33,POR,78,2282,237,438,0,0,237,438,105,166,579
2003,Emanual Davis,SG,34,ATL,24,340,32,88,7,29,25,59,17,22,88
2003,Hubert Davis,SG,32,DET,43,328,31,79,12,36,19,43,5,6,79
2003,Ricky Davis,SG,23,CLE,79,3131,602,1470,74,204,528,1266,348,465,1626
2003,Andrew DeClercq,C,29,ORL,77,1327,149,279,0,0,149,279,67,104,365
2003,Tony Delk,PG,29,BOS,67,1873,233,560,120,304,113,256,68,87,654
2003,Dan Dickau,PG,24,ATL,50,515,70,170,22,61,48,109,21,26,183
2003,Michael Dickerson,SG,27,MEM,6,87,10,24,4,11,6,13,5,5,29
2003,DeSagana Diop,PF,21,CLE,80,943,54,154,0,0,54,154,11,30,119
2003,Vlade Divac,C,34,SAC,80,2384,305,655,6,25,299,630,179,251,795
2003,Juan Dixon,PG,24,WAS,42,647,104,271,25,84,79,187,37,46,270
2003,Michael Doleac,C,25,NYK,75,1041,146,343,0,0,146,343,36,46,328
2003,Keyon Dooling,SG,22,LAC,55,969,128,329,50,139,78,190,44,57,350
2003,Bryce Drew,PG,28,NOH,13,79,8,27,3,7,5,20,0,0,19
2003,Predrag Drobnjak,C,27,SEA,82,1984,325,789,30,85,295,704,91,115,771
2003,Chris Dudley,C,37,POR,3,11,0,1,0,0,0,1,0,0,0
2003,Tim Duncan,PF,26,SAS,81,3181,714,1392,6,22,708,1370,450,634,1884
2003,Mike Dunleavy,SF,22,GSW,82,1305,168,417,52,150,116,267,78,100,466
2003,Howard Eisley,PG,30,NYK,82,2243,262,628,131,337,131,291,89,105,744
2003,LaPhonso Ellis,PF,32,MIA,55,784,100,262,27,107,73,155,50,66,277
2003,Melvin Ely,C,24,LAC,52,802,92,186,0,0,92,186,52,74,236
2003,Evan Eschmeyer,C,27,DAL,17,135,7,19,0,0,7,19,3,4,17
2003,Reggie Evans,PF,22,SEA,67,1365,66,140,0,0,66,140,80,154,212
2003,Danny Ferry,SF,36,SAS,64,601,44,124,21,60,23,64,10,13,119
2003,Michael Finley,SF,29,DAL,69,2642,507,1193,119,322,388,871,198,230,1331
2003,Derek Fisher,PG,28,LAL,82,2829,339,775,85,212,254,563,100,125,863
2003,Marcus Fizer,PF,24,CHI,38,809,178,383,1,6,177,377,88,134,445
2003,Alton Ford,PF,21,PHO,11,31,3,9,0,0,3,9,1,3,7
2003,Joseph Forte,SG,21,SEA,17,86,10,35,0,3,10,32,4,6,24
2003,Danny Fortson,PF,26,GSW,17,223,20,54,0,1,20,53,19,29,59
2003,Greg Foster,C,34,TOR,29,539,47,122,1,4,46,118,26,32,121
2003,Jeff Foster,C,26,IND,77,802,64,178,0,2,64,176,34,63,162
2003,Tremaine Fowlkes,SF,26,LAC,37,573,56,128,2,9,54,119,50,59,164
2003,Rick Fox,SF,33,LAL,76,2181,262,621,105,280,157,341,52,69,681
2003,Adonal Foyle,C,27,GSW,82,1787,185,345,0,1,185,344,70,104,440
2003,Steve Francis,PG,25,HOU,81,3318,571,1312,85,240,486,1072,476,595,1703
2003,Lawrence Funderburke,PF,32,SAC,27,229,32,72,0,0,32,72,10,17,74
2003,Dan Gadzuric,C,24,MIL,49,760,70,145,0,1,70,144,29,56,169
2003,Kevin Garnett,PF,26,MIN,82,3321,743,1481,20,71,723,1410,377,502,1883
2003,Pat Garrity,PF,26,ORL,81,2584,312,744,161,407,151,337,83,100,868
2003,Pau Gasol,PF,22,MEM,82,2948,569,1116,1,10,568,1106,416,565,1555
2003,Devean George,SF,25,LAL,71,1613,180,461,49,132,131,329,83,105,492
2003,Kendall Gill,SG,34,MIN,82,2068,286,677,19,59,267,618,123,161,714
2003,Manu Ginobili,SG,25,SAS,69,1431,174,397,51,148,123,249,126,171,525
2003,Gordan Giricek,SG-SF,25,TOT,76,2148,350,803,85,249,265,554,150,183,935
2003,Gordan Giricek,SG,25,MEM,49,1187,207,478,46,130,161,348,88,107,548
2003,Gordan Giricek,SF,25,ORL,27,961,143,325,39,119,104,206,62,76,387
2003,Dion Glover,SG,24,ATL,76,1890,277,648,56,158,221,490,127,162,737
2003,Anthony Goldwire,PG,31,TOT,15,85,9,25,3,9,6,16,4,7,25
2003,Anthony Goldwire,PG,31,SAS,10,51,5,18,2,8,3,10,0,2,12
2003,Anthony Goldwire,PG,31,WAS,5,34,4,7,1,1,3,6,4,5,13
2003,Drew Gooden,SF-PF,21,TOT,70,1873,355,777,14,48,341,729,151,212,875
2003,Drew Gooden,SF,21,MEM,51,1329,255,576,14,46,241,530,92,132,616
2003,Drew Gooden,PF,21,ORL,19,544,100,201,0,2,100,199,59,80,259
2003,Brian Grant,C,30,MIA,82,2641,344,676,0,0,344,676,158,205,846
2003,Horace Grant,PF,37,ORL,5,85,13,25,0,0,13,25,0,0,26
2003,Adrian Griffin,SG,28,DAL,74,1373,146,337,6,24,140,313,27,32,325
2003,Eddie Griffin,PF,20,HOU,77,1890,271,678,64,192,207,486,58,94,664
2003,Tom Gugliotta,PF,33,PHO,27,447,60,132,0,1,60,131,9,9,129
2003,A.J. Guyton,PG,24,GSW,2,9,0,4,0,1,0,3,0,0,0
2003,Marcus Haislip,PF,22,MIL,39,441,66,153,3,12,63,141,26,38,161
2003,Darvin Ham,SG,29,ATL,75,926,71,159,0,3,71,156,38,79,180
2003,Richard Hamilton,SG,24,DET,82,2640,570,1286,32,119,538,1167,440,528,1612
2003,Zendon Hamilton,C,27,TOR,3,12,2,5,0,0,2,5,2,2,6
2003,Anfernee Hardaway,SG,31,PHO,58,1777,256,573,26,73,230,500,77,97,615
2003,Tim Hardaway,PG,36,IND,10,127,18,49,11,31,7,18,2,4,49
2003,Matt Harpring,SF,26,UTA,78,2557,521,1020,66,160,455,860,262,331,1370
2003,Adam Harrington,SG,22,TOT,19,111,11,37,5,14,6,23,3,4,30
2003,Adam Harrington,SG,22,DAL,13,37,4,17,1,3,3,14,2,2,11
2003,Adam Harrington,SG,22,DEN,6,74,7,20,4,11,3,9,1,2,19
2003,Al Harrington,SF,22,IND,82,2467,389,896,13,46,376,850,211,274,1002
2003,Junior Harrington,PG,22,DEN,82,2003,169,467,7,28,162,439,73,112,418
2003,Othella Harrington,PF,29,NYK,74,1850,225,443,0,0,225,443,123,150,573
2003,Lucious Harris,SG,32,NJN,77,1973,298,721,47,136,251,585,152,189,795
2003,Antonio Harvey,PF,32,ATL,4,32,2,5,0,0,2,5,0,0,4
2003,Donnell Harvey,SF,22,DEN,77,1613,246,551,1,7,245,544,118,176,611
2003,Trenton Hassell,SG,23,CHI,82,1999,144,392,13,40,131,352,41,55,342
2003,Kirk Haston,SF,23,NOH,12,57,2,17,0,3,2,14,2,4,6
2003,Juaquin Hawkins,SG,29,HOU,58,685,57,148,10,24,47,124,10,20,134
2003,Brendan Haywood,C,23,WAS,81,1930,173,339,0,0,173,339,155,245,501
2003,Alan Henderson,C,30,ATL,82,1494,153,327,0,2,153,325,88,138,394
2003,Nene Hilario,C,20,DEN,80,2258,321,619,0,3,321,616,197,341,839
2003,Grant Hill,SF,30,ORL,29,843,151,307,1,4,150,303,118,144,421
2003,Tyrone Hill,PF,34,TOT,56,1351,129,306,0,0,129,306,54,80,312
2003,Tyrone Hill,PF,34,CLE,32,855,85,197,0,0,85,197,33,45,203
2003,Tyrone Hill,PF,34,PHI,24,496,44,109,0,0,44,109,21,35,109
2003,Fred Hoiberg,SG,30,CHI,63,784,49,126,5,21,44,105,41,50,144
2003,Robert Horry,PF,32,LAL,80,2343,184,476,51,177,133,299,103,134,522
2003,Eddie House,SG,24,MIA,55,1025,172,444,36,120,136,324,31,36,411
2003,Allan Houston,SG,31,NYK,82,3108,652,1465,178,450,474,1015,363,395,1845
2003,Juwan Howard,PF,29,DEN,77,2730,567,1261,2,4,565,1257,282,351,1418
2003,Troy Hudson,PG,26,MIN,79,2600,409,956,97,266,312,690,208,231,1123
2003,Nate Huffman,C,27,TOR,7,76,9,25,0,0,9,25,5,8,23
2003,Larry Hughes,PG,24,WAS,67,2137,346,741,29,79,317,662,136,186,857
2003,Ryan Humphrey,PF,23,TOT,48,444,35,120,0,0,35,120,23,39,93
2003,Ryan Humphrey,PF,23,ORL,35,322,23,85,0,0,23,85,18,28,64
2003,Ryan Humphrey,PF,23,MEM,13,122,12,35,0,0,12,35,5,11,29
2003,Lindsey Hunter,PG,32,TOR,29,673,106,302,34,107,72,195,34,47,280
2003,Steven Hunter,C,21,ORL,33,447,56,103,0,0,56,103,18,44,130
2003,Zydrunas Ilgauskas,C,27,CLE,81,2432,495,1122,0,5,495,1117,400,512,1390
2003,Allen Iverson*,SG,27,PHI,82,3485,804,1940,84,303,720,1637,570,736,2262
2003,Bobby Jackson,PG,29,SAC,59,1676,340,732,89,235,251,497,126,149,895
2003,Jermaine Jackson,SG,26,TOT,53,559,40,110,1,10,39,100,40,55,121
2003,Jermaine Jackson,SG,26,TOR,24,286,21,68,1,9,20,59,23,27,66
2003,Jermaine Jackson,SG,26,ATL,29,273,19,42,0,1,19,41,17,28,55
2003,Jim Jackson,SF,32,SAC,63,1309,204,462,32,71,172,391,47,55,487
2003,Marc Jackson,C,28,MIN,77,1041,153,349,1,1,152,348,114,149,421
2003,Mark Jackson,PG,37,UTA,82,1467,147,369,27,95,120,274,61,80,382
2003,Stephen Jackson,SG,24,SAS,80,2254,356,818,95,297,261,521,139,183,946
2003,Casey Jacobsen,SF,21,PHO,72,1147,122,327,52,165,70,162,72,105,368
2003,Jerome James,C,27,SEA,51,766,111,232,0,0,111,232,54,92,276
2003,Mike James,PG,27,MIA,78,1722,218,585,67,228,151,357,104,142,607
2003,Antawn Jamison,SF,26,GSW,82,3226,691,1471,65,209,626,1262,375,475,1822
2003,Marko Jaric,SF,24,LAC,66,1379,179,446,53,166,126,280,79,105,490
2003,Chris Jefferies,SF,22,TOR,51,666,75,194,18,54,57,140,29,43,197
2003,Richard Jefferson,SF,22,NJN,80,2879,456,911,6,24,450,887,324,436,1242
2003,Jared Jeffries,SF,21,WAS,20,292,30,63,3,6,27,57,16,29,79
2003,Anthony Johnson,PG,28,NJN,66,842,103,231,13,35,90,196,51,74,270
2003,Avery Johnson,PG,37,DAL,48,430,63,150,0,2,63,148,30,39,156
2003,Ervin Johnson,C,35,MIL,69,1170,61,135,0,0,61,135,30,44,152
2003,Joe Johnson,SG,21,PHO,82,2255,316,796,75,205,241,591,96,124,803
2003,Ken Johnson,C,24,MIA,16,156,15,37,0,0,15,37,2,6,32
2003,Damon Jones,PG,26,SAC,49,709,80,210,44,121,36,89,20,27,224
2003,Eddie Jones,SG,31,MIA,47,1789,291,688,98,241,193,447,189,230,869
2003,Fred Jones,SG,23,IND,19,115,9,24,2,7,7,17,3,4,23
2003,Jumaine Jones,SF,23,CLE,80,2204,308,710,111,314,197,396,57,83,784
2003,Popeye Jones,PF,32,DAL,26,222,24,62,0,0,24,62,5,11,53
2003,Michael Jordan*,SF,39,WAS,82,3031,679,1527,16,55,663,1472,266,324,1640
2003,Shawn Kemp,C,33,ORL,79,1633,211,505,0,1,211,504,115,155,537
2003,Steve Kerr,PG,37,SAS,75,952,110,256,49,124,61,132,30,34,299
2003,Jason Kidd,PG,29,NJN,80,2989,515,1244,126,370,389,874,339,403,1495
2003,Andrei Kirilenko,SF,21,UTA,80,2213,315,642,37,114,278,528,296,370,963
2003,Kerry Kittles,SG,28,NJN,65,1951,332,711,78,219,254,492,106,135,848
2003,Brevin Knight,PG,27,MEM,55,928,97,228,2,8,95,220,20,37,216
2003,Travis Knight,C,28,NYK,32,287,25,65,0,1,25,64,10,13,60
2003,Toni Kukoc,PF,34,MIL,63,1704,249,577,95,263,154,314,137,194,730
2003,Christian Laettner,PF,33,WAS,76,2215,255,516,2,16,253,500,120,144,632
2003,Raef LaFrentz,C,26,DAL,69,1611,266,514,47,116,219,398,60,88,639
2003,Sean Lampley,SF,23,MIA,35,487,56,129,0,4,56,125,57,82,169
2003,Dan Langhi,SF,25,PHO,60,541,81,202,9,31,72,171,12,20,183
2003,Voshon Lenard,SG,29,TOR,63,1929,325,809,92,252,233,557,156,194,898
2003,Rashard Lewis,SF,23,SEA,77,3044,519,1149,75,217,444,932,283,345,1396
2003,Randy Livingston,PG,27,NOH,2,12,2,4,0,0,2,4,2,2,6
2003,Art Long,SF,30,TOT,26,211,28,75,2,3,26,72,2,10,60
2003,Art Long,SF,30,PHI,19,131,19,50,1,1,18,49,1,5,40
2003,Art Long,SF,30,TOR,7,80,9,25,1,2,8,23,1,5,20
2003,Grant Long,PF,36,BOS,41,488,27,70,0,3,27,67,18,23,72
2003,Tyronn Lue,PG,25,WAS,75,1986,248,573,60,176,188,397,91,104,647
2003,George Lynch,SG,32,NOH,81,1497,147,359,28,79,119,280,41,74,363
2003,Todd MacCulloch,C,27,PHI,42,812,123,238,0,0,123,238,53,79,299
2003,Tito Maddox,SG,21,HOU,9,35,3,12,0,3,3,9,5,8,11
2003,Mark Madsen,PF,27,LAL,54,781,69,163,0,0,69,163,36,61,174
2003,Corey Maggette,SG,23,LAC,64,2006,343,773,62,177,281,596,325,405,1073
2003,Jamaal Magloire,C,24,NOH,82,2443,305,635,0,3,305,632,231,322,841
2003,Karl Malone*,PF,39,UTA,81,2936,595,1289,3,14,592,1275,474,621,1667
2003,Matt Maloney,PG,31,ATL,14,103,8,25,5,15,3,10,3,5,24
2003,Danny Manning,PF,36,DET,13,89,13,32,3,8,10,24,5,6,34
2003,Stephon Marbury,PG,25,PHO,81,3240,671,1530,89,296,582,1234,375,467,1806
2003,Shawn Marion,SF,24,PHO,81,3373,662,1466,141,364,521,1102,251,295,1716
2003,Sean Marks,PF,27,MIA,23,223,22,59,0,1,22,58,10,15,54
2003,Donny Marshall,SF,30,NJN,3,6,0,3,0,1,0,2,0,0,0
2003,Donyell Marshall,PF,29,CHI,78,2378,421,918,33,87,388,831,167,221,1042
2003,Kenyon Martin,PF,25,NJN,77,2628,509,1082,9,43,500,1039,256,392,1283
2003,Jamal Mashburn,SF,30,NOH,82,3321,670,1586,119,306,551,1280,313,369,1772
2003,Anthony Mason,C,36,MIL,65,2119,191,393,0,1,191,392,84,117,466
2003,Desmond Mason,SF,25,TOT,80,2763,457,1017,21,72,436,945,212,283,1147
2003,Desmond Mason,SF,25,SEA,52,1811,291,667,16,55,275,612,134,181,732
2003,Desmond Mason,SF,25,MIL,28,952,166,350,5,17,161,333,78,102,415
2003,Roger Mason,SF,22,CHI,17,113,11,31,6,18,5,13,2,2,30
2003,Tony Massenburg,C,35,UTA,58,792,104,232,0,0,104,232,65,84,273
2003,Walter McCarty,SF,28,BOS,82,1949,173,418,91,248,82,170,61,98,498
2003,Amal McCaskill,C,29,ATL,11,70,4,17,0,0,4,17,3,4,11
2003,Jelani McCoy,C,25,TOR,67,1367,194,395,0,0,194,395,69,126,457
2003,Tracy McGrady,SG,23,ORL,75,2954,829,1813,173,448,656,1365,576,726,2407
2003,Jeff McInnis,PG,28,POR,75,1311,188,423,6,35,182,388,50,67,432
2003,Aaron McKie,SF,30,PHI,80,2374,286,666,37,112,249,554,112,134,721
2003,Stanislav Medvedenko,PF,23,LAL,58,620,112,258,0,2,112,256,31,43,255
2003,Ron Mercer,SG,26,IND,72,1671,244,597,3,16,241,581,65,81,556
2003,Chris Mihm,C,23,CLE,52,809,116,287,0,3,116,284,76,105,308
2003,Darius Miles,SF,21,CLE,67,2008,263,642,0,14,263,628,92,155,618
2003,Andre Miller,PG,26,LAC,80,2913,377,928,23,108,354,820,311,391,1088
2003,Brad Miller,C,26,IND,73,2270,329,667,5,16,324,651,292,357,955
2003,Mike Miller,SF,22,TOT,65,2186,373,859,109,300,264,559,156,186,1011
2003,Mike Miller,SF,22,ORL,49,1826,296,708,87,256,209,452,127,150,806
2003,Mike Miller,SF,22,MEM,16,360,77,151,22,44,55,107,29,36,205
2003,Reggie Miller*,SG,37,IND,70,2117,281,637,113,318,168,319,207,230,882
2003,Chris Mills,PF,33,GSW,21,262,39,106,7,25,32,81,16,18,101
2003,Yao Ming*,C,22,HOU,82,2382,401,805,1,2,400,803,301,371,1104
2003,Cuttino Mobley,SG,27,HOU,73,3044,463,1067,112,318,351,749,242,282,1280
2003,Nazr Mohammed,C,25,ATL,35,445,67,159,0,0,67,159,26,41,160
2003,Jerome Moiso,C,24,NOH,51,644,89,171,0,0,89,171,27,41,205
2003,Mikki Moore,C,27,TOT,8,43,5,13,0,0,5,13,8,10,18
2003,Mikki Moore,C,27,BOS,3,12,0,1,0,0,0,1,0,0,0
2003,Mikki Moore,C,27,ATL,5,31,5,12,0,0,5,12,8,10,18
2003,Terence Morris,SF,24,HOU,49,632,82,176,7,32,75,144,11,14,182
2003,Troy Murphy,PF,22,GSW,79,2510,338,749,3,14,335,735,244,290,923
2003,Ronald Murray,SG,23,TOT,14,62,11,31,0,5,11,26,5,8,27
2003,Ronald Murray,SG,23,MIL,12,42,9,26,0,4,9,22,5,8,23
2003,Ronald Murray,SG,23,SEA,2,20,2,5,0,1,2,4,0,0,4
2003,Tracy Murray,SF,31,LAL,31,193,23,71,8,38,15,33,7,9,61
2003,Dikembe Mutombo*,C,36,NJN,24,514,49,131,0,0,49,131,40,55,138
2003,Mamadou N'Diaye,C,27,TOR,22,364,43,96,0,0,43,96,34,47,120
2003,Bostjan Nachbar,SF,22,HOU,14,77,11,31,2,10,9,21,5,10,29
2003,Lee Nailon,SF,27,NYK,38,405,84,190,0,1,84,189,42,51,210
2003,Eduardo Najera,SF,26,DAL,48,1103,129,231,0,1,129,230,62,91,320
2003,Steve Nash,PG,28,DAL,82,2711,518,1114,111,269,407,845,308,339,1455
2003,Rasho Nesterovic,C,26,MIN,77,2337,400,762,0,2,400,760,61,95,861
2003,Ira Newble,SF,28,ATL,73,1931,231,467,32,84,199,383,70,90,564
2003,Moochie Norris,PG,29,HOU,82,1375,134,330,11,45,123,285,78,114,357
2003,Dirk Nowitzki,PF,24,DAL,80,3117,690,1489,148,390,542,1099,483,548,2011
2003,Jermaine O'Neal,PF,24,IND,77,2864,610,1260,7,21,603,1239,373,510,1600
2003,Shaquille O'Neal*,C,30,LAL,67,2535,695,1211,0,0,695,1211,451,725,1841
2003,Charles Oakley,C,39,WAS,42,514,23,55,0,0,23,55,28,34,74
2003,Lamar Odom,SF,23,LAC,49,1679,268,611,42,129,226,482,136,175,714
2003,Mehmet Okur,PF,23,DET,72,1366,180,423,38,112,142,311,96,131,494
2003,Dean Oliver,PG,24,GSW,15,93,7,29,1,6,6,23,7,8,22
2003,Kevin Ollie,PG,30,TOT,82,1897,199,441,2,6,197,435,134,178,534
2003,Kevin Ollie,PG,30,MIL,53,1127,117,255,1,5,116,250,68,91,303
2003,Kevin Ollie,PG,30,SEA,29,770,82,186,1,1,81,185,66,87,231
2003,Michael Olowokandi,C,27,LAC,36,1369,186,436,0,0,186,436,69,105,441
2003,Greg Ostertag,C,29,UTA,81,1926,169,326,0,0,169,326,100,196,438
2003,Bo Outlaw,C,31,PHO,80,1800,153,278,0,2,153,276,72,116,378
2003,Chris Owens,SF,23,MEM,1,6,2,3,0,0,2,3,0,0,4
2003,Olumide Oyedeji,C,21,ORL,27,145,10,23,0,0,10,23,7,11,27
2003,Robert Pack,PG,33,NOH,28,440,52,129,0,5,52,124,41,55,145
2003,Scott Padgett,PF,26,UTA,82,1321,170,423,45,133,125,290,81,107,466
2003,Milt Palacio,PG,24,CLE,80,1976,162,388,8,37,154,351,65,87,397
2003,Jannero Pargo,PG,23,LAL,34,342,37,93,7,24,30,69,4,4,85
2003,Smush Parker,PG,21,CLE,66,1103,136,338,38,118,98,220,98,118,408
2003,Tony Parker,PG,20,SAS,82,2774,484,1043,82,243,402,800,219,290,1269
2003,Cherokee Parks,PF,30,LAC,30,648,82,163,1,2,81,161,23,38,188
2003,Ruben Patterson,SF,27,POR,78,1655,254,516,3,20,251,496,138,220,649
2003,Gary Payton*,PG,34,TOT,80,3208,665,1466,54,182,611,1284,250,352,1634
2003,Gary Payton*,PG,34,SEA,52,2123,444,992,34,114,410,878,162,234,1084
2003,Gary Payton*,PG,34,MIL,28,1085,221,474,20,68,201,406,88,118,550
2003,Anthony Peeler,SG,33,MIN,82,2245,252,609,87,212,165,397,39,50,630
2003,Wesley Person,SG,31,MEM,66,1941,274,601,100,231,174,370,79,97,727
2003,Morris Peterson,SF,25,TOR,82,2949,421,1073,116,344,305,729,195,247,1153
2003,Eric Piatkowski,SG,32,LAC,62,1360,210,446,80,201,130,245,101,122,601
2003,Paul Pierce,SG,25,BOS,79,3096,663,1592,118,391,545,1201,604,753,2048
2003,Scottie Pippen*,SF,37,POR,64,1911,265,597,38,133,227,464,121,148,689
2003,Scot Pollard,C,27,SAC,23,325,40,87,0,0,40,87,23,38,103
2003,James Posey,SF,26,TOT,83,2518,309,752,70,229,239,523,205,246,893
2003,James Posey,SF,26,DEN,25,872,121,324,24,88,97,236,86,102,352
2003,James Posey,SF,26,HOU,58,1646,188,428,46,141,142,287,119,144,541
2003,Lavor Postell,SG,24,NYK,12,98,14,38,2,7,12,31,13,15,43
2003,Vitaly Potapenko,C,27,SEA,26,403,41,93,0,0,41,93,22,29,104
2003,Tayshaun Prince,SF,22,DET,42,435,53,118,20,47,33,71,11,17,137
2003,Joel Przybilla,C,23,MIL,32,546,18,46,0,0,18,46,12,24,48
2003,Vladimir Radmanovic,PF,22,SEA,72,1910,274,668,104,293,170,375,72,102,724
2003,Igor Rakocevic,PG,24,MIN,42,244,22,58,5,12,17,46,29,36,78
2003,Zach Randolph,PF,21,POR,77,1301,264,515,0,5,264,510,122,161,650
2003,Theo Ratliff,C,29,ATL,81,2518,276,595,0,0,276,595,154,214,706
2003,Zeljko Rebraca,C,30,DET,30,488,80,145,0,0,80,145,38,48,198
2003,Michael Redd,SG,23,MIL,82,2316,455,971,182,416,273,555,149,185,1241
2003,Don Reid,PF,29,DET,1,10,0,3,0,0,0,3,1,2,1
2003,Efthimi Rentzias,C,27,PHI,35,144,20,59,4,8,16,51,8,9,52
2003,Glen Rice,SF,35,HOU,62,1532,196,457,101,254,95,203,63,83,556
2003,Jason Richardson,SG,22,GSW,82,2698,476,1161,123,334,353,827,207,271,1282
2003,Quentin Richardson,SG,22,LAC,59,1368,203,546,61,198,142,348,85,124,552
2003,Antoine Rigaudeau,SG,31,DAL,11,91,8,35,1,5,7,30,0,0,17
2003,Clifford Robinson,PF,36,DET,81,2825,372,935,87,259,285,676,161,238,992
2003,David Robinson*,C,37,SAS,64,1676,197,420,0,0,197,420,152,214,546
2003,Eddie Robinson,SF,26,CHI,64,1355,155,315,3,14,152,301,51,63,364
2003,Glenn Robinson,SF,30,ATL,69,2591,539,1248,90,263,449,985,268,306,1436
2003,Rodney Rogers,PF,31,NJN,68,1303,183,455,44,132,139,323,68,90,478
2003,Sean Rooks,C,33,LAC,70,1344,125,297,0,1,125,296,47,58,297
2003,Jalen Rose,SF,30,CHI,82,3351,642,1583,133,359,509,1224,399,467,1816
2003,Malik Rose,PF,28,SAS,79,1933,289,630,2,5,287,625,242,306,822
2003,Guy Rucker,PF,25,GSW,3,4,0,0,0,0,0,0,0,0,0
2003,Kareem Rush,PG,22,LAL,76,872,96,244,19,68,77,176,16,23,227
2003,Bryon Russell,SF,32,WAS,70,1388,108,306,46,140,62,166,53,69,315
2003,Arvydas Sabonis*,C,38,POR,78,1209,172,361,3,6,169,355,129,164,476
2003,John Salmons,PG,23,PHI,64,504,48,116,10,31,38,85,26,35,132
2003,Soumaila Samake,C,24,LAL,13,77,10,24,0,0,10,24,2,2,22
2003,Jamal Sampson,PF,19,MIL,5,8,0,2,0,0,0,2,0,0,0
2003,Pepe Sanchez,PG,25,DET,9,37,0,5,0,0,0,5,0,0,0
2003,Jeryl Sasser,SG,23,ORL,75,1025,64,207,13,44,51,163,53,78,194
2003,Kenny Satterfield,PG,21,TOT,39,502,55,183,5,28,50,155,17,25,132
2003,Kenny Satterfield,PG,21,DEN,22,420,51,165,5,28,46,137,16,23,123
2003,Kenny Satterfield,PG,21,PHI,17,82,4,18,0,0,4,18,1,2,9
2003,Predrag Savovic,SG,26,DEN,27,256,29,93,4,26,25,67,21,29,83
2003,Brian Scalabrine,PF,24,NJN,59,724,68,169,14,39,54,130,30,36,180
2003,Ansu Sesay,SF,26,SEA,45,448,41,107,0,0,41,107,12,21,94
2003,Brian Shaw,PG,36,LAL,72,900,101,261,38,109,63,152,10,15,250
2003,Paul Shirley,PF,25,ATL,2,5,0,4,0,0,0,4,0,0,0
2003,Bobby Simmons,SG,22,WAS,36,378,44,112,0,5,44,107,32,35,120
2003,Brian Skinner,PF,26,PHI,77,1381,182,331,0,0,182,331,97,161,461
2003,Reggie Slater,PF,32,MIN,26,141,27,50,0,0,27,50,27,45,81
2003,Tamar Slay,SG,22,NJN,36,274,39,103,7,25,32,78,7,10,92
2003,Charles Smith,SG,27,POR,3,13,1,4,0,1,1,3,3,4,5
2003,Joe Smith,SF,27,MIN,54,1117,151,328,0,2,151,326,102,131,404
2003,Steve Smith,SG,33,SAS,53,1032,113,291,39,118,74,173,95,114,360
2003,Eric Snow,PG,29,PHI,82,3108,361,799,7,32,354,767,325,379,1054
2003,Latrell Sprewell,SF,32,NYK,74,2859,454,1127,134,360,320,767,173,218,1215
2003,Jerry Stackhouse,SG,28,WAS,70,2747,491,1201,71,245,420,956,455,518,1508
2003,Vladimir Stepania,C,26,MIA,79,1594,185,427,0,0,185,427,71,134,441
2003,DeShawn Stevenson,SG,21,UTA,61,760,114,284,4,12,110,272,47,68,279
2003,Michael Stewart,PF,27,CLE,47,251,14,37,0,0,14,37,8,12,36
2003,John Stockton*,PG,40,UTA,82,2275,309,640,29,80,280,560,237,287,884
2003,Peja Stojakovic,SF,25,SAC,72,2450,497,1034,155,406,342,628,231,264,1380
2003,Damon Stoudamire,PG,29,POR,59,1315,156,415,44,114,112,301,53,67,409
2003,Amar'e Stoudemire,PF,20,PHO,82,2570,392,830,2,10,390,820,320,484,1106
2003,Erick Strickland,SG,29,IND,71,1275,163,380,62,160,101,220,70,87,458
2003,Mark Strickland,SF,32,DAL,4,13,2,5,0,0,2,5,0,0,4
2003,Rod Strickland,PG,36,MIN,47,956,120,278,1,11,119,267,79,107,320
2003,Bruno Sundov,C,22,BOS,26,138,14,56,4,16,10,40,0,2,32
2003,Bob Sura,SG,29,GSW,55,1130,135,328,28,85,107,243,103,148,401
2003,Stromile Swift,PF,23,MEM,67,1478,235,489,0,2,235,487,177,245,647
2003,Wally Szczerbiak,SF,25,MIN,52,1836,351,729,61,145,290,584,150,173,913
2003,Maurice Taylor,PF,26,HOU,67,1377,231,535,0,2,231,533,100,138,562
2003,Jason Terry,PG,25,ATL,81,3081,488,1141,160,431,328,710,259,292,1395
2003,Etan Thomas,PF,24,WAS,38,513,61,124,0,0,61,124,60,94,182
2003,Kenny Thomas,PF,25,TOT,66,1978,260,559,0,0,260,559,147,197,667
2003,Kenny Thomas,PF,25,HOU,20,586,82,190,0,0,82,190,33,45,197
2003,Kenny Thomas,PF,25,PHI,46,1392,178,369,0,0,178,369,114,152,470
2003,Kurt Thomas,C,30,NYK,81,2577,497,1028,2,3,495,1025,138,184,1134
2003,Tim Thomas,SF,25,MIL,80,2358,412,930,97,265,315,665,145,186,1066
2003,Jamaal Tinsley,PG,24,IND,73,2237,220,556,46,166,174,390,80,112,566
2003,Oscar Torres,SG,26,GSW,17,109,16,36,7,13,9,23,14,20,53
2003,Robert Traylor,C,25,NOH,69,851,105,237,1,3,104,234,57,88,268
2003,Gary Trent,SF,28,MIN,80,1222,208,389,0,2,208,387,60,101,476
2003,Jeff Trepagnier,SG,23,DEN,8,97,17,40,4,8,13,32,7,7,45
2003,Cezary Trybanski,C,23,MEM,15,86,5,20,0,0,5,20,4,10,14
2003,Jake Tsakalidis,C,23,PHO,33,543,61,135,0,0,61,135,39,58,161
2003,Nikoloz Tskitishvili,SF,19,DEN,81,1320,115,393,37,152,78,241,48,65,315
2003,Hedo Turkoglu,SF,23,SAC,67,1175,165,391,29,78,136,313,88,110,447
2003,Nick Van,SG,31,DAL,73,2026,342,831,118,312,224,519,110,144,912
2003,Keith Van,PF,27,PHI,74,2337,459,952,65,176,394,776,193,240,1176
2003,Jacque Vaughn,PG,27,ORL,80,1686,184,411,8,34,176,377,97,125,473
2003,Jake Voskuhl,C,25,PHO,65,947,92,163,0,0,92,163,64,96,248
2003,Dajuan Wagner,SG,19,CLE,47,1385,223,605,55,174,168,431,128,160,629
2003,Antoine Walker,PF,26,BOS,78,3235,603,1554,188,582,415,972,176,286,1570
2003,Samaki Walker,C,26,LAL,67,1243,115,274,0,1,115,273,66,101,296
2003,Ben Wallace,C,28,DET,73,2873,210,437,1,6,209,431,85,189,506
2003,Gerald Wallace,SF,20,SAC,47,571,90,183,1,4,89,179,39,74,220
2003,Rasheed Wallace,PF,28,POR,74,2684,515,1094,110,307,405,787,200,272,1340
2003,Charlie Ward,PG,32,NYK,66,1465,165,414,101,267,64,147,41,53,472
2003,Earl Watson,PG,23,MEM,79,1366,170,391,31,91,139,300,62,86,433
2003,Clarence Weatherspoon,PF,32,NYK,79,2024,186,414,0,0,186,414,149,194,521
2003,Chris Webber,PF,29,SAC,67,2622,661,1433,5,21,656,1412,215,354,1542
2003,Bonzi Wells,SG,26,POR,75,2396,437,990,38,130,399,860,226,313,1138
2003,Jiri Welsch,SF,23,GSW,37,234,19,75,1,4,18,71,22,29,61
2003,David Wesley,SG,32,NOH,73,2710,449,1037,134,316,315,721,185,237,1217
2003,Jahidi White,C,26,WAS,16,230,25,53,0,0,25,53,17,25,67
2003,Rodney White,SG,22,DEN,72,1563,260,638,32,134,228,504,98,125,650
2003,Chris Whitney,PG,31,TOT,51,1052,124,349,50,164,74,185,57,69,355
2003,Chris Whitney,PG,31,DEN,29,762,94,261,43,128,51,133,46,57,277
2003,Chris Whitney,PG,31,ORL,22,290,30,88,7,36,23,52,11,12,78
2003,Chris Wilcox,PF,20,LAC,46,479,73,140,0,0,73,140,25,50,171
2003,Mike Wilks,PG-SG,23,TOT,46,688,50,148,10,35,40,113,37,47,147
2003,Mike Wilks,SG,23,ATL,15,364,29,81,6,17,23,64,21,29,85
2003,Mike Wilks,PG,23,MIN,31,324,21,67,4,18,17,49,16,18,62
2003,Aaron Williams,C,31,NJN,81,1597,199,439,0,1,199,438,102,130,500
2003,Alvin Williams,PG,28,TOR,78,2638,396,905,48,146,348,759,187,239,1027
2003,Brandon Williams,SF,27,ATL,6,19,1,7,0,1,1,6,0,0,2
2003,Eric Williams,SF,30,BOS,82,2350,254,575,37,110,217,465,201,268,746
2003,Frank Williams,PG,22,NYK,21,167,9,33,6,16,3,17,4,6,28
2003,Jason Williams,PG,27,MEM,76,2407,333,859,143,404,190,455,110,131,919
2003,Jay Williams,PG,21,CHI,75,1961,273,685,65,202,208,483,103,161,714
2003,Jerome Williams,PF,29,TOR,71,2346,267,535,1,6,266,529,156,281,691
2003,Monty Williams,SF,31,PHI,21,276,34,80,0,2,34,78,24,32,92
2003,Scott Williams,C,34,PHO,69,872,120,292,0,2,120,290,33,42,273
2003,Shammond Williams,PG,27,TOT,78,1881,228,579,93,261,135,318,78,102,627
2003,Shammond Williams,PG,27,BOS,51,1169,134,338,56,159,78,179,48,57,372
2003,Shammond Williams,PG,27,DEN,27,712,94,241,37,102,57,139,30,45,255
2003,Walt Williams,SF,32,DAL,66,1161,134,341,64,171,70,170,31,50,363
2003,Corliss Williamson,SF,29,DET,82,2061,374,826,2,11,372,815,237,300,987
2003,Kevin Willis,C,40,SAS,71,840,123,257,0,2,123,255,51,83,297
2003,Ruben Wolkowyski,PF,29,BOS,7,24,2,4,0,1,2,3,1,4,5
2003,Loren Woods,C,24,MIN,38,353,29,76,1,3,28,73,21,27,80
2003,Qyntel Woods,PF,21,POR,53,334,59,118,3,9,56,109,7,20,128
2003,Metta World,SF,23,IND,69,2317,362,846,71,211,291,635,273,371,1068
2003,Lorenzen Wright,C,27,MEM,70,1982,325,716,0,5,325,711,147,223,797
2003,Vincent Yarbrough,SG,21,DEN,59,1381,168,428,21,78,147,350,49,62,406
2003,Wang Zhizhi,C,25,LAC,41,412,62,162,16,47,46,115,42,58,182
,,,,,,,,,,,,,,,
2004,Shareef Abdur-Rahim,PF,27,TOT,85,2684,501,1054,9,34,492,1020,373,429,1384
2004,Shareef Abdur-Rahim,PF,27,ATL,53,1956,383,790,5,23,378,767,294,334,1065
2004,Shareef Abdur-Rahim,PF,27,POR,32,728,118,264,4,11,114,253,79,95,319
2004,Malik Allen,PF,25,MIA,45,616,83,198,0,0,83,198,25,33,191
2004,Ray Allen,SG,28,SEA,56,2152,447,1017,148,378,299,639,245,271,1287
2004,Rafer Alston,PG,27,MIA,82,2581,287,764,161,434,126,330,103,134,838
2004,Chris Andersen,PF,25,DEN,71,1029,90,203,0,1,90,202,63,107,243
2004,Derek Anderson,SG,29,POR,51,1810,230,612,79,259,151,353,155,188,694
2004,Kenny Anderson,PG,33,IND,44,905,113,256,1,4,112,252,35,48,262
2004,Shandon Anderson,SG,30,NYK,80,1974,238,564,36,128,202,436,123,161,635
2004,Carmelo Anthony,SF,19,DEN,82,2995,624,1465,69,214,555,1251,408,525,1725
2004,Robert Archibald,C-PF,23,TOT,32,256,9,33,0,0,9,33,14,31,32
2004,Robert Archibald,PF,23,PHO,1,6,0,1,0,0,0,1,1,2,1
2004,Robert Archibald,PF,23,ORL,1,4,1,2,0,0,1,2,0,2,2
2004,Robert Archibald,C,23,TOR,30,246,8,30,0,0,8,30,13,27,29
2004,Gilbert Arenas,PG,22,WAS,55,2066,358,914,125,333,233,581,237,317,1078
2004,Brandon Armstrong,SG,23,NJN,56,434,65,175,19,52,46,123,2,4,151
2004,Darrell Armstrong,PG,35,NOH,79,2247,291,736,135,429,156,307,123,144,840
2004,Carlos Arroyo,PG,24,UTA,71,2008,339,768,38,117,301,651,181,225,897
2004,Chucky Atkins,PG,29,TOT,64,1544,192,484,81,241,111,243,73,97,538
2004,Chucky Atkins,PG,29,DET,40,751,88,235,42,130,46,105,31,43,249
2004,Chucky Atkins,PG,29,BOS,24,793,104,249,39,111,65,138,42,54,289
2004,Stacey Augmon,SF,35,NOH,69,1416,143,347,1,7,142,340,110,139,397
2004,Vin Baker,PF,32,TOT,54,1313,208,432,1,3,207,429,114,157,531
2004,Vin Baker,PF,32,BOS,37,1000,168,333,0,1,168,332,82,112,418
2004,Vin Baker,PF,32,NYK,17,313,40,99,1,2,39,97,32,45,113
2004,Marcus Banks,PG,22,BOS,81,1385,177,442,27,86,150,356,99,131,480
2004,Leandro Barbosa,PG,21,PHO,70,1500,210,470,83,210,127,260,47,61,550
2004,Matt Barnes,SF,23,LAC,38,724,63,138,2,13,61,125,43,61,171
2004,Dana Barros,SG,36,BOS,1,11,2,3,0,0,2,3,2,2,6
2004,Brent Barry,SG,32,SEA,59,1803,215,427,114,252,101,175,91,110,635
2004,Jon Barry,SG,34,DEN,57,1101,120,297,51,138,69,159,60,71,351
2004,Mengke Bateer,C,28,TOR,7,40,4,7,0,0,4,7,0,0,8
2004,Tony Battie,C,27,TOT,73,1478,170,384,2,9,168,375,66,89,408
2004,Tony Battie,C,27,BOS,23,501,56,117,1,1,55,116,23,33,136
2004,Tony Battie,C,27,CLE,50,977,114,267,1,8,113,259,43,56,272
2004,Shane Battier,SF,25,MEM,79,1947,242,543,65,186,177,357,120,164,669
2004,Lonny Baxter,C-PF,25,TOT,62,766,103,209,1,3,102,206,44,76,251
2004,Lonny Baxter,PF,25,CHI,14,147,27,49,1,1,26,48,5,8,60
2004,Lonny Baxter,C,25,TOR,36,487,60,128,0,1,60,127,30,56,150
2004,Lonny Baxter,PF,25,WAS,12,132,16,32,0,1,16,31,9,12,41
2004,Jerome Beasley,PF,23,MIA,2,5,1,3,0,0,1,3,0,0,2
2004,Raja Bell,SG,27,UTA,82,2020,329,805,62,166,267,639,195,248,915
2004,Troy Bell,PG,23,MEM,6,34,4,18,0,4,4,14,3,3,11
2004,Jonathan Bender,SF,23,IND,21,271,50,106,9,22,41,84,39,47,148
2004,Travis Best,PG,31,DAL,61,762,64,172,3,20,61,152,40,46,171
2004,Mike Bibby,PG,25,SAC,82,2980,527,1170,148,378,379,792,304,373,1506
2004,Chauncey Billups,PG,27,DET,78,2758,392,996,130,335,262,661,404,460,1318
2004,Steve Blake,PG,23,WAS,75,1392,157,407,75,202,82,205,55,67,444
2004,Corie Blount,PF-C,35,TOT,62,1050,115,253,0,3,115,250,15,27,245
2004,Corie Blount,PF,35,CHI,46,756,97,206,0,3,97,203,13,24,207
2004,Corie Blount,C,35,TOR,16,294,18,47,0,0,18,47,2,3,38
2004,Mark Blount,C,28,BOS,82,2402,342,604,0,0,342,604,159,221,843
2004,Keith Bogans,SF,23,ORL,73,1787,183,454,67,187,116,267,65,103,498
2004,Calvin Booth,C,27,SEA,71,1206,135,290,0,2,135,288,75,94,345
2004,Carlos Boozer,PF,22,CLE,75,2592,471,900,1,6,470,894,219,285,1162
2004,Curtis Borchardt,C,23,UTA,16,258,22,56,0,1,22,55,14,18,58
2004,Chris Bosh,C,19,TOR,75,2510,327,712,5,14,322,698,202,288,861
2004,Ruben Boumtje-Boumtje,C,25,POR,9,26,1,5,0,0,1,5,2,2,4
2004,Bruce Bowen,SF,32,SAS,82,2624,211,502,77,212,134,290,66,114,565
2004,Ryan Bowen,PF,28,DEN,52,392,18,53,0,0,18,53,10,12,46
2004,Earl Boykins,SG,27,DEN,82,1849,321,766,55,171,266,595,142,162,839
2004,Michael Bradley,C-PF,24,TOT,16,98,7,15,0,0,7,15,1,2,15
2004,Michael Bradley,PF,24,TOR,5,38,1,3,0,0,1,3,1,2,3
2004,Michael Bradley,C,24,ATL,11,60,6,12,0,0,6,12,0,0,12
2004,Shawn Bradley,C,31,DAL,66,773,89,188,0,1,89,187,41,49,219
2004,Torraye Braggs,PF,27,TOT,15,154,16,33,0,0,16,33,8,12,40
2004,Torraye Braggs,PF,27,HOU,11,132,13,28,0,0,13,28,8,12,34
2004,Torraye Braggs,PF,27,WAS,4,22,3,5,0,0,3,5,0,0,6
2004,Elton Brand,PF,24,LAC,69,2670,484,982,0,1,484,981,411,532,1379
2004,J.R. Bremer,PG,23,TOT,36,443,43,158,19,74,24,84,13,20,118
2004,J.R. Bremer,PG,23,CLE,31,403,39,137,19,66,20,71,13,20,110
2004,J.R. Bremer,PG,23,GSW,5,40,4,21,0,8,4,13,0,0,8
2004,Jamison Brewer,PG,23,IND,13,160,13,35,5,14,8,21,1,6,32
2004,Primoz Brezec,C,24,IND,18,72,12,26,0,0,12,26,4,6,28
2004,Damone Brown,PF,24,NJN,3,17,1,10,0,0,1,10,1,2,3
2004,Devin Brown,SG,25,SAS,58,627,85,196,4,14,81,182,60,74,234
2004,Kedrick Brown,SF,22,TOT,55,969,117,254,38,99,79,155,17,27,289
2004,Kedrick Brown,SF,22,BOS,21,408,45,99,12,32,33,67,8,13,110
2004,Kedrick Brown,SF,22,CLE,34,561,72,155,26,67,46,88,9,14,179
2004,Kwame Brown,PF,21,WAS,74,2239,288,589,1,2,287,587,228,334,805
2004,P.J. Brown,PF,34,NOH,80,2753,339,712,0,1,339,711,158,185,836
2004,Tierre Brown,PG,24,NOH,3,17,2,4,0,0,2,4,2,4,6
2004,Rick Brunson,PG,31,TOT,40,412,40,105,11,23,29,82,27,31,118
2004,Rick Brunson,PG,31,TOR,3,10,2,4,0,0,2,4,0,0,4
2004,Rick Brunson,PG,31,CHI,37,402,38,101,11,23,27,78,27,31,114
2004,Kobe Bryant,SG,25,LAL,65,2447,516,1178,71,217,445,961,454,533,1557
2004,Greg Buckner,SG,27,PHI,53,703,66,175,12,44,54,131,20,27,164
2004,Rodney Buford,SF,26,SAC,22,141,19,56,0,2,19,54,3,6,41
2004,Caron Butler,SF,23,MIA,68,2030,240,631,10,42,230,589,133,176,623
2004,Mitchell Butler,SG,33,WAS,41,552,54,124,11,30,43,94,15,24,134
2004,Rasual Butler,SF,24,MIA,45,675,119,250,50,108,69,142,16,21,304
2004,Zarko Cabarkapa,PF,22,PHO,49,570,81,197,6,32,75,165,35,53,203
2004,Marcus Camby,C,29,DEN,72,2162,262,549,0,2,262,547,98,136,622
2004,Elden Campbell,C,35,DET,65,892,138,314,0,0,138,314,85,124,361
2004,Brian Cardinal,PF,26,GSW,76,1634,220,466,55,124,165,342,238,271,733
2004,Matt Carroll,SG,23,TOT,16,70,7,16,1,3,6,13,4,6,19
2004,Matt Carroll,SG,23,POR,13,48,5,11,1,3,4,8,2,2,13
2004,Matt Carroll,SG,23,SAS,3,22,2,5,0,0,2,5,2,4,6
2004,Anthony Carter,PG,28,SAS,5,87,11,37,0,3,11,34,0,0,22
2004,Maurice Carter,SG,27,TOT,10,110,11,35,4,11,7,24,16,20,42
2004,Maurice Carter,SG,27,LAL,4,50,5,14,1,3,4,11,11,12,22
2004,Maurice Carter,SG,27,NOH,6,60,6,21,3,8,3,13,5,8,20
2004,Vince Carter,SG,27,TOR,73,2785,608,1457,93,243,515,1214,336,417,1645
2004,Sam Cassell,PG,34,MIN,81,2838,620,1270,74,186,546,1084,289,331,1603
2004,Kelvin Cato,PF,29,HOU,69,1743,161,360,0,0,161,360,96,142,418
2004,Tyson Chandler,PF,21,CHI,35,782,67,158,0,1,67,157,79,118,213
2004,Calbert Cheaney,SF,32,GSW,79,2067,278,578,0,10,278,568,47,77,603
2004,Doug Christie,SG,33,SAC,82,2780,317,688,49,142,268,546,148,172,831
2004,Keon Clark,PF,28,UTA,2,27,2,6,0,0,2,6,0,0,4
2004,Speedy Claxton,PG,25,GSW,60,1595,224,524,4,22,220,502,182,224,634
2004,Mateen Cleaves,PG,26,CLE,4,92,7,23,0,1,7,22,1,2,15
2004,Derrick Coleman,C,36,PHI,34,843,107,259,8,36,99,223,49,65,271
2004,Bimbo Coles,PG,35,MIA,22,170,12,34,0,0,12,34,4,6,28
2004,Jason Collier,C,26,ATL,20,545,79,165,1,4,78,161,67,85,226
2004,Jarron Collins,C,25,UTA,81,1732,147,295,0,1,147,294,188,262,482
2004,Jason Collins,C,25,NJN,78,2220,163,384,0,2,163,382,136,184,462
2004,Brian Cook,C,23,LAL,35,442,67,141,0,5,67,136,21,28,155
2004,Omar Cook,PG,22,POR,17,139,7,27,0,1,7,26,0,0,14
2004,Chris Crawford,PF,28,ATL,56,1207,211,471,44,113,167,358,103,119,569
2004,Jamal Crawford,SG,23,CHI,80,2811,509,1318,165,521,344,797,200,240,1383
2004,Austin Croshere,PF,28,IND,77,1051,119,307,56,144,63,163,93,104,387
2004,Eddy Curry,PF,21,CHI,73,2154,417,840,1,1,416,839,235,350,1070
2004,Michael Curry,SF,35,TOR,70,1229,76,196,3,15,73,181,49,58,204
2004,Samuel Dalembert,C,22,PHI,82,2197,270,499,0,1,270,498,112,174,652
2004,Erick Dampier,C,28,GSW,74,2403,348,650,0,2,348,648,217,332,913
2004,Antonio Daniels,PG,28,SEA,71,1512,187,398,42,116,145,282,155,184,571
2004,Marquis Daniels,SG,23,DAL,56,1039,203,411,11,36,192,375,60,78,477
2004,Antonio Davis,C,35,TOT,80,2570,266,660,0,0,266,660,176,230,708
2004,Antonio Davis,C,35,TOR,15,538,46,120,0,0,46,120,37,49,129
2004,Antonio Davis,C,35,CHI,65,2032,220,540,0,0,220,540,139,181,579
2004,Baron Davis,PG,24,NOH,67,2686,554,1402,187,582,367,820,237,352,1532
2004,Dale Davis,C,34,POR,76,1682,133,281,0,0,133,281,65,106,331
2004,Hubert Davis,SG,33,TOT,17,78,1,11,0,1,1,10,2,2,4
2004,Hubert Davis,SG,33,DET,3,23,0,2,0,1,0,1,0,0,0
2004,Hubert Davis,SG,33,NJN,14,55,1,9,0,0,1,9,2,2,4
2004,Josh Davis,PF,23,ATL,4,23,2,5,0,2,2,3,1,1,5
2004,Ricky Davis,SF-SG,24,TOT,79,2474,446,950,52,140,394,810,196,273,1140
2004,Ricky Davis,SG,24,CLE,22,796,134,311,17,48,117,263,51,75,336
2004,Ricky Davis,SF,24,BOS,57,1678,312,639,35,92,277,547,145,198,804
2004,Andrew DeClercq,C,30,ORL,71,1211,93,195,0,0,93,195,44,54,230
2004,Tony Delk,SG,30,DAL,33,509,70,184,20,66,50,118,37,44,197
2004,Derrick Dial,SG,28,ORL,9,86,9,28,2,9,7,19,6,8,26
2004,Boris Diaw,SG,21,ATL,76,1919,140,313,6,26,134,287,56,93,342
2004,Dan Dickau,PG,25,TOT,43,294,37,98,10,30,27,68,11,14,95
2004,Dan Dickau,PG,25,ATL,23,143,21,49,3,10,18,39,4,6,49
2004,Dan Dickau,PG,25,POR,20,151,16,49,7,20,9,29,7,8,46
2004,Kaniel Dickens,PF,25,POR,3,12,3,3,0,0,3,3,1,2,7
2004,DeSagana Diop,C,22,CLE,56,730,57,147,0,0,57,147,12,20,126
2004,Vlade Divac,C,35,SAC,81,2317,314,668,2,13,312,655,170,260,800
2004,Juan Dixon,SG,25,WAS,71,1478,247,637,59,198,188,439,111,139,664
2004,Michael Doleac,C,26,TOT,72,1029,140,322,0,0,140,322,45,52,325
2004,Michael Doleac,C,26,NYK,46,685,100,225,0,0,100,225,31,36,231
2004,Michael Doleac,C,26,DEN,26,344,40,97,0,0,40,97,14,16,94
2004,Keyon Dooling,PG,23,LAC,58,1137,137,352,8,46,129,306,78,94,360
2004,Bryce Drew,PG,29,NOH,15,78,4,18,1,7,3,11,3,3,12
2004,Predrag Drobnjak,C,28,LAC,61,949,149,379,11,36,138,343,73,86,382
2004,Tim Duncan,PF,27,SAS,69,2527,592,1181,2,12,590,1169,352,588,1538
2004,Mike Dunleavy,SF,23,GSW,75,2336,323,720,94,254,229,466,137,185,877
2004,Ronald Dupree,SF,23,CHI,47,893,111,282,4,9,107,273,66,105,292
2004,Ndudi Ebi,SF,19,MIN,17,32,6,14,0,0,6,14,1,4,13
2004,Howard Eisley,PG,31,TOT,67,1457,166,451,52,163,114,288,76,89,460
2004,Howard Eisley,PG,31,NYK,33,730,80,202,28,85,52,117,32,36,220
2004,Howard Eisley,PG,31,PHO,34,727,86,249,24,78,62,171,44,53,240
2004,Francisco Elson,C,27,DEN,62,875,94,199,0,1,94,198,30,45,218
2004,Melvin Ely,PF,25,LAC,42,510,66,153,0,1,66,152,25,42,157
2004,Reggie Evans,PF,23,SEA,75,1280,67,165,0,3,67,162,83,148,217
2004,Desmond Ferguson,SF,26,POR,7,32,5,12,3,8,2,4,0,2,13
2004,Michael Finley,SG,30,DAL,72,2778,514,1159,150,370,364,789,164,193,1342
2004,Derek Fisher,SG,29,LAL,82,1769,203,576,52,179,151,397,122,153,580
2004,Marcus Fizer,SF,25,CHI,46,738,134,350,2,17,132,333,90,120,360
2004,Alton Ford,PF,22,HOU,9,41,6,11,0,0,6,11,3,6,15
2004,T.J. Ford,PG,20,MIL,55,1472,153,398,5,21,148,377,80,98,391
2004,Danny Fortson,C,27,DAL,56,625,71,139,0,0,71,139,75,92,217
2004,Jeff Foster,C,27,IND,82,1961,197,362,0,4,197,358,103,154,497
2004,Tremaine Fowlkes,SF,27,DET,36,261,15,48,1,8,14,40,13,18,44
2004,Rick Fox,SF,34,LAL,38,846,73,186,15,61,58,125,22,30,183
2004,Adonal Foyle,C,28,GSW,44,572,59,130,0,0,59,130,19,35,137
2004,Richie Frahm,SF,26,SEA,54,469,63,139,34,92,29,47,23,26,183
2004,Steve Francis,PG,26,HOU,79,3194,450,1117,73,250,377,867,337,435,1310
2004,Hiram Fuller,PF,22,ATL,4,43,3,8,0,0,3,8,2,6,8
2004,Dan Gadzuric,C,25,MIL,75,1260,183,349,0,1,183,348,58,118,424
2004,Reece Gaines,PG,23,ORL,38,364,25,86,3,10,22,76,16,25,69
2004,Alex Garcia,SG,23,SAS,2,13,1,7,0,0,1,7,1,2,3
2004,Kevin Garnett,PF,27,MIN,82,3231,804,1611,11,43,793,1568,368,465,1987
2004,Pat Garrity,PF,27,ORL,2,22,1,3,0,0,1,3,0,0,2
2004,Pau Gasol,PF,23,MEM,78,2458,506,1049,4,15,502,1034,365,511,1381
2004,Devean George,SF,26,LAL,82,1951,233,571,65,186,168,385,73,96,604
2004,Eddie Gill,PG,25,POR,22,157,15,36,3,8,12,28,17,20,50
2004,Kendall Gill,SG,35,CHI,56,1411,215,548,9,38,206,510,100,136,539
2004,Manu Ginobili,SG,26,SAS,77,2260,330,789,88,245,242,544,239,298,987
2004,Gordan Giricek,SF-SG,26,TOT,73,2041,316,724,60,152,256,572,135,158,827
2004,Gordan Giricek,SF,26,ORL,48,1435,188,427,46,113,142,314,67,81,489
2004,Gordan Giricek,SG,26,UTA,25,606,128,297,14,39,114,258,68,77,338
2004,Dion Glover,SG,25,TOT,69,1643,230,589,40,119,190,470,120,156,620
2004,Dion Glover,SG,25,ATL,55,1465,205,524,36,105,169,419,110,142,556
2004,Dion Glover,SG,25,TOR,14,178,25,65,4,14,21,51,10,14,64
2004,Anthony Goldwire,PG,32,TOT,11,85,7,22,2,8,5,14,1,1,17
2004,Anthony Goldwire,PG,32,MIN,5,66,5,14,2,6,3,8,1,1,13
2004,Anthony Goldwire,PG,32,NJN,6,19,2,8,0,2,2,6,0,0,4
2004,Drew Gooden,PF,22,ORL,79,2134,369,829,9,42,360,787,167,262,914
2004,Brian Grant,C,31,MIA,76,2303,289,613,0,1,289,612,86,110,664
2004,Horace Grant,PF,38,LAL,55,1106,92,224,0,1,92,223,39,54,223
2004,Paul Grant,C,30,UTA,10,98,11,23,0,0,11,23,3,8,25
2004,Willie Green,SG,22,PHI,53,767,143,357,19,61,124,296,59,81,364
2004,Adrian Griffin,SG,29,HOU,19,133,5,18,1,2,4,16,0,4,11
2004,Tom Gugliotta,PF,34,TOT,55,819,70,203,1,4,69,199,20,28,161
2004,Tom Gugliotta,PF,34,PHO,30,304,31,99,0,1,31,98,6,8,68
2004,Tom Gugliotta,PF,34,UTA,25,515,39,104,1,3,38,101,14,20,93
2004,Marcus Haislip,PF,23,MIL,31,263,36,74,1,2,35,72,20,28,93
2004,Darvin Ham,SF,30,DET,54,484,37,75,1,2,36,73,21,35,96
2004,Richard Hamilton,SG,25,DET,78,2772,530,1166,18,68,512,1098,297,342,1375
2004,Zendon Hamilton,C,28,PHI,46,473,51,95,0,0,51,95,67,96,169
2004,Ben Handlogten,C,30,UTA,17,172,25,47,0,0,25,47,18,27,68
2004,Travis Hansen,SF,25,ATL,41,507,46,130,9,30,37,100,22,27,123
2004,Anfernee Hardaway,SG,32,TOT,76,2095,279,679,30,79,249,600,111,138,699
2004,Anfernee Hardaway,SG,32,PHO,34,876,120,271,14,35,106,236,42,49,296
2004,Anfernee Hardaway,SG,32,NYK,42,1219,159,408,16,44,143,364,69,89,403
2004,Matt Harpring,SF,27,UTA,31,1134,193,410,8,33,185,377,108,157,502
2004,Al Harrington,PF,23,IND,79,2441,421,909,21,77,400,832,185,252,1048
2004,Othella Harrington,PF,30,NYK,56,872,100,202,0,0,100,202,58,78,258
2004,Lucious Harris,PG,33,NJN,69,1504,187,463,38,101,149,362,66,78,478
2004,Jason Hart,PG,25,SAS,53,660,71,159,2,9,69,150,33,43,177
2004,Donnell Harvey,PF,23,TOT,60,783,89,201,0,3,89,198,61,83,239
2004,Donnell Harvey,PF,23,ORL,24,345,36,89,0,3,36,86,26,39,98
2004,Donnell Harvey,PF,23,PHO,36,438,53,112,0,0,53,112,35,44,141
2004,Udonis Haslem,PF,23,MIA,75,1795,205,447,0,3,205,444,140,183,550
2004,Trenton Hassell,SG,24,MIN,81,2264,177,381,4,13,173,368,48,61,406
2004,Jarvis Hayes,SF,22,WAS,70,2044,278,695,40,131,238,564,77,98,673
2004,Brendan Haywood,C,24,WAS,77,1484,200,388,0,1,200,387,137,234,537
2004,Shane Heal,PG,33,SAS,6,72,7,24,4,18,3,6,4,5,22
2004,Alan Henderson,PF,31,ATL,6,68,10,21,0,0,10,21,4,6,24
2004,Nene Hilario,PF,21,DEN,77,2504,334,630,0,2,334,628,240,352,908
2004,Tyrone Hill,PF,35,MIA,5,38,3,5,0,0,3,5,3,4,9
2004,Kirk Hinrich,PG,23,CHI,76,2706,318,823,144,369,174,454,135,168,915
2004,Fred Hoiberg,SG,31,MIN,79,1804,178,383,76,172,102,211,98,116,530
2004,Robert Horry,PF,33,SAS,81,1290,141,348,41,108,100,240,69,107,392
2004,Eddie House,SG,25,LAC,60,1188,161,449,51,136,110,313,36,45,409
2004,Allan Houston,SG,32,NYK,50,1799,340,781,87,202,253,579,157,172,924
2004,Josh Howard,SF,23,DAL,67,1589,229,532,20,66,209,466,97,138,575
2004,Juwan Howard,PF,30,ORL,81,2877,529,1169,0,1,529,1168,318,393,1376
2004,Troy Hudson,PG,27,MIN,29,503,80,207,31,77,49,130,27,33,218
2004,Larry Hughes,SG,25,WAS,61,2061,401,1009,79,232,322,777,267,335,1148
2004,Ryan Humphrey,PF,24,MEM,2,11,1,4,0,1,1,3,0,0,2
2004,Brandon Hunter,PF,23,BOS,36,406,53,116,0,3,53,113,19,43,125
2004,Lindsey Hunter,SG,33,DET,33,661,49,143,14,50,35,93,5,8,117
2004,Steven Hunter,C,22,ORL,59,789,82,155,0,0,82,155,23,69,187
2004,Zydrunas Ilgauskas,C,28,CLE,81,2539,466,965,2,7,464,958,303,406,1237
2004,Allen Iverson*,SG,28,PHI,48,2040,435,1125,57,199,378,926,339,455,1266
2004,Bobby Jackson,SG,30,SAC,50,1185,263,592,81,219,182,373,82,109,689
2004,Jim Jackson,SF,33,HOU,80,3119,382,900,162,405,220,495,107,127,1033
2004,Marc Jackson,PF,29,PHI,22,598,71,171,0,1,71,170,64,81,206
2004,Mark Jackson,PG,38,HOU,42,577,34,100,7,41,27,59,28,39,103
2004,Stephen Jackson,SF,25,ATL,80,2940,536,1261,145,427,391,834,233,297,1450
2004,Casey Jacobsen,SF,22,PHO,78,1828,150,360,75,180,75,180,91,111,466
2004,Jerome James,C,28,SEA,65,990,129,259,0,0,129,259,66,100,324
2004,LeBron James,SG,19,CLE,79,3122,622,1492,63,217,559,1275,347,460,1654
2004,Mike James,PG,28,TOT,81,2196,272,657,106,281,166,376,103,127,753
2004,Mike James,PG,28,BOS,55,1684,213,510,86,226,127,284,76,95,588
2004,Mike James,PG,28,DET,26,512,59,147,20,55,39,92,27,32,165
2004,Antawn Jamison,SF,27,DAL,82,2376,488,913,16,40,472,873,220,294,1212
2004,Marko Jaric,PG,25,LAC,58,1760,185,477,51,150,134,327,74,101,495
2004,Chris Jefferies,SF-SG,23,TOT,21,195,27,72,17,42,10,30,13,20,84
2004,Chris Jefferies,SG,23,TOR,2,8,3,6,1,3,2,3,1,1,8
2004,Chris Jefferies,SF,23,CHI,19,187,24,66,16,39,8,27,12,19,76
2004,Richard Jefferson,SF,23,NJN,82,3133,555,1115,48,132,507,983,357,468,1515
2004,Jared Jeffries,PF,22,WAS,82,1913,177,469,5,30,172,439,105,171,464
2004,Britton Johnsen,C,24,ORL,20,290,17,59,1,12,16,47,7,16,42
2004,Anthony Johnson,PG,29,IND,73,1598,167,411,41,122,126,289,75,94,450
2004,Avery Johnson,PG,38,GSW,46,637,80,199,0,3,80,196,52,78,212
2004,DerMarr Johnson,SF,23,NYK,21,287,36,97,13,36,23,61,28,31,113
2004,Ervin Johnson,C,36,MIN,66,965,55,103,0,1,55,102,17,28,127
2004,Joe Johnson,SG,22,PHO,82,3331,555,1291,83,272,472,1019,174,232,1367
2004,Linton Johnson,SF,23,CHI,41,734,72,203,7,33,65,170,22,37,173
2004,Dahntay Jones,SG,23,MEM,20,154,15,53,1,4,14,49,5,11,36
2004,Damon Jones,PG,27,MIL,82,2016,210,524,98,273,112,251,55,72,573
2004,Eddie Jones,SG,32,MIA,81,2998,473,1156,177,479,296,677,278,333,1401
2004,Fred Jones,SG,24,IND,81,1508,123,311,27,89,96,222,124,149,397
2004,James Jones,SF,23,IND,6,26,2,9,1,4,1,5,2,2,7
2004,Jumaine Jones,SG,24,BOS,42,373,33,96,13,44,20,52,14,23,93
2004,Popeye Jones,PF,33,GSW,5,10,0,2,0,0,0,2,0,0,0
2004,Chris Kaman,C,21,LAC,82,1843,200,435,0,2,200,433,99,142,499
2004,Jason Kapono,SF,22,CLE,41,427,52,129,21,44,31,85,20,24,145
2004,Jason Kidd,PG,30,NJN,67,2450,368,959,94,293,274,666,206,249,1036
2004,Andrei Kirilenko,PF,22,UTA,78,2895,412,931,68,201,344,730,392,496,1284
2004,Kerry Kittles,SG,29,NJN,82,2842,434,959,97,276,337,683,107,136,1072
2004,Brevin Knight,PG,28,TOT,56,1037,105,246,2,8,103,238,49,65,261
2004,Brevin Knight,PG,28,PHO,3,19,1,3,0,0,1,3,0,0,2
2004,Brevin Knight,PG,28,WAS,32,598,58,138,1,5,57,133,19,27,136
2004,Brevin Knight,PG,28,MIL,21,420,46,105,1,3,45,102,30,38,123
2004,Kyle Korver,SF,22,PHI,74,882,115,327,81,207,34,120,19,24,330
2004,Toni Kukoc,PF,35,MIL,73,1522,211,506,49,168,162,338,145,199,616
2004,Christian Laettner,PF,34,WAS,48,984,119,256,6,21,113,235,40,50,284
2004,Raef LaFrentz,C,27,BOS,17,328,57,124,8,40,49,84,10,13,132
2004,Maciej Lampe,C,18,PHO,21,224,43,88,0,4,43,84,10,13,96
2004,Sean Lampley,SF,24,GSW,10,63,13,20,0,0,13,20,8,12,34
2004,Dan Langhi,SF,26,TOT,6,37,5,14,1,2,4,12,2,2,13
2004,Dan Langhi,SF,26,GSW,4,17,2,6,0,0,2,6,2,2,6
2004,Dan Langhi,SF,26,MIL,2,20,3,8,1,2,2,6,0,0,7
2004,Rusty LaRue,PG,30,GSW,4,22,1,3,1,1,0,2,1,2,4
2004,Voshon Lenard,SG,30,DEN,73,2233,394,933,106,289,288,644,144,182,1038
2004,Quincy Lewis,SF,26,MIN,14,65,7,20,2,5,5,15,0,0,16
2004,Rashard Lewis,SF,24,SEA,80,2931,535,1229,145,386,390,843,206,270,1421
2004,Randy Livingston,PG,28,LAC,4,48,2,10,0,3,2,7,4,6,8
2004,Raul Lopez,PG,23,UTA,82,1617,223,517,25,85,198,432,101,117,572
2004,Tyronn Lue,PG,26,ORL,76,2332,309,714,80,209,229,505,101,131,799
2004,George Lynch,SF,33,NOH,78,1701,149,375,43,139,106,236,34,51,375
2004,Mark Madsen,C,28,MIN,72,1246,101,204,0,6,101,198,57,118,259
2004,Corey Maggette,SF,24,LAC,73,2628,453,1013,76,231,377,782,526,620,1508
2004,Jamaal Magloire,C,25,NOH,82,2777,383,809,0,1,383,808,353,470,1119
2004,Karl Malone*,PF,40,LAL,42,1373,193,400,0,1,193,399,168,225,554
2004,Stephon Marbury,PG,26,TOT,81,3254,598,1386,87,274,511,1112,356,436,1639
2004,Stephon Marbury,PG,26,PHO,34,1415,262,606,37,118,225,488,147,185,708
2004,Stephon Marbury,PG,26,NYK,47,1839,336,780,50,156,286,624,209,251,931
2004,Shawn Marion,SF,25,PHO,79,3217,590,1341,90,265,500,1076,228,268,1498
2004,Donyell Marshall,PF,30,TOT,82,2988,470,1020,131,325,339,695,134,182,1205
2004,Donyell Marshall,PF,30,CHI,16,408,57,136,11,27,46,109,14,20,139
2004,Donyell Marshall,PF,30,TOR,66,2580,413,884,120,298,293,586,120,162,1066
2004,Darrick Martin,PG,32,MIN,16,172,20,67,6,26,14,41,9,9,55
2004,Kenyon Martin,PF,26,NJN,65,2252,439,900,7,25,432,875,201,294,1086
2004,Jamal Mashburn,SF,31,NOH,19,730,156,398,19,67,137,331,65,80,396
2004,Desmond Mason,SF,26,MIL,82,2534,409,867,9,39,400,828,356,463,1183
2004,Roger Mason,SG,23,TOT,26,328,32,98,13,39,19,59,19,22,96
2004,Roger Mason,SG,23,CHI,3,43,1,11,1,6,0,5,0,0,3
2004,Roger Mason,SG,23,TOR,23,285,31,87,12,33,19,54,19,22,93
2004,Tony Massenburg,PF,36,SAC,59,789,104,219,0,1,104,218,43,63,251
2004,Walter McCarty,PF,29,BOS,77,1900,203,523,137,366,66,157,62,82,605
2004,Amal McCaskill,C,30,PHI,59,636,47,117,0,1,47,116,19,27,113
2004,Jelani McCoy,C,26,CLE,2,12,0,0,0,0,0,0,0,0,0
2004,Antonio McDyess,PF,29,TOT,42,927,126,268,0,0,126,268,38,69,290
2004,Antonio McDyess,PF,29,NYK,18,421,65,142,0,0,65,142,22,38,152
2004,Antonio McDyess,PF,29,PHO,24,506,61,126,0,0,61,126,16,31,138
2004,Tracy McGrady,SG,24,ORL,67,2675,653,1566,174,513,479,1053,398,500,1878
2004,Jeff McInnis,SG-PG,29,TOT,70,2365,334,747,46,127,288,620,114,143,828
2004,Jeff McInnis,SG,29,POR,39,1269,196,416,15,47,181,369,58,76,465
2004,Jeff McInnis,PG,29,CLE,31,1096,138,331,31,80,107,251,56,67,363
2004,Aaron McKie,SF,31,PHI,75,2112,265,577,75,172,190,405,84,111,689
2004,Keith McLeod,PG,24,MIN,33,391,27,82,1,10,26,72,33,43,88
2004,Stanislav Medvedenko,PF,24,LAL,68,1442,237,537,0,3,237,534,89,116,563
2004,Ron Mercer,SG,27,SAS,39,516,90,211,2,7,88,204,13,17,195
2004,Chris Mihm,C-PF,24,TOT,76,1330,186,381,0,0,186,381,110,166,482
2004,Chris Mihm,PF,24,CLE,22,391,59,127,0,0,59,127,34,48,152
2004,Chris Mihm,C,24,BOS,54,939,127,254,0,0,127,254,76,118,330
2004,Darius Miles,SF,22,TOT,79,2079,365,753,7,40,358,713,124,193,861
2004,Darius Miles,SF,22,CLE,37,888,143,331,5,30,138,301,39,72,330
2004,Darius Miles,SF,22,POR,42,1191,222,422,2,10,220,412,85,121,531
2004,Darko Milicic,C,18,DET,34,159,17,65,0,1,17,64,14,24,48
2004,Andre Miller,PG,27,DEN,82,2838,430,941,12,65,418,876,342,411,1214
2004,Brad Miller,PF,27,SAC,72,2621,373,731,12,38,361,693,256,329,1014
2004,Mike Miller,SF,23,MEM,65,1770,270,616,80,215,190,401,102,141,722
2004,Oliver Miller,C,33,MIN,48,506,53,100,0,1,53,99,15,23,121
2004,Reggie Miller*,SG,38,IND,80,2254,260,594,134,334,126,260,146,165,800
2004,Yao Ming*,C,23,HOU,82,2692,535,1025,0,2,535,1023,361,446,1431
2004,Cuttino Mobley,SG,28,HOU,80,3229,460,1081,164,420,296,661,176,217,1260
2004,Nazr Mohammed,C,26,TOT,80,1611,246,472,0,0,246,472,100,169,592
2004,Nazr Mohammed,C,26,ATL,53,938,138,280,0,0,138,280,69,110,345
2004,Nazr Mohammed,C,26,NYK,27,673,108,192,0,0,108,192,31,59,247
2004,Jerome Moiso,PF,25,TOR,35,417,40,84,0,1,40,83,22,38,102
2004,Mikki Moore,PF-C,28,TOT,32,395,50,99,0,0,50,99,30,35,130
2004,Mikki Moore,C,28,NJN,4,10,1,5,0,0,1,5,0,0,2
2004,Mikki Moore,PF,28,UTA,28,385,49,94,0,0,49,94,30,35,128
2004,Alonzo Mourning*,C,33,NJN,12,215,33,71,0,0,33,71,30,34,96
2004,Troy Murphy,PF,23,GSW,28,610,107,243,5,17,102,226,60,80,279
2004,Lamond Murray,SF,30,TOR,33,518,76,215,21,60,55,155,24,35,197
2004,Ronald Murray,PG,24,SEA,82,2021,389,915,67,229,322,686,168,235,1013
2004,Tracy Murray,SF,32,POR,7,35,3,12,2,5,1,7,0,1,8
2004,Dikembe Mutombo*,C,37,NYK,65,1494,141,295,0,0,141,295,81,119,363
2004,Mamadou N'Diaye,C,28,TOT,28,366,27,69,0,0,27,69,44,59,98
2004,Mamadou N'Diaye,C,28,DAL,3,7,0,1,0,0,0,1,0,0,0
2004,Mamadou N'Diaye,C,28,ATL,25,359,27,68,0,0,27,68,44,59,98
2004,Bostjan Nachbar,SF,23,HOU,45,516,47,132,23,63,24,69,21,29,138
2004,Lee Nailon,PF-SF,28,TOT,57,780,147,327,0,3,147,324,47,58,341
2004,Lee Nailon,PF,28,ATL,27,300,63,138,0,0,63,138,16,19,142
2004,Lee Nailon,SF,28,ORL,8,83,11,27,0,0,11,27,7,9,29
2004,Lee Nailon,SF,28,CLE,22,397,73,162,0,3,73,159,24,30,170
2004,Eduardo Najera,SF,27,DAL,58,720,72,162,2,4,70,158,30,46,176
2004,Steve Nash,PG,29,DAL,78,2612,397,845,104,257,293,588,230,251,1128
2004,Rasho Nesterovic,C,27,SAS,82,2353,328,700,0,0,328,700,54,114,710
2004,Ira Newble,SF,29,CLE,64,1245,108,276,2,19,106,257,36,46,254
2004,Moochie Norris,PG,30,TOT,66,847,80,217,20,58,60,159,54,71,234
2004,Moochie Norris,PG,30,HOU,30,401,27,87,8,23,19,64,18,24,80
2004,Moochie Norris,PG,30,NYK,36,446,53,130,12,35,41,95,36,47,154
2004,Dirk Nowitzki,C,25,DAL,77,2915,605,1310,99,290,506,1020,371,423,1680
2004,Jermaine O'Neal,PF,25,IND,78,2788,608,1400,2,18,606,1382,348,460,1566
2004,Shaquille O'Neal*,C,31,LAL,67,2464,554,948,0,0,554,948,331,676,1439
2004,Charles Oakley,PF,40,HOU,7,25,2,6,0,0,2,6,5,6,9
2004,Lamar Odom,PF,24,MIA,80,3003,485,1127,61,205,424,922,340,458,1371
2004,Mehmet Okur,PF,24,DET,71,1580,251,542,18,48,233,494,162,209,682
2004,Kevin Ollie,PG,31,CLE,82,1401,95,257,4,9,91,248,147,176,341
2004,Michael Olowokandi,C,28,MIN,43,925,121,285,0,0,121,285,36,61,278
2004,Greg Ostertag,C,30,UTA,78,2153,208,437,0,1,208,436,113,195,529
2004,Bo Outlaw,PF,32,MEM,82,1606,159,312,0,4,159,308,61,116,379
2004,Travis Outlaw,PF,19,POR,8,19,3,7,0,0,3,7,2,4,8
2004,Doug Overton,PG,34,TOT,61,1033,99,245,3,23,96,222,23,31,224
2004,Doug Overton,PG,34,NJN,6,22,3,8,0,0,3,8,2,2,8
2004,Doug Overton,PG,34,LAC,55,1011,96,237,3,23,93,214,21,29,216
2004,Zaza Pachulia,C,19,ORL,59,664,68,175,0,0,68,175,58,90,194
2004,Robert Pack,PG,34,NJN,26,220,22,52,0,0,22,52,5,6,49
2004,Scott Padgett,PF,27,HOU,58,547,74,167,28,65,46,102,24,32,200
2004,Milt Palacio,PG,25,TOR,59,1211,104,298,4,26,100,272,45,68,257
2004,Jannero Pargo,PG,24,TOT,31,479,81,199,22,62,59,137,23,27,207
2004,Jannero Pargo,PG,24,LAL,13,63,6,16,2,4,4,12,0,0,14
2004,Jannero Pargo,PG,24,TOR,5,71,9,29,0,5,9,24,0,0,18
2004,Jannero Pargo,PG,24,CHI,13,345,66,154,20,53,46,101,23,27,175
2004,Tony Parker,PG,21,SAS,75,2577,423,946,62,199,361,747,191,272,1099
2004,Cherokee Parks,C,31,GSW,12,64,4,10,0,0,4,10,4,6,12
2004,Ruben Patterson,SF,28,POR,73,1651,200,395,2,12,198,383,105,190,507
2004,Sasha Pavlovic,SF,20,UTA,79,1144,149,376,19,70,130,306,65,84,382
2004,Gary Payton*,PG,35,LAL,82,2825,482,1024,55,165,427,859,180,252,1199
2004,Anthony Peeler,SG,34,SAC,75,1391,156,348,68,141,88,207,51,61,431
2004,Desmond Penigar,PF,22,ORL,10,89,14,28,0,0,14,28,4,4,32
2004,Kirk Penney,SG,23,MIA,2,18,1,6,1,3,0,3,0,0,3
2004,Kendrick Perkins,C,19,BOS,10,35,8,15,0,0,8,15,6,9,22
2004,Wesley Person,SG,32,TOT,58,1037,126,314,55,138,71,176,31,39,338
2004,Wesley Person,SG,32,MEM,16,284,33,107,11,43,22,64,6,8,83
2004,Wesley Person,SG,32,POR,33,621,80,168,36,76,44,92,19,25,215
2004,Wesley Person,SG,32,ATL,9,132,13,39,8,19,5,20,6,6,40
2004,Morris Peterson,SF,26,TOR,82,2148,238,587,126,340,112,247,76,94,678
2004,Eric Piatkowski,SF,33,HOU,49,703,72,191,43,122,29,69,14,16,201
2004,Paul Pierce,SG,26,BOS,80,3099,602,1497,115,384,487,1113,517,631,1836
2004,Mickael Pietrus,PG,21,GSW,53,748,96,231,35,105,61,126,52,75,279
2004,Scottie Pippen*,SF,38,CHI,23,412,53,140,13,48,40,92,17,27,136
2004,Zoran Planinic,SG,21,NJN,49,473,53,129,9,32,44,97,38,60,153
2004,Scot Pollard,C,28,IND,61,678,47,114,0,0,47,114,12,21,106
2004,Olden Polynice,C,39,LAC,2,12,0,0,0,0,0,0,0,0,0
2004,Mark Pope,PF,31,DEN,4,20,1,2,0,0,1,2,0,1,2
2004,James Posey,SG,27,MEM,82,2451,368,770,112,290,256,480,278,335,1126
2004,Vitaly Potapenko,C,28,SEA,65,1419,200,409,0,0,200,409,59,92,459
2004,Tayshaun Prince,SF,23,DET,82,2701,338,723,57,157,281,566,108,141,841
2004,Joel Przybilla,C,24,TOT,17,347,18,50,0,0,18,50,13,31,49
2004,Joel Przybilla,C,24,MIL,5,33,0,0,0,0,0,0,1,2,1
2004,Joel Przybilla,C,24,ATL,12,314,18,50,0,0,18,50,12,29,48
2004,Vladimir Radmanovic,PF,23,SEA,77,2321,345,812,140,377,205,435,95,127,925
2004,Zach Randolph,PF,22,POR,81,3067,663,1368,1,5,662,1363,299,393,1626
2004,Theo Ratliff,C,30,TOT,85,2664,266,549,0,0,266,549,140,217,672
2004,Theo Ratliff,C,30,ATL,53,1648,171,373,0,0,171,373,96,147,438
2004,Theo Ratliff,C,30,POR,32,1016,95,176,0,0,95,176,44,70,234
2004,Zeljko Rebraca,C,31,TOT,24,273,34,77,0,0,34,77,23,30,91
2004,Zeljko Rebraca,C,31,DET,21,222,22,54,0,0,22,54,22,28,66
2004,Zeljko Rebraca,C,31,ATL,3,51,12,23,0,0,12,23,1,2,25
2004,Michael Redd,SG,24,MIL,82,3021,633,1439,127,363,506,1076,383,441,1776
2004,Glen Rice,SF,36,LAC,18,262,22,76,5,28,17,48,17,17,66
2004,Jason Richardson,SG,23,GSW,78,2936,563,1284,77,273,486,1011,258,377,1461
2004,Quentin Richardson,SG,23,LAC,65,2338,425,1068,120,341,305,727,151,204,1121
2004,Luke Ridnour,PG,22,SEA,69,1114,145,350,27,80,118,270,65,79,382
2004,Clifford Robinson,PF,37,GSW,82,2846,366,945,112,314,254,631,123,173,967
2004,Eddie Robinson,SF,27,CHI,51,1024,157,326,1,5,156,321,28,43,343
2004,Glenn Robinson,SF,31,PHI,42,1336,275,614,34,100,241,514,114,137,698
2004,Rodney Rogers,PF,32,NJN,69,1409,207,505,50,152,157,353,75,98,539
2004,Sean Rooks,C,34,TOT,55,595,54,151,0,1,54,150,33,37,141
2004,Sean Rooks,C,34,NOH,35,325,34,94,0,0,34,94,12,15,80
2004,Sean Rooks,C,34,ORL,20,270,20,57,0,1,20,56,21,22,61
2004,Jalen Rose,PG-SF,31,TOT,66,2497,383,952,69,202,314,750,187,231,1022
2004,Jalen Rose,SF,31,CHI,16,529,75,200,23,54,52,146,39,51,212
2004,Jalen Rose,PG,31,TOR,50,1968,308,752,46,148,262,604,148,180,810
2004,Malik Rose,PF,29,SAS,67,1256,173,404,0,3,173,401,183,225,529
2004,Michael Ruffin,PF,27,UTA,41,733,38,117,0,0,38,117,16,38,92
2004,Kareem Rush,SG,23,LAL,72,1244,190,432,48,138,142,294,31,52,459
2004,Bryon Russell,SF,33,LAL,72,945,98,244,43,112,55,132,50,65,289
2004,John Salmons,SG,24,PHI,77,1603,161,416,50,147,111,269,71,92,443
2004,Jamal Sampson,C,20,LAL,10,130,11,23,0,0,11,23,7,12,29
2004,Daniel Santiago,C,27,MIL,54,708,78,163,0,0,78,163,61,90,217
2004,Brian Scalabrine,PF,25,NJN,69,928,86,218,10,41,76,177,58,70,240
2004,Ansu Sesay,SF,27,SEA,57,583,81,178,6,21,75,157,32,46,200
2004,Paul Shirley,PF,26,CHI,7,86,10,23,0,1,10,22,1,3,21
2004,Bobby Simmons,SF,23,LAC,56,1376,147,373,2,12,145,361,141,169,437
2004,Brian Skinner,C,27,MIL,56,1577,255,513,0,0,255,513,79,138,589
2004,Tamar Slay,SG,23,NJN,22,165,21,60,4,12,17,48,7,14,53
2004,Jabari Smith,C,26,SAC,31,168,26,70,0,3,26,67,12,20,64
2004,Joe Smith,PF,28,MIL,76,2254,311,708,1,5,310,703,207,241,830
2004,Leon Smith,C,23,SEA,1,4,1,2,0,0,1,2,0,0,2
2004,Steve Smith,SG,34,NOH,71,929,119,293,43,107,76,186,77,83,358
2004,Theron Smith,SF,23,MEM,20,178,16,43,6,12,10,31,6,8,44
2004,Eric Snow,PG,30,PHI,82,2966,295,715,2,18,293,697,252,316,844
2004,Darius Songaila,PF,25,SAC,73,976,133,273,0,0,133,273,71,88,337
2004,Latrell Sprewell,SF,33,MIN,82,3100,518,1266,99,299,419,967,240,295,1375
2004,Jerry Stackhouse,SF,29,WAS,26,774,128,321,23,65,105,256,83,103,362
2004,Vladimir Stepania,C,27,POR,42,453,43,103,0,0,43,103,22,36,108
2004,DeShawn Stevenson,SG-SF,22,TOT,80,2444,376,871,19,71,357,800,138,204,909
2004,DeShawn Stevenson,SG,22,UTA,54,1511,261,586,7,30,254,556,89,133,618
2004,DeShawn Stevenson,SF,22,ORL,26,933,115,285,12,41,103,244,49,71,291
2004,Michael Stewart,C-PF,28,TOT,25,147,5,12,0,0,5,12,3,4,13
2004,Michael Stewart,PF,28,CLE,8,76,3,7,0,0,3,7,2,2,8
2004,Michael Stewart,C,28,BOS,17,71,2,5,0,0,2,5,1,2,5
2004,Peja Stojakovic,SF,26,SAC,81,3264,665,1386,240,554,425,832,394,425,1964
2004,Damon Stoudamire,PG,30,POR,82,3118,408,1018,156,427,252,591,127,145,1099
2004,Amar'e Stoudemire,PF,21,PHO,55,2025,411,865,1,5,410,860,310,435,1133
2004,Erick Strickland,PG,30,MIL,43,571,79,196,29,66,50,130,44,51,231
2004,Rod Strickland,PG,37,TOT,61,1197,150,353,10,36,140,317,72,98,382
2004,Rod Strickland,PG,37,ORL,46,915,122,269,10,33,112,236,57,76,311
2004,Rod Strickland,PG,37,TOR,15,282,28,84,0,3,28,81,15,22,71
2004,Bruno Sundov,C,23,TOT,5,33,4,10,0,0,4,10,3,6,11
2004,Bruno Sundov,C,23,CLE,4,29,3,9,0,0,3,9,3,6,9
2004,Bruno Sundov,C,23,NYK,1,4,1,1,0,0,1,1,0,0,2
2004,Bob Sura,SG,30,TOT,80,1663,202,485,21,79,181,406,171,226,596
2004,Bob Sura,SG,30,DET,53,707,71,173,9,36,62,137,48,69,199
2004,Bob Sura,SG,30,ATL,27,956,131,312,12,43,119,269,123,157,397
2004,Mike Sweetney,PF,21,NYK,42,494,69,140,0,1,69,139,42,58,180
2004,Stromile Swift,PF,24,MEM,77,1528,268,571,1,4,267,567,190,262,727
2004,Wally Szczerbiak,SF,26,MIN,28,622,106,236,20,46,86,190,53,64,285
2004,Maurice Taylor,PF,27,HOU,75,2081,367,765,0,2,367,763,128,174,862
2004,Jason Terry,PG,26,ATL,81,3018,499,1196,146,421,353,775,215,260,1359
2004,Etan Thomas,C,25,WAS,79,1901,257,526,0,0,257,526,191,295,705
2004,Kenny Thomas,PF,26,PHI,74,2699,381,813,1,5,380,808,243,323,1006
2004,Kurt Thomas,PF,31,NYK,80,2548,392,829,0,3,392,826,106,127,890
2004,Tim Thomas,SF,26,TOT,66,2089,363,813,73,194,290,619,171,218,970
2004,Tim Thomas,SF,26,MIL,42,1343,226,510,47,130,179,380,93,122,592
2004,Tim Thomas,SF,26,NYK,24,746,137,303,26,64,111,239,78,96,378
2004,Jamaal Tinsley,PG,25,IND,52,1378,153,370,77,207,76,163,49,67,432
2004,Robert Traylor,C,26,NOH,71,942,145,287,2,5,143,282,70,128,362
2004,Gary Trent,C,29,MIN,68,1025,155,328,0,6,155,322,69,91,379
2004,Jeff Trepagnier,SG,24,DEN,11,96,10,38,2,4,8,34,3,6,25
2004,Cezary Trybanski,C,24,TOT,7,15,0,4,0,0,0,4,1,2,1
2004,Cezary Trybanski,C,24,PHO,4,10,0,2,0,0,0,2,0,0,0
2004,Cezary Trybanski,C,24,NYK,3,5,0,2,0,0,0,2,1,2,1
2004,Jake Tsakalidis,C,24,MEM,40,533,67,133,0,0,67,133,36,61,170
2004,Nikoloz Tskitishvili,PF,20,DEN,39,307,40,122,3,11,37,111,23,29,106
2004,Hedo Turkoglu,SF,24,SAS,80,2073,262,645,101,241,161,404,114,161,739
2004,Ime Udoka,SF,26,LAL,4,28,3,9,0,1,3,8,2,4,8
2004,Nick Van,PG,32,GSW,39,1255,187,479,46,150,141,329,70,99,490
2004,Keith Van,SF,28,TOT,72,2340,410,903,93,233,317,670,249,290,1162
2004,Keith Van,SF,28,NYK,47,1574,273,613,60,161,213,452,163,199,769
2004,Keith Van,SF,28,MIL,25,766,137,290,33,72,104,218,86,91,393
2004,Jacque Vaughn,PG,28,ATL,71,1271,107,277,3,20,104,257,53,68,270
2004,Jake Voskuhl,C,26,PHO,66,1606,152,300,0,0,152,300,134,181,438
2004,Slavko Vranes,C,21,POR,1,3,0,1,0,0,0,1,0,0,0
2004,Dwyane Wade,PG,22,MIA,61,2126,371,798,16,53,355,745,233,312,991
2004,Dajuan Wagner,SG,20,CLE,44,708,112,306,31,86,81,220,32,47,287
2004,Antoine Walker,PF,27,DAL,82,2840,483,1129,82,305,401,824,103,186,1151
2004,Samaki Walker,PF,27,MIA,33,418,38,99,0,2,38,97,29,44,105
2004,Ben Wallace,C,29,DET,81,3050,315,748,1,8,314,740,142,290,773
2004,Gerald Wallace,SF,21,SAC,37,337,32,89,0,2,32,87,11,24,75
2004,John Wallace,SF,29,MIA,37,368,61,145,5,13,56,132,31,40,158
2004,Rasheed Wallace,PF,29,TOT,68,2390,425,974,82,248,343,726,156,212,1088
2004,Rasheed Wallace,PF,29,POR,45,1675,296,669,59,173,237,496,115,155,766
2004,Rasheed Wallace,PF,29,ATL,1,42,8,24,1,6,7,18,3,3,20
2004,Rasheed Wallace,PF,29,DET,22,673,121,281,22,69,99,212,38,54,302
2004,Luke Walton,PF,23,LAL,72,730,65,153,13,39,52,114,31,44,174
2004,Charlie Ward,PG,33,TOT,71,1252,160,390,84,206,76,184,20,27,424
2004,Charlie Ward,PG,33,NYK,35,827,115,260,59,138,56,122,16,21,305
2004,Charlie Ward,PG,33,SAS,36,425,45,130,25,68,20,62,4,6,119
2004,Earl Watson,PG,24,MEM,81,1669,172,464,26,106,146,358,90,138,460
2004,Clarence Weatherspoon,PF,33,TOT,52,868,104,211,0,1,104,210,53,72,261
2004,Clarence Weatherspoon,PF,33,NYK,15,216,18,40,0,0,18,40,18,19,54
2004,Clarence Weatherspoon,PF,33,HOU,37,652,86,171,0,1,86,170,35,53,207
2004,Chris Webber,PF,30,SAC,23,831,174,421,1,5,173,416,81,114,430
2004,Bonzi Wells,SG,27,TOT,72,1872,363,850,22,69,341,781,138,183,886
2004,Bonzi Wells,SG,27,POR,13,404,68,175,1,8,67,167,21,27,158
2004,Bonzi Wells,SG,27,MEM,59,1468,295,675,21,61,274,614,117,156,728
2004,Jiri Welsch,SG,24,BOS,81,2179,262,612,69,181,193,431,153,206,746
2004,David Wesley,SG,33,NOH,61,2001,311,800,92,285,219,515,137,182,851
2004,David West,PF,23,NOH,71,930,108,228,0,2,108,226,57,80,273
2004,Jahidi White,C,27,TOT,62,865,99,190,0,0,99,190,63,126,261
2004,Jahidi White,C,27,WAS,1,4,0,1,0,0,0,1,0,0,0
2004,Jahidi White,C,27,PHO,61,861,99,189,0,0,99,189,63,126,261
2004,Rodney White,SF,23,DEN,72,985,215,468,33,87,182,381,78,104,541
2004,Chris Whitney,PG,32,WAS,16,186,17,45,8,18,9,27,5,5,47
2004,Chris Wilcox,C,21,LAC,65,1340,227,436,0,1,227,435,105,150,559
2004,Mike Wilks,PG,24,HOU,26,145,17,36,6,10,11,26,10,12,50
2004,Aaron Williams,C,32,NJN,72,1337,172,342,1,3,171,339,105,155,450
2004,Alvin Williams,SG,29,TOR,56,1730,201,496,26,89,175,407,66,85,494
2004,Eric Williams,SF,31,TOT,71,1886,231,598,35,127,196,471,215,283,712
2004,Eric Williams,SF,31,BOS,21,513,77,177,11,32,66,145,78,109,243
2004,Eric Williams,SF,31,CLE,50,1373,154,421,24,95,130,326,137,174,469
2004,Frank Williams,PG,23,NYK,56,714,80,208,18,60,62,148,41,48,219
2004,Jason Williams,PG,28,MEM,72,2115,290,713,120,364,170,349,82,98,782
2004,Jerome Williams,PF,30,TOT,68,1637,158,336,0,8,158,328,106,155,422
2004,Jerome Williams,PF,30,TOR,15,407,28,57,0,1,28,56,21,29,77
2004,Jerome Williams,PF,30,CHI,53,1230,130,279,0,7,130,272,85,126,345
2004,Mo Williams,SG,21,UTA,57,772,115,303,10,39,105,264,44,56,284
2004,Scott Williams,C,35,TOT,43,527,90,186,2,3,88,183,16,27,198
2004,Scott Williams,C,35,PHO,16,267,53,101,2,2,51,99,9,13,117
2004,Scott Williams,C,35,DAL,27,260,37,85,0,1,37,84,7,14,81
2004,Shammond Williams,SG-PG,28,TOT,53,763,87,232,30,100,57,132,51,58,255
2004,Shammond Williams,SG,28,ORL,37,525,59,151,25,74,34,77,40,45,183
2004,Shammond Williams,PG,28,NOH,16,238,28,81,5,26,23,55,11,13,72
2004,Corliss Williamson,PF,30,DET,79,1574,304,602,0,0,304,602,144,197,752
2004,Kevin Willis,C,41,SAS,48,373,70,150,0,1,70,149,24,39,164
2004,Loren Woods,C,25,MIA,38,506,44,96,0,0,44,96,33,55,121
2004,Qyntel Woods,SF,22,POR,62,673,88,237,10,29,78,208,38,60,224
2004,Metta World,SF,24,IND,73,2714,468,1112,75,242,393,870,322,439,1333
2004,Lorenzen Wright,C,28,MEM,65,1674,257,586,0,5,257,581,96,131,610
2004,Wang Zhizhi,C,26,TOT,16,114,17,46,4,14,13,32,9,10,47
2004,Wang Zhizhi,C,26,LAC,2,9,0,1,0,0,0,1,4,4,4
2004,Wang Zhizhi,C,26,MIA,14,105,17,45,4,14,13,31,5,6,43
,,,,,,,,,,,,,,,
2005,Shareef Abdur-Rahim,PF,28,POR,54,1867,337,670,15,39,322,631,220,254,909
2005,Cory Alexander,SG,31,CHA,16,201,16,49,8,19,8,30,9,12,49
2005,Malik Allen,PF,26,TOT,36,519,84,177,0,0,84,177,26,28,194
2005,Malik Allen,PF,26,MIA,14,248,35,76,0,0,35,76,13,14,83
2005,Malik Allen,PF,26,CHA,22,271,49,101,0,0,49,101,13,14,111
2005,Ray Allen,SG,29,SEA,78,3064,640,1494,209,556,431,938,378,428,1867
2005,Tony Allen,SG,23,BOS,77,1262,184,387,12,31,172,356,112,152,492
2005,Rafer Alston,PG,28,TOR,80,2717,403,974,139,389,264,585,191,258,1136
2005,Chris Andersen,C,26,NOH,67,1430,191,358,0,3,191,355,131,190,513
2005,Derek Anderson,SG,30,POR,47,1239,152,391,58,151,94,240,70,87,432
2005,Kenny Anderson,PG,34,TOT,43,743,85,201,6,13,79,188,27,37,203
2005,Kenny Anderson,PG,34,ATL,39,717,81,190,6,13,75,177,27,37,195
2005,Kenny Anderson,PG,34,LAC,4,26,4,11,0,0,4,11,0,0,8
2005,Shandon Anderson,SF-SG,31,TOT,66,1171,98,217,5,29,93,188,54,66,255
2005,Shandon Anderson,SG,31,NYK,1,20,0,2,0,1,0,1,0,0,0
2005,Shandon Anderson,SF,31,MIA,65,1151,98,215,5,28,93,187,54,66,255
2005,Carmelo Anthony,SF,20,DEN,75,2608,530,1230,42,158,488,1072,456,573,1558
2005,Rafael Araujo,C,24,TOR,59,736,76,175,1,3,75,172,43,55,196
2005,Gilbert Arenas,PG,23,WAS,80,3274,656,1523,205,562,451,961,521,640,2038
2005,Trevor Ariza,SF,19,NYK,80,1382,172,389,3,13,169,376,121,174,468
2005,Darrell Armstrong,PG,36,TOT,66,988,89,277,28,111,61,166,58,68,264
2005,Darrell Armstrong,PG,36,NOH,14,412,53,159,17,70,36,89,19,21,142
2005,Darrell Armstrong,PG,36,DAL,52,576,36,118,11,41,25,77,39,47,122
2005,Carlos Arroyo,PG,25,TOT,70,1448,167,429,8,30,159,399,119,149,461
2005,Carlos Arroyo,PG,25,UTA,30,742,93,232,7,18,86,214,53,63,246
2005,Carlos Arroyo,PG,25,DET,40,706,74,197,1,12,73,185,66,86,215
2005,Chucky Atkins,PG,30,LAL,82,2903,388,910,176,455,212,455,163,203,1115
2005,Stacey Augmon,SF,36,ORL,55,663,68,167,0,0,68,167,57,77,193
2005,Maurice Baker,PG,25,TOT,5,19,0,1,0,0,0,1,0,0,0
2005,Maurice Baker,PG,25,LAC,1,1,0,0,0,0,0,0,0,0,0
2005,Maurice Baker,PG,25,POR,4,18,0,1,0,0,0,1,0,0,0
2005,Vin Baker,PF-C,33,TOT,27,204,13,42,0,1,13,41,9,17,35
2005,Vin Baker,PF,33,NYK,24,191,13,38,0,1,13,37,7,15,33
2005,Vin Baker,C,33,HOU,3,13,0,4,0,0,0,4,2,2,2
2005,Marcus Banks,PG,23,BOS,81,1145,115,286,21,59,94,227,121,163,372
2005,Leandro Barbosa,PG,22,PHO,63,1087,168,354,51,139,117,215,55,69,442
2005,Matt Barnes,SF,24,SAC,43,715,62,151,5,22,57,129,35,58,164
2005,Andre Barrett,PG,22,TOT,38,483,45,124,14,52,31,72,14,19,118
2005,Andre Barrett,PG,22,HOU,27,314,20,69,9,37,11,32,7,10,56
2005,Andre Barrett,PG,22,ORL,11,169,25,55,5,15,20,40,7,9,62
2005,Brent Barry,SG,33,SAS,81,1742,194,459,100,280,94,179,113,135,601
2005,Jon Barry,SG,35,TOT,69,1505,161,368,71,165,90,203,62,71,455
2005,Jon Barry,SG,35,ATL,16,275,31,77,11,32,20,45,10,13,83
2005,Jon Barry,SG,35,HOU,53,1230,130,291,60,133,70,158,52,58,372
2005,Tony Battie,C,28,ORL,81,1894,163,354,0,6,163,348,68,94,394
2005,Shane Battier,SG,26,MEM,80,2516,271,613,70,177,201,436,180,228,792
2005,Lonny Baxter,PF,26,NOH,4,36,3,11,0,0,3,11,0,2,6
2005,Raja Bell,SG,28,UTA,63,1790,303,667,54,134,249,533,112,150,772
2005,Jonathan Bender,SF,24,IND,7,93,16,40,1,5,15,35,3,6,36
2005,Travis Best,PG,32,NJN,76,1461,190,452,26,85,164,367,108,122,514
2005,Mike Bibby,PG,26,SAC,80,3084,560,1264,131,364,429,900,320,413,1571
2005,Andris Biedrins,C,18,GSW,30,384,45,78,0,1,45,77,19,40,109
2005,Chauncey Billups,PG,28,DET,80,2866,404,913,165,387,239,526,343,382,1316
2005,Steve Blake,PG,24,WAS,44,648,61,186,36,93,25,93,33,41,191
2005,Mark Blount,C,29,BOS,82,2130,327,618,0,1,327,617,117,164,771
2005,Tony Bobbitt,SG,25,LAL,2,12,2,5,1,2,1,3,0,0,5
2005,Keith Bogans,SG,24,CHA,74,1791,262,688,57,173,205,515,133,183,714
2005,Matt Bonner,C,24,TOR,82,1553,247,463,39,92,208,371,56,71,589
2005,Calvin Booth,C,28,TOT,51,451,49,108,0,1,49,107,26,32,124
2005,Calvin Booth,C,28,DAL,34,262,34,79,0,1,34,78,14,16,82
2005,Calvin Booth,C,28,MIL,17,189,15,29,0,0,15,29,12,16,42
2005,Carlos Boozer,PF,23,UTA,51,1772,361,693,0,1,361,692,187,268,909
2005,Curtis Borchardt,C,24,UTA,67,859,74,172,0,0,74,172,52,71,200
2005,Chris Bosh,PF,20,TOR,81,3017,473,1005,3,10,470,995,412,542,1361
2005,Bruce Bowen,SF,33,SAS,82,2627,251,598,102,253,149,345,71,112,675
2005,Ryan Bowen,SF,29,HOU,66,604,47,111,3,6,44,105,14,21,111
2005,Earl Boykins,PG,28,DEN,82,2162,340,824,56,166,284,658,279,303,1015
2005,Michael Bradley,PF,25,TOT,18,119,15,24,0,1,15,23,3,8,33
2005,Michael Bradley,PF,25,ORL,8,55,3,7,0,0,3,7,0,0,6
2005,Michael Bradley,PF,25,SAC,8,48,8,12,0,0,8,12,2,6,18
2005,Michael Bradley,PF,25,PHI,2,16,4,5,0,1,4,4,1,2,9
2005,Shawn Bradley,C,32,DAL,77,885,84,186,0,0,84,186,43,63,211
2005,Torraye Braggs,PF,28,HOU,7,24,3,7,0,0,3,7,0,0,6
2005,Elton Brand,PF,25,LAC,81,3001,629,1251,0,3,629,1248,364,484,1622
2005,Jamison Brewer,PG,24,NYK,18,185,11,37,3,15,8,22,6,13,31
2005,Primoz Brezec,C,25,CHA,72,2276,387,756,0,0,387,756,164,220,938
2005,Damone Brown,SF,25,WAS,14,152,23,62,4,11,19,51,4,9,54
2005,Devin Brown,SG,26,SAS,67,1238,173,409,45,121,128,288,103,130,494
2005,Kedrick Brown,SF,23,PHI,8,55,2,6,0,3,2,3,8,10,12
2005,Kwame Brown,PF,22,WAS,42,908,109,237,0,0,109,237,74,129,292
2005,P.J. Brown,PF,35,NOH,82,2817,338,758,0,0,338,758,210,243,886
2005,Tierre Brown,PG,25,LAL,76,1066,124,348,26,72,98,276,59,75,333
2005,Rick Brunson,PG,32,LAC,80,1945,166,442,48,130,118,312,57,74,437
2005,Kobe Bryant,SG,26,LAL,66,2689,573,1324,131,387,442,937,542,664,1819
2005,Greg Buckner,SG,28,DEN,70,1522,160,303,49,121,111,182,63,81,432
2005,Rodney Buford,SF,27,NJN,64,1313,187,489,34,108,153,381,37,45,445
2005,Antonio Burks,PG,24,MEM,24,219,28,60,3,11,25,49,14,19,73
2005,Caron Butler,SF,24,LAL,77,2746,441,991,38,125,403,866,275,319,1195
2005,Jackie Butler,C,19,NYK,3,5,4,4,0,0,4,4,2,2,10
2005,Rasual Butler,SF,25,MIA,65,1203,163,409,57,153,106,256,37,48,420
2005,Zarko Cabarkapa,PF,23,TOT,40,475,86,177,13,36,73,141,53,65,238
2005,Zarko Cabarkapa,PF,23,PHO,3,11,4,7,0,0,4,7,1,1,9
2005,Zarko Cabarkapa,PF,23,GSW,37,464,82,170,13,36,69,134,52,64,229
2005,Marcus Camby,C,30,DEN,66,2015,279,600,0,4,279,596,125,173,683
2005,Elden Campbell,C,36,TOT,40,390,39,123,0,2,39,121,42,55,120
2005,Elden Campbell,C,36,NJN,10,50,0,7,0,0,0,7,2,4,2
2005,Elden Campbell,C,36,DET,30,340,39,116,0,2,39,114,40,51,118
2005,Brian Cardinal,PF,27,MEM,58,1433,160,432,44,125,116,307,158,181,522
2005,Geno Carlisle,SG,28,POR,6,16,2,3,0,0,2,3,4,6,8
2005,Matt Carroll,SG,24,CHA,25,430,70,180,13,39,57,141,71,83,224
2005,Anthony Carter,PG,29,MIN,66,742,72,177,2,17,70,160,35,51,181
2005,Vince Carter,SF-SG,28,TOT,77,2828,696,1541,127,313,569,1228,367,460,1886
2005,Vince Carter,SG,28,TOR,20,608,124,302,19,59,105,243,50,72,317
2005,Vince Carter,SF,28,NJN,57,2220,572,1239,108,254,464,985,317,388,1569
2005,Sam Cassell,PG,35,MIN,59,1522,319,687,27,103,292,584,134,155,799
2005,Kelvin Cato,C,30,ORL,62,1525,160,297,0,0,160,297,112,143,432
2005,Lionel Chalmers,PG,24,LAC,36,433,42,125,12,49,30,76,15,24,111
2005,Tyson Chandler,C,22,CHI,80,2189,207,419,0,2,207,417,226,336,640
2005,Calbert Cheaney,SG,33,GSW,55,951,113,265,0,3,113,262,24,37,250
2005,Josh Childress,SG,21,ATL,80,2376,302,642,13,56,289,586,190,231,807
2005,Doug Christie,SG,34,TOT,52,1525,130,332,15,62,115,270,70,78,345
2005,Doug Christie,SG,34,SAC,31,996,83,204,10,39,73,165,50,56,226
2005,Doug Christie,SG,34,ORL,21,529,47,128,5,23,42,105,20,22,119
2005,Speedy Claxton,PG,26,TOT,62,1866,257,611,11,61,246,550,187,254,712
2005,Speedy Claxton,PG,26,GSW,46,1501,216,501,10,52,206,449,162,213,604
2005,Speedy Claxton,PG,26,NOH,16,365,41,110,1,9,40,101,25,41,108
2005,Mateen Cleaves,PG,27,SEA,14,65,5,14,0,2,5,12,3,4,13
2005,Derrick Coleman,C,37,DET,5,50,3,14,0,2,3,12,3,3,9
2005,Jason Collier,C,27,ATL,70,942,174,376,6,14,168,362,48,71,402
2005,Jarron Collins,C,26,UTA,50,961,65,157,0,1,65,156,83,119,213
2005,Jason Collins,C,26,NJN,80,2542,186,451,2,6,184,445,137,209,511
2005,Nick Collison,C,24,SEA,82,1396,190,354,0,3,190,351,83,118,463
2005,Brian Cook,C,24,LAL,72,1087,176,422,78,199,98,223,28,37,458
2005,Omar Cook,PG,23,TOR,5,74,10,24,0,4,10,20,3,6,23
2005,Jamal Crawford,SG,24,NYK,70,2688,437,1097,185,512,252,585,182,216,1241
2005,Austin Croshere,PF,29,IND,73,1827,188,497,45,174,143,323,226,256,647
2005,Eddy Curry,C,22,CHI,63,1808,393,730,0,0,393,730,226,314,1012
2005,Michael Curry,SF,36,IND,18,249,13,29,0,0,13,29,4,8,30
2005,Samuel Dalembert,C,23,PHI,72,1785,250,477,0,0,250,477,89,148,589
2005,Erick Dampier,C,29,DAL,59,1609,202,367,0,3,202,364,138,228,542
2005,Antonio Daniels,PG,29,SEA,75,2026,273,623,49,165,224,458,248,304,843
2005,Erik Daniels,SF,22,SAC,21,72,6,18,1,2,5,16,0,0,13
2005,Marquis Daniels,SG,24,DAL,60,1412,220,504,7,35,213,469,98,133,545
2005,Antonio Davis,PF,36,CHI,72,1843,193,419,0,0,193,419,115,152,501
2005,Baron Davis,PG,25,TOT,46,1581,291,752,118,354,173,398,185,243,885
2005,Baron Davis,PG,25,NOH,18,593,111,303,44,137,67,166,74,96,340
2005,Baron Davis,PG,25,GSW,28,988,180,449,74,217,106,232,111,147,545
2005,Dale Davis,C,35,TOT,61,1307,112,234,0,0,112,234,60,99,284
2005,Dale Davis,C,35,GSW,36,577,45,109,0,0,45,109,22,38,112
2005,Dale Davis,C,35,IND,25,730,67,125,0,0,67,125,38,61,172
2005,Josh Davis,PF,24,PHI,42,328,42,111,19,53,23,58,14,17,117
2005,Ricky Davis,SG,25,BOS,82,2696,481,1041,61,180,420,861,286,351,1309
2005,Andrew DeClercq,C,31,ORL,8,49,4,9,0,0,4,9,1,3,9
2005,Carlos Delfino,SG,22,DET,30,459,42,117,9,35,33,82,23,40,116
2005,Tony Delk,SG,31,ATL,56,1340,246,591,72,202,174,389,103,136,667
2005,Luol Deng,SF,19,CHI,61,1663,280,645,31,117,249,528,120,162,711
2005,Boris Diaw,SG,22,ATL,66,1201,124,294,9,50,115,244,57,77,314
2005,Dan Dickau,PG,26,TOT,71,2090,306,756,85,245,221,511,190,228,887
2005,Dan Dickau,PG,26,DAL,4,16,1,8,1,3,0,5,2,3,5
2005,Dan Dickau,PG,26,NOH,67,2074,305,748,84,242,221,506,188,225,882
2005,Kaniel Dickens,SF,26,NJN,11,61,4,14,3,9,1,5,2,2,13
2005,DeSagana Diop,C,23,CLE,39,306,20,69,0,2,20,67,0,5,40
2005,Vlade Divac,C,36,LAL,15,130,13,31,0,0,13,31,8,12,34
2005,Juan Dixon,SG,26,WAS,63,1054,186,447,48,147,138,300,87,97,507
2005,Michael Doleac,C,27,MIA,80,1175,148,331,0,2,148,329,25,41,321
2005,Keyon Dooling,PG,24,MIA,74,1184,139,345,19,75,120,270,85,109,382
2005,Predrag Drobnjak,C,29,ATL,71,1435,238,543,25,71,213,472,96,120,597
2005,Chris Duhon,PG,22,CHI,82,2177,172,488,94,265,78,223,49,67,487
2005,Tim Duncan,PF,28,SAS,66,2203,517,1042,3,9,514,1033,305,455,1342
2005,Mike Dunleavy,SF,24,GSW,79,2570,408,905,107,276,301,629,134,172,1057
2005,Ronald Dupree,SF,24,DET,47,472,61,127,1,2,60,125,29,47,152
2005,Ndudi Ebi,SG,20,MIN,2,54,11,21,0,1,11,20,5,9,27
2005,Corsley Edwards,C,25,NOH,10,110,10,31,0,0,10,31,7,12,27
2005,John Edwards,C,23,IND,25,139,11,30,0,0,11,30,7,14,29
2005,Howard Eisley,PG,32,UTA,74,1428,161,405,27,103,134,302,66,83,415
2005,Obinna Ekezie,C,29,ATL,42,732,79,182,0,1,79,181,72,93,230
2005,Francisco Elson,C,28,DEN,67,939,101,216,1,3,100,213,45,79,248
2005,Melvin Ely,PF,26,CHA,79,1649,227,526,0,0,227,526,122,212,576
2005,Andre Emmett,SG,22,MEM,8,28,2,6,0,0,2,6,3,5,7
2005,Maurice Evans,SG,26,SAC,65,1233,165,373,27,82,138,291,59,78,416
2005,Reggie Evans,PF,24,SEA,79,1881,131,275,0,2,131,273,125,234,387
2005,Michael Finley,SG,31,DAL,64,2358,387,907,116,285,271,622,113,136,1003
2005,Derek Fisher,PG,30,GSW,74,2222,297,755,108,291,189,464,175,203,877
2005,Marcus Fizer,PF,26,MIL,54,903,133,292,0,6,133,286,70,103,336
2005,Luis Flores,PG,23,TOT,16,77,14,29,5,10,9,19,2,2,35
2005,Luis Flores,PG,23,GSW,15,73,13,27,4,9,9,18,2,2,32
2005,Luis Flores,PG,23,DEN,1,4,1,2,1,1,0,1,0,0,3
2005,Danny Fortson,C,28,SEA,62,1047,118,226,0,0,118,226,227,258,463
2005,Jeff Foster,C,28,IND,61,1594,168,324,0,5,168,319,90,142,426
2005,Tremaine Fowlkes,SF,28,IND,8,56,9,17,1,3,8,14,0,2,19
2005,Adonal Foyle,C,29,GSW,78,1700,156,311,0,0,156,311,40,72,352
2005,Richie Frahm,SG,27,POR,43,499,56,140,31,80,25,60,21,25,164
2005,Steve Francis,PG,27,ORL,78,2978,563,1330,38,127,525,1203,499,606,1663
2005,Matt Freije,PF,23,NOH,23,441,37,127,14,54,23,73,5,8,93
2005,Lawrence Funderburke,PF,34,CHI,2,21,3,6,0,0,3,6,3,5,9
2005,Dan Gadzuric,C,26,MIL,81,1783,243,451,0,0,243,451,107,199,593
2005,Reece Gaines,PG,24,TOT,21,187,17,50,4,14,13,36,3,4,41
2005,Reece Gaines,PG,24,HOU,10,108,10,27,3,12,7,15,3,4,26
2005,Reece Gaines,PG,24,MIL,11,79,7,23,1,2,6,21,0,0,15
2005,Alex Garcia,SG,24,NOH,8,146,18,52,5,18,13,34,3,4,44
2005,Kevin Garnett,PF,28,MIN,82,3121,683,1360,6,25,677,1335,445,549,1817
2005,Pat Garrity,PF,28,ORL,71,955,123,306,49,147,74,159,29,33,324
2005,Pau Gasol,PF,24,MEM,56,1790,357,695,1,6,356,689,282,367,997
2005,Devean George,SF,27,LAL,15,306,37,104,21,58,16,46,15,20,110
2005,Eddie Gill,PG,26,IND,73,1021,81,242,36,117,45,125,71,81,269
2005,Kendall Gill,SG,36,MIL,14,284,32,80,3,9,29,71,18,20,85
2005,Manu Ginobili,SG,27,SAS,74,2193,367,780,97,258,270,522,355,442,1186
2005,Gordan Giricek,SG,27,UTA,81,1660,283,632,38,105,245,527,111,137,715
2005,Dion Glover,SG,26,SAS,7,68,8,22,1,8,7,14,8,10,25
2005,Anthony Goldwire,PG,33,TOT,33,537,57,136,32,80,25,56,26,31,172
2005,Anthony Goldwire,PG,33,DET,9,55,4,15,3,9,1,6,7,8,18
2005,Anthony Goldwire,PG,33,MIL,24,482,53,121,29,71,24,50,19,23,154
2005,Drew Gooden,PF,23,CLE,82,2523,464,943,5,28,459,915,251,310,1184
2005,Ben Gordon,SG,21,CHI,82,2002,434,1056,134,331,300,725,233,270,1235
2005,Brian Grant,C,32,LAL,69,1136,103,209,0,0,103,209,57,79,263
2005,Willie Green,SG,23,PHI,57,1066,155,423,30,105,125,318,97,125,437
2005,Adrian Griffin,SF,30,CHI,69,667,58,161,2,9,56,152,33,44,151
2005,Eddie Griffin,PF,22,MIN,70,1492,202,522,67,204,135,318,56,78,527
2005,Tom Gugliotta,PF,35,TOT,47,966,99,241,8,26,91,215,33,43,239
2005,Tom Gugliotta,PF,35,BOS,20,218,11,37,0,0,11,37,4,6,26
2005,Tom Gugliotta,PF,35,ATL,27,748,88,204,8,26,80,178,29,37,213
2005,Marcus Haislip,PF,24,IND,9,106,13,38,0,1,13,37,6,11,32
2005,Darvin Ham,SF,31,DET,47,275,17,37,0,0,17,37,12,31,46
2005,Richard Hamilton,SG,26,DET,76,2926,510,1160,36,118,474,1042,368,429,1424
2005,Zendon Hamilton,C,29,MIL,16,159,11,32,0,0,11,32,29,48,51
2005,Ben Handlogten,C,31,UTA,21,297,43,83,0,1,43,82,9,17,95
2005,Anfernee Hardaway,SF,33,NYK,37,894,110,260,15,50,95,210,34,46,269
2005,Matt Harpring,SF,28,UTA,78,2584,418,855,9,43,409,812,245,315,1090
2005,Al Harrington,SF,24,ATL,66,2550,453,986,16,74,437,912,236,351,1158
2005,Junior Harrington,SG,24,NOH,29,550,64,178,6,19,58,159,29,35,163
2005,Othella Harrington,PF,31,CHI,70,1271,217,424,0,0,217,424,127,177,561
2005,Devin Harris,PG,21,DAL,76,1173,157,366,44,131,113,235,78,103,436
2005,Lucious Harris,SG,34,CLE,73,1128,118,299,21,65,97,234,56,69,313
2005,David Harrison,C,22,IND,43,760,106,184,0,0,106,184,52,91,264
2005,Jason Hart,PG,26,CHA,74,1887,257,573,35,95,222,478,157,200,706
2005,Donnell Harvey,PF,24,NJN,3,16,2,2,0,0,2,2,4,4,8
2005,Udonis Haslem,PF,24,MIA,80,2675,346,641,0,4,346,637,178,225,870
2005,Trenton Hassell,SG,25,MIN,82,2068,225,475,1,11,224,464,90,114,541
2005,Jarvis Hayes,SF,23,WAS,54,1560,206,530,42,123,164,407,99,118,553
2005,Brendan Haywood,C,25,WAS,68,1865,239,427,0,0,239,427,159,261,637
2005,Alan Henderson,PF,32,DAL,78,1203,116,220,0,2,116,218,41,76,273
2005,Nene Hilario,C,22,DEN,55,1317,194,386,0,2,194,384,140,212,528
2005,Grant Hill,SF,32,ORL,67,2338,517,1015,3,13,514,1002,280,341,1317
2005,Kirk Hinrich,PG,24,CHI,77,2800,445,1122,145,408,300,714,171,216,1206
2005,Fred Hoiberg,SG,32,MIN,76,1272,139,284,70,145,69,139,89,102,437
2005,Robert Horry,PF,34,SAS,75,1396,157,375,51,138,106,237,86,109,451
2005,Eddie House,PG-SG,26,TOT,68,891,165,366,44,97,121,269,23,27,397
2005,Eddie House,SG,26,CHA,13,300,61,135,12,29,49,106,10,13,144
2005,Eddie House,SG,26,MIL,5,41,6,17,4,6,2,11,0,0,16
2005,Eddie House,PG,26,SAC,50,550,98,214,28,62,70,152,13,14,237
2005,Allan Houston,SG,33,NYK,20,532,85,205,31,80,54,125,36,43,237
2005,Dwight Howard,PF,19,ORL,82,2670,352,677,0,2,352,675,277,413,981
2005,Josh Howard,SF,24,DAL,76,2446,377,793,34,115,343,678,170,232,958
2005,Juwan Howard,PF,31,HOU,61,1624,244,541,0,1,244,540,97,115,585
2005,Troy Hudson,PG,28,MIN,79,1729,266,664,89,258,177,406,70,90,691
2005,Larry Hughes,SG,26,WAS,61,2358,467,1086,59,209,408,877,352,453,1345
2005,Ryan Humphrey,SF,25,MEM,35,317,42,103,0,2,42,101,18,37,102
2005,Kris Humphries,PF,19,UTA,67,873,116,287,2,6,114,281,44,101,278
2005,Brandon Hunter,PF,24,ORL,31,224,37,73,0,0,37,73,21,39,95
2005,Lindsey Hunter,SG,34,DET,76,1144,108,302,23,84,85,218,46,58,285
2005,Steven Hunter,C,23,PHO,76,1046,135,220,0,1,135,219,78,163,348
2005,Andre Iguodala,SG,21,PHI,82,2686,269,546,47,142,222,404,156,210,741
2005,Zydrunas Ilgauskas,C,29,CLE,78,2615,458,979,2,7,456,972,402,503,1320
2005,Didier Ilunga-Mbenga,C,24,DAL,15,58,6,14,0,0,6,14,3,4,15
2005,Allen Iverson*,PG,29,PHI,75,3174,771,1818,104,338,667,1480,656,786,2302
2005,Royal Ivey,PG,23,ATL,62,809,85,198,3,9,82,189,47,67,220
2005,Bobby Jackson,SG,31,SAC,25,536,109,255,33,96,76,159,50,58,301
2005,Jermaine Jackson,SG,28,NYK,21,230,17,33,0,2,17,31,8,13,42
2005,Jim Jackson,SF,34,TOT,64,1987,248,582,122,295,126,287,54,58,672
2005,Jim Jackson,SF,34,HOU,24,990,118,283,54,147,64,136,30,33,320
2005,Jim Jackson,SF,34,PHO,40,997,130,299,68,148,62,151,24,25,352
2005,Luke Jackson,SF,23,CLE,10,43,10,27,4,6,6,21,5,6,29
2005,Marc Jackson,C,30,PHI,81,1976,340,731,0,2,340,729,289,349,969
2005,Stephen Jackson,SF,26,IND,51,1806,330,819,103,286,227,533,190,229,953
2005,Casey Jacobsen,SG-SF,23,TOT,84,1798,165,408,66,177,99,231,151,192,547
2005,Casey Jacobsen,SF,23,PHO,40,768,65,157,34,89,31,68,48,62,212
2005,Casey Jacobsen,SG,23,NOH,44,1030,100,251,32,88,68,163,103,130,335
2005,Jerome James,C,29,SEA,80,1330,174,342,0,2,174,340,47,65,395
2005,LeBron James,SF,20,CLE,80,3388,795,1684,108,308,687,1376,477,636,2175
2005,Mike James,PG,29,TOT,74,1859,331,751,100,259,231,492,109,145,871
2005,Mike James,PG,29,MIL,47,1167,205,460,58,152,147,308,67,90,535
2005,Mike James,PG,29,HOU,27,692,126,291,42,107,84,184,42,55,336
2005,Antawn Jamison,PF,28,WAS,68,2605,519,1189,71,208,448,981,225,296,1334
2005,Marko Jaric,PG,26,LAC,50,1656,189,457,56,151,133,306,59,82,493
2005,Al Jefferson,PF,20,BOS,71,1051,195,369,0,3,195,366,85,135,475
2005,Richard Jefferson,SF,24,NJN,33,1355,238,564,30,89,208,475,227,269,733
2005,Jared Jeffries,SF,23,WAS,77,2007,203,434,16,51,187,383,101,173,523
2005,Horace Jenkins,PG,30,DET,15,104,15,45,0,9,15,36,12,13,42
2005,Britton Johnsen,SF,25,IND,6,87,6,22,0,4,6,18,0,0,12
2005,Anthony Johnson,PG,30,IND,63,1747,203,456,41,108,162,348,85,113,532
2005,DerMarr Johnson,SG,24,DEN,71,1232,185,371,53,148,132,223,80,101,503
2005,Ervin Johnson,C,37,MIN,46,410,28,54,1,1,27,53,16,25,73
2005,Joe Johnson,SF,23,PHO,82,3240,544,1179,177,370,367,809,135,180,1400
2005,Linton Johnson,SF,24,SAS,2,15,0,2,0,1,0,1,0,0,0
2005,Dahntay Jones,SG,24,MEM,52,649,83,190,23,60,60,130,44,64,233
2005,Damon Jones,PG,28,MIA,82,2576,331,726,225,521,106,205,68,86,955
2005,Eddie Jones,SF,33,MIA,80,2839,351,820,142,382,209,438,174,216,1018
2005,Fred Jones,SG,25,IND,77,2268,275,647,87,229,188,418,176,207,813
2005,James Jones,SF,24,IND,75,1330,126,318,66,166,60,152,53,62,371
2005,Jumaine Jones,SF,25,LAL,76,1830,210,486,102,261,108,225,55,75,577
2005,Mark Jones,SF,29,ORL,10,116,9,31,0,4,9,27,5,10,23
2005,Chris Kaman,C,22,LAC,63,1632,246,495,0,1,246,494,80,121,572
2005,Jason Kapono,SF,23,CHA,81,1491,269,671,80,194,189,477,70,85,688
2005,Mario Kasun,C,24,ORL,45,356,47,98,0,1,47,97,24,43,118
2005,Viktor Khryapa,SF,22,POR,32,523,54,124,4,11,50,113,23,42,135
2005,Jason Kidd,PG,31,NJN,66,2435,340,855,129,358,211,497,142,192,951
2005,Andrei Kirilenko,PF,23,UTA,41,1349,207,420,23,77,184,343,203,259,640
2005,Kerry Kittles,SG,30,LAC,11,243,28,73,7,21,21,52,6,10,69
2005,Brandin Knight,PG,23,HOU,1,3,0,1,0,0,0,1,0,0,0
2005,Brevin Knight,PG,29,CHA,66,1944,248,587,3,20,245,567,167,196,666
2005,Kyle Korver,SF,23,PHI,82,2667,317,759,226,558,91,201,82,96,942
2005,Nenad Krstic,PF,21,NJN,75,1965,281,570,0,2,281,568,185,255,747
2005,Toni Kukoc,SF,36,MIL,53,1099,105,256,42,116,63,140,44,61,296
2005,Ibo Kutluay,SG,30,SEA,5,12,0,1,0,0,0,1,0,0,0
2005,Christian Laettner,PF,35,MIA,49,739,107,184,1,7,106,177,45,59,260
2005,Raef LaFrentz,PF,28,BOS,80,2196,341,688,82,225,259,463,120,148,884
2005,Maciej Lampe,C,19,TOT,37,380,49,132,2,4,47,128,15,22,115
2005,Maciej Lampe,C,19,PHO,16,119,17,49,2,3,15,46,8,12,44
2005,Maciej Lampe,C,19,NOH,21,261,32,83,0,1,32,82,7,10,71
2005,Voshon Lenard,SG,31,DEN,3,54,10,26,4,12,6,14,5,8,29
2005,Rashard Lewis,SF,25,SEA,71,2697,532,1151,173,432,359,719,220,283,1457
2005,Randy Livingston,PG,29,UTA,17,227,22,52,5,8,17,44,15,17,64
2005,Shaun Livingston,PG,19,LAC,30,814,89,215,0,2,89,213,44,59,222
2005,Raul Lopez,PG,24,UTA,31,518,57,135,20,45,37,90,27,33,161
2005,Tyronn Lue,PG,27,TOT,70,2007,295,654,55,155,240,499,142,165,787
2005,Tyronn Lue,PG,27,HOU,21,479,48,122,15,45,33,77,14,18,125
2005,Tyronn Lue,PG,27,ATL,49,1528,247,532,40,110,207,422,128,147,662
2005,George Lynch,SF,34,NOH,44,933,68,189,11,37,57,152,17,23,164
2005,Mark Madsen,C,29,MIN,41,601,34,66,0,0,34,66,20,40,88
2005,Corey Maggette,SG,25,LAC,66,2436,425,986,51,168,374,818,563,657,1464
2005,Jamaal Magloire,C,26,NOH,23,703,98,227,0,0,98,227,74,123,270
2005,Stephon Marbury,PG,27,NYK,82,3281,604,1308,115,325,489,983,458,549,1781
2005,Shawn Marion,PF,26,PHO,81,3146,613,1289,114,341,499,948,229,275,1569
2005,Sean Marks,PF,29,SAS,23,244,27,80,0,3,27,77,22,28,76
2005,Donyell Marshall,PF,31,TOR,65,1645,262,592,151,363,111,229,72,91,747
2005,Darrick Martin,PG,33,LAC,11,190,16,50,5,18,11,32,5,8,42
2005,Kenyon Martin,PF,27,DEN,70,2272,444,907,0,12,444,895,199,308,1087
2005,Kevin Martin,PG,21,SAC,45,455,45,117,5,25,40,92,36,55,131
2005,Desmond Mason,SF,27,MIL,80,2893,478,1079,1,8,477,1071,420,524,1377
2005,Tony Massenburg,PF,37,SAS,61,699,74,182,0,0,74,182,48,63,196
2005,Walter McCarty,PF,30,TOT,72,906,95,235,55,155,40,80,15,29,260
2005,Walter McCarty,PF,30,BOS,44,553,62,150,30,90,32,60,8,15,162
2005,Walter McCarty,PF,30,PHO,28,353,33,85,25,65,8,20,7,14,98
2005,Jelani McCoy,C,27,ATL,10,88,7,13,0,0,7,13,1,5,15
2005,Antonio McDyess,PF,30,DET,77,1797,307,598,0,1,307,597,126,192,740
2005,Tracy McGrady,SF,25,HOU,78,3182,715,1660,142,435,573,1225,431,557,2003
2005,Jeff McInnis,PG,30,CLE,76,2651,377,915,91,264,286,651,130,160,975
2005,Aaron McKie,SG,32,PHI,68,1118,61,142,20,62,41,80,10,16,152
2005,Keith McLeod,PG,25,UTA,53,1382,143,408,18,72,125,336,112,146,416
2005,Stanislav Medvedenko,PF,25,LAL,43,423,71,156,0,1,71,155,23,28,165
2005,Ron Mercer,SF,28,NJN,18,390,65,158,0,3,65,155,7,10,137
2005,Chris Mihm,C,25,LAL,75,1870,280,552,0,2,280,550,175,258,735
2005,Darius Miles,SF,23,POR,63,1699,336,697,8,23,328,674,129,215,809
2005,Darko Milicic,C,19,DET,37,254,25,76,0,0,25,76,17,24,67
2005,Andre Miller,PG,28,DEN,82,2852,427,895,6,39,421,856,253,302,1113
2005,Anthony Miller,PF,33,ATL,2,9,2,3,0,0,2,3,0,0,4
2005,Brad Miller,C,28,SAC,56,2089,319,609,5,19,314,590,233,287,876
2005,Mike Miller,SF,24,MEM,76,2278,387,766,140,323,247,443,108,150,1022
2005,Reggie Miller*,SG,39,IND,66,2105,314,719,96,298,218,421,250,268,974
2005,Yao Ming*,C,24,HOU,80,2447,538,975,0,0,538,975,389,497,1465
2005,Cuttino Mobley,SG,29,TOT,66,2388,408,932,150,342,258,590,168,205,1134
2005,Cuttino Mobley,SG,29,ORL,23,726,128,296,58,125,70,171,55,69,369
2005,Cuttino Mobley,SG,29,SAC,43,1662,280,636,92,217,188,419,113,136,765
2005,Nazr Mohammed,C,27,TOT,77,1933,289,602,0,1,289,601,153,227,731
2005,Nazr Mohammed,C,27,NYK,54,1519,234,460,0,1,234,459,121,171,589
2005,Nazr Mohammed,C,27,SAS,23,414,55,142,0,0,55,142,32,56,142
2005,Jerome Moiso,C-PF,26,TOT,20,120,9,18,0,1,9,17,10,13,28
2005,Jerome Moiso,C,26,TOR,8,69,3,9,0,1,3,8,8,9,14
2005,Jerome Moiso,C,26,NJN,8,24,3,4,0,0,3,4,2,4,8
2005,Jerome Moiso,PF,26,CLE,4,27,3,5,0,0,3,5,0,0,6
2005,Mikki Moore,PF,29,LAC,74,1178,144,287,1,5,143,282,107,136,396
2005,Alonzo Mourning*,C-PF,34,TOT,37,702,100,212,0,0,100,212,82,141,282
2005,Alonzo Mourning*,PF,34,NJN,18,457,68,150,0,0,68,150,51,86,187
2005,Alonzo Mourning*,C,34,MIA,19,245,32,62,0,0,32,62,31,55,95
2005,Troy Murphy,PF,24,GSW,70,2375,392,947,59,148,333,799,233,319,1076
2005,Lamond Murray,SF,31,TOR,62,918,132,310,46,105,86,205,61,80,371
2005,Ronald Murray,SG,25,SEA,49,883,131,363,24,95,107,268,59,80,345
2005,Dikembe Mutombo*,C,38,HOU,80,1212,108,217,0,0,108,217,106,143,322
2005,Mamadou N'Diaye,C,29,LAC,11,72,8,20,0,1,8,19,4,7,20
2005,Bostjan Nachbar,PF-SF,24,TOT,71,1341,161,411,75,196,86,215,97,117,494
2005,Bostjan Nachbar,SF,24,HOU,16,204,15,43,10,21,5,22,9,12,49
2005,Bostjan Nachbar,PF,24,NOH,55,1137,146,368,65,175,81,193,88,105,445
2005,Lee Nailon,SF,29,NOH,68,2017,415,869,0,2,415,867,133,165,963
2005,Eduardo Najera,PF,28,TOT,68,1185,145,322,6,21,139,301,58,91,354
2005,Eduardo Najera,PF,28,GSW,42,610,70,172,6,15,64,157,29,45,175
2005,Eduardo Najera,PF,28,DEN,26,575,75,150,0,6,75,144,29,46,179
2005,Steve Nash,PG,30,PHO,75,2573,430,857,94,218,336,639,211,238,1165
2005,Jameer Nelson,PG,22,ORL,79,1612,286,628,44,141,242,487,73,107,689
2005,Rasho Nesterovic,C,28,SAS,70,1785,198,430,0,0,198,430,14,30,410
2005,Ira Newble,SG,30,CLE,74,1832,182,424,19,53,163,371,55,69,438
2005,Andres Nocioni,SF,25,CHI,81,1892,241,601,25,97,216,504,170,222,677
2005,Moochie Norris,PG,31,TOT,38,360,35,109,0,12,35,97,20,24,90
2005,Moochie Norris,PG,31,NYK,32,321,32,93,0,12,32,81,18,22,82
2005,Moochie Norris,PG,31,HOU,6,39,3,16,0,0,3,16,2,2,8
2005,Dirk Nowitzki,PF,26,DAL,78,3020,663,1445,91,228,572,1217,615,708,2032
2005,Jermaine O'Neal,PF,26,IND,44,1530,386,854,1,6,385,848,295,391,1068
2005,Shaquille O'Neal*,C,32,MIA,73,2492,658,1095,0,0,658,1095,353,765,1669
2005,Lamar Odom,PF,25,LAL,64,2320,366,774,36,117,330,657,207,298,975
2005,Emeka Okafor,PF,22,CHA,73,2600,448,1003,0,1,448,1002,209,343,1105
2005,Mehmet Okur,C,25,UTA,82,2304,354,756,17,63,337,693,329,387,1054
2005,Kevin Ollie,PG,32,PHI,26,158,11,31,0,0,11,31,6,9,28
2005,Michael Olowokandi,C,29,MIN,62,1215,161,353,0,0,161,353,46,69,368
2005,Greg Ostertag,C,31,SAC,56,556,37,84,0,2,37,82,13,38,87
2005,Bo Outlaw,PF,33,PHO,39,214,12,34,0,0,12,34,5,9,29
2005,Travis Outlaw,SF,20,POR,59,793,133,267,4,10,129,257,49,75,319
2005,Zaza Pachulia,C,20,MIL,74,1397,160,354,0,1,160,353,138,185,458
2005,Scott Padgett,PF,28,HOU,66,942,98,233,50,126,48,107,29,40,275
2005,Milt Palacio,PG,26,TOR,80,1533,175,392,2,12,173,380,115,155,467
2005,Jannero Pargo,PG,25,CHI,32,453,82,213,23,66,59,147,17,23,204
2005,Smush Parker,PG,23,TOT,16,144,18,43,3,13,15,30,9,13,48
2005,Smush Parker,PG,23,DET,11,110,11,28,2,9,9,19,9,13,33
2005,Smush Parker,PG,23,PHO,5,34,7,15,1,4,6,11,0,0,15
2005,Tony Parker,PG,22,SAS,80,2735,539,1118,43,156,496,962,210,323,1331
2005,Ruben Patterson,SF,29,POR,70,1957,319,601,2,25,317,576,169,282,809
2005,Sasha Pavlovic,SG,21,CLE,65,862,120,276,30,78,90,198,44,64,314
2005,Gary Payton*,PG,36,BOS,77,2541,339,725,42,129,297,596,153,201,873
2005,Anthony Peeler,SG,35,WAS,40,529,56,150,25,65,31,85,16,18,153
2005,Kirk Penney,SG,24,LAC,4,12,1,3,0,1,1,2,0,0,2
2005,Kendrick Perkins,C,20,BOS,60,548,56,119,0,0,56,119,37,58,149
2005,Wesley Person,SF,33,TOT,41,667,107,226,41,89,66,137,9,13,264
2005,Wesley Person,SF,33,MIA,16,206,25,57,8,21,17,36,4,4,62
2005,Wesley Person,SF,33,DEN,25,461,82,169,33,68,49,101,5,9,202
2005,Morris Peterson,SG,27,TOR,82,2510,356,848,129,335,227,513,188,226,1029
2005,Eric Piatkowski,SG,34,CHI,68,841,111,258,57,134,54,124,45,56,324
2005,Paul Pierce,SF,27,BOS,82,2960,556,1223,108,292,448,931,549,668,1769
2005,Mickael Pietrus,SF,22,GSW,67,1340,214,501,67,195,147,306,141,202,636
2005,Zoran Planinic,PG,22,NJN,43,515,78,174,15,40,63,134,46,66,217
2005,Pavel Podkolzin,C,20,DAL,5,10,0,0,0,0,0,0,1,2,1
2005,Scot Pollard,C,29,IND,49,865,79,167,0,0,79,167,33,49,191
2005,Mark Pope,PF,32,DEN,9,27,2,6,0,0,2,6,0,0,4
2005,James Posey,SF,28,MEM,50,1382,127,356,55,178,72,178,96,111,405
2005,Vitaly Potapenko,C,29,SEA,33,335,45,87,0,1,45,86,27,31,117
2005,Tayshaun Prince,SF,24,DET,82,3039,469,963,47,138,422,825,221,274,1206
2005,Laron Profit,SF,27,WAS,42,428,56,128,8,28,48,100,16,25,136
2005,Joel Przybilla,C,25,POR,76,1858,199,333,0,0,199,333,90,174,488
2005,Vladimir Radmanovic,PF,24,SEA,63,1856,266,650,128,329,138,321,81,103,741
2005,Aleksandar Radojevic,C,28,UTA,12,128,6,19,0,0,6,19,7,10,19
2005,Peter John,C,19,WAS,6,20,5,10,0,0,5,10,1,2,11
2005,Zach Randolph,PF,23,POR,46,1603,332,741,0,6,332,735,207,254,871
2005,Theo Ratliff,C,31,POR,63,1731,115,257,0,0,115,257,74,107,304
2005,Zeljko Rebraca,C,32,LAC,58,928,133,234,0,0,133,234,73,85,339
2005,Michael Redd,SG,25,MIL,75,2848,625,1418,104,293,521,1125,369,432,1723
2005,Justin Reed,SF,23,BOS,23,121,15,29,0,3,15,26,11,15,41
2005,Jared Reiner,C,22,CHI,19,132,10,30,0,0,10,30,1,4,21
2005,Jason Richardson,SG,24,GSW,72,2724,610,1368,125,370,485,998,214,309,1559
2005,Quentin Richardson,SG,24,PHO,79,2839,407,1045,226,631,181,414,136,184,1176
2005,Luke Ridnour,PG,23,SEA,82,2571,299,739,67,178,232,561,159,180,824
2005,Bernard Robinson,SG,24,CHA,31,328,36,81,3,8,33,73,18,26,93
2005,Clifford Robinson,C-PF,38,TOT,71,1689,202,523,67,193,135,330,62,97,533
2005,Clifford Robinson,C,38,GSW,42,1090,141,354,42,127,99,227,35,58,359
2005,Clifford Robinson,PF,38,NJN,29,599,61,169,25,66,36,103,27,39,174
2005,Glenn Robinson,SF,32,SAS,9,157,34,77,2,6,32,71,20,23,90
2005,Rodney Rogers,SF-PF,33,TOT,58,1367,172,450,48,168,124,282,52,70,444
2005,Rodney Rogers,SF,33,NOH,30,882,109,289,25,92,84,197,32,42,275
2005,Rodney Rogers,PF,33,PHI,28,485,63,161,23,76,40,85,20,28,169
2005,Jalen Rose,SF,32,TOR,81,2710,527,1159,108,274,419,885,333,390,1495
2005,Malik Rose,PF,30,TOT,76,1475,198,441,1,10,197,431,137,186,534
2005,Malik Rose,PF,30,SAS,50,862,124,267,0,4,124,263,69,99,317
2005,Malik Rose,PF,30,NYK,26,613,74,174,1,6,73,168,68,87,217
2005,Quinton Ross,SG,23,LAC,78,1659,161,373,1,4,160,369,74,110,397
2005,Michael Ruffin,C,28,WAS,79,1262,41,99,0,1,41,98,29,67,111
2005,Kareem Rush,SG,24,TOT,48,968,157,406,51,137,106,269,37,48,402
2005,Kareem Rush,SG,24,LAL,14,91,4,20,2,10,2,10,2,2,12
2005,Kareem Rush,SG,24,CHA,34,877,153,386,49,127,104,259,35,46,390
2005,Bryon Russell,SF,34,DEN,70,1026,95,252,56,149,39,103,61,77,307
2005,John Salmons,SG,25,PHI,58,993,85,210,31,91,54,119,35,48,236
2005,Jamal Sampson,PF,21,CHA,23,329,28,62,0,0,28,62,23,39,79
2005,Daniel Santiago,C,28,MIL,11,105,7,21,0,0,7,21,8,11,22
2005,Brian Scalabrine,PF,26,NJN,54,1167,132,332,22,68,110,264,53,69,339
2005,Ansu Sesay,SF,28,GSW,16,128,17,42,2,8,15,34,13,24,49
2005,Ha Seung-Jin,C,19,POR,19,104,10,23,0,0,10,23,6,11,26
2005,Paul Shirley,PF,27,PHO,9,30,5,11,0,0,5,11,2,4,12
2005,Bobby Simmons,SF,24,LAC,75,2799,474,1017,50,115,424,902,231,273,1229
2005,Brian Skinner,C-PF,28,TOT,49,941,104,205,0,1,104,204,25,70,233
2005,Brian Skinner,PF,28,PHI,24,246,22,57,0,1,22,56,5,17,49
2005,Brian Skinner,C,28,SAC,25,695,82,148,0,0,82,148,20,53,184
2005,Tamar Slay,SG,24,CHA,8,78,13,39,2,12,11,27,0,2,28
2005,Donta Smith,SG,21,ATL,38,433,44,113,6,22,38,91,33,48,127
2005,J.R. Smith,SG,19,NOH,76,1859,295,748,81,281,214,467,111,161,782
2005,Jabari Smith,PF,27,NJN,45,648,62,148,1,2,61,146,41,55,166
2005,Joe Smith,PF,29,MIL,74,2265,319,621,0,1,319,620,175,228,813
2005,Josh Smith,SF,19,ATL,74,2050,274,602,4,23,270,579,163,237,715
2005,Steve Smith,SG,35,TOT,50,750,102,248,41,105,61,143,69,80,314
2005,Steve Smith,SG,35,CHA,37,636,93,218,38,90,55,128,67,77,291
2005,Steve Smith,SG,35,MIA,13,114,9,30,3,15,6,15,2,3,23
2005,Theron Smith,SF,24,CHA,33,510,44,136,3,12,41,124,14,16,105
2005,Eric Snow,SG,31,CLE,81,1844,125,327,13,45,112,282,59,80,322
2005,Kirk Snyder,SG,21,UTA,68,906,122,328,30,85,92,243,64,96,338
2005,Darius Songaila,PF,26,SAC,81,1668,257,488,0,3,257,485,94,111,608
2005,Pape Sow,C,23,TOR,27,255,23,58,0,0,23,58,16,27,62
2005,Latrell Sprewell,SF,34,MIN,80,2450,398,961,69,211,329,750,156,188,1021
2005,Jerry Stackhouse,SG,30,DAL,56,1617,274,662,32,120,242,542,253,298,833
2005,DeShawn Stevenson,SG,23,ORL,55,1089,174,426,25,67,149,359,56,101,429
2005,Michael Stewart,PF,29,ATL,12,145,11,21,0,0,11,21,3,7,25
2005,Peja Stojakovic,SF,27,SAC,66,2534,451,1016,174,433,277,583,253,275,1329
2005,Awvee Storey,SG,27,NJN,9,32,3,10,1,2,2,8,1,2,8
2005,Damon Stoudamire,PG,31,POR,81,2762,457,1165,181,490,276,675,182,199,1277
2005,Amar'e Stoudemire,C,22,PHO,80,2889,747,1336,3,16,744,1320,583,795,2080
2005,Erick Strickland,SG,31,MIL,62,1014,114,304,21,83,93,221,52,64,301
2005,Rod Strickland,PG,38,HOU,16,196,9,43,1,2,8,41,9,10,28
2005,Bruno Sundov,C,24,NYK,21,73,11,37,1,3,10,34,2,2,25
2005,Bob Sura,PG,31,HOU,61,1922,215,504,55,155,160,349,141,188,626
2005,Mike Sweetney,C,22,NYK,77,1509,237,446,0,1,237,445,176,235,650
2005,Robert Swift,C,19,SEA,16,72,5,11,0,0,5,11,5,9,15
2005,Stromile Swift,PF,25,MEM,60,1279,219,488,0,4,219,484,166,219,604
2005,Wally Szczerbiak,SF,27,MIN,81,2558,465,919,63,169,402,750,260,304,1253
2005,Yuta Tabuse,PG,24,PHO,4,17,1,6,1,1,0,5,4,4,7
2005,Maurice Taylor,PF-C,28,TOT,65,1336,203,446,3,9,200,437,63,103,472
2005,Maurice Taylor,PF,28,HOU,38,905,127,292,3,8,124,284,39,60,296
2005,Maurice Taylor,C,28,NYK,27,431,76,154,0,1,76,153,24,43,176
2005,Sebastian Telfair,PG,19,POR,68,1330,169,430,17,69,152,361,105,133,460
2005,Jason Terry,PG,27,DAL,80,2401,372,743,103,245,269,498,146,173,993
2005,Billy Thomas,SF,29,NJN,25,356,34,94,17,56,17,38,7,9,92
2005,Etan Thomas,C,26,WAS,47,976,128,255,0,0,128,255,76,144,332
2005,James Thomas,PF,24,TOT,11,117,12,20,0,0,12,20,2,6,26
2005,James Thomas,PF,24,POR,9,112,11,18,0,0,11,18,2,6,24
2005,James Thomas,PF,24,ATL,2,5,1,2,0,0,1,2,0,0,2
2005,John Thomas,C,29,MIN,44,521,42,86,0,0,42,86,27,46,111
2005,Kenny Thomas,PF,27,TOT,73,2167,367,781,1,5,366,776,173,227,908
2005,Kenny Thomas,PF,27,PHI,47,1344,217,476,1,4,216,472,95,119,530
2005,Kenny Thomas,PF,27,SAC,26,823,150,305,0,1,150,304,78,108,378
2005,Kurt Thomas,PF,32,NYK,80,2855,424,901,2,4,422,897,66,84,916
2005,Tim Thomas,SF,27,NYK,71,1940,315,718,85,208,230,510,136,173,851
2005,Jamaal Tinsley,PG,26,IND,40,1301,218,522,58,156,160,366,122,164,616
2005,Robert Traylor,C,27,CLE,74,1327,177,399,0,8,177,391,55,102,409
2005,Jake Tsakalidis,C,25,MEM,31,278,32,64,0,0,32,64,14,18,78
2005,Nikoloz Tskitishvili,PF,21,TOT,35,220,22,74,2,17,20,57,4,7,50
2005,Nikoloz Tskitishvili,PF,21,DEN,23,158,15,51,0,7,15,44,4,7,34
2005,Nikoloz Tskitishvili,PF,21,GSW,12,62,7,23,2,10,5,13,0,0,16
2005,Hedo Turkoglu,SF,25,ORL,67,1757,328,782,93,245,235,537,188,225,937
2005,Beno Udrih,PG,22,SAS,80,1149,173,390,58,142,115,248,67,89,471
2005,Nick Van,SG,33,POR,53,1619,214,561,100,257,114,304,58,74,586
2005,Keith Van,SF-PF,29,TOT,62,1502,257,564,54,142,203,422,128,157,696
2005,Keith Van,SF,29,MIL,33,818,128,285,30,78,98,207,56,65,342
2005,Keith Van,PF,29,DAL,29,684,129,279,24,64,105,215,72,92,354
2005,Anderson Varejao,PF,22,CLE,54,863,99,193,0,2,99,191,68,127,266
2005,Jacque Vaughn,SG,29,NJN,71,1410,146,325,5,15,141,310,76,91,373
2005,Jake Voskuhl,C,27,PHO,38,360,27,59,0,0,27,59,26,38,80
2005,Jackson Vroman,C-PF,23,TOT,46,705,82,199,0,3,82,196,48,75,212
2005,Jackson Vroman,PF,23,PHO,10,57,6,16,0,0,6,16,4,7,16
2005,Jackson Vroman,C,23,NOH,36,648,76,183,0,3,76,180,44,68,196
2005,Sasha Vujacic,SG,20,LAL,35,403,33,117,17,63,16,54,18,19,101
2005,Dwyane Wade,SG,23,MIA,77,2974,630,1318,13,45,617,1273,581,762,1854
2005,Dajuan Wagner,SG,21,CLE,11,102,18,55,5,26,13,29,3,4,44
2005,Antoine Walker,PF,28,TOT,77,2955,581,1377,110,341,471,1036,201,373,1473
2005,Antoine Walker,PF,28,ATL,53,2128,420,1013,85,268,335,745,157,294,1082
2005,Antoine Walker,PF,28,BOS,24,827,161,364,25,73,136,291,44,79,391
2005,Samaki Walker,PF,28,WAS,14,134,11,31,0,0,11,31,2,3,24
2005,Ben Wallace,C,30,DET,74,2671,295,651,1,9,294,642,130,304,721
2005,Gerald Wallace,SF,22,CHA,70,2147,286,637,17,62,269,575,191,289,780
2005,Rasheed Wallace,PF,30,DET,79,2687,467,1062,75,236,392,826,136,195,1145
2005,Luke Walton,SF,24,LAL,61,768,74,180,16,61,58,119,34,48,198
2005,Charlie Ward,PG,34,HOU,14,360,24,77,16,51,8,26,11,13,75
2005,Earl Watson,PG,25,MEM,80,1808,236,554,52,163,184,391,91,138,615
2005,Clarence Weatherspoon,PF,34,HOU,40,525,47,114,0,0,47,114,29,35,123
2005,Chris Webber,PF,31,TOT,67,2370,555,1283,15,44,540,1239,181,228,1306
2005,Chris Webber,PF,31,SAC,46,1668,412,917,11,29,401,888,143,179,978
2005,Chris Webber,PF,31,PHI,21,702,143,366,4,15,139,351,38,49,328
2005,Bonzi Wells,SG,28,MEM,69,1489,272,617,36,104,236,513,141,188,721
2005,Jiri Welsch,SG-SF,25,TOT,71,1317,149,371,34,110,115,261,129,169,461
2005,Jiri Welsch,SG,25,BOS,55,1125,137,320,32,99,105,221,109,141,415
2005,Jiri Welsch,SF,25,CLE,16,192,12,51,2,11,10,40,20,28,46
2005,David Wesley,SG,34,TOT,80,2774,334,840,118,315,216,525,162,189,948
2005,David Wesley,SG,34,NOH,26,934,133,342,28,80,105,262,67,76,361
2005,David Wesley,SG,34,HOU,54,1840,201,498,90,235,111,263,95,113,587
2005,David West,SF,24,NOH,30,552,75,172,2,5,73,167,34,50,186
2005,Delonte West,SG,21,BOS,39,507,66,155,24,67,42,88,19,27,175
2005,Jahidi White,C,28,CHA,17,135,14,31,0,0,14,31,14,40,42
2005,Rodney White,SF,24,TOT,58,677,121,289,24,60,97,229,27,44,293
2005,Rodney White,SF,24,DEN,42,531,98,227,19,44,79,183,21,34,236
2005,Rodney White,SF,24,GSW,16,146,23,62,5,16,18,46,6,10,57
2005,Chris Wilcox,C,22,LAC,54,1005,169,329,0,0,169,329,88,144,426
2005,Damien Wilkins,SF,25,SEA,29,520,73,168,16,59,57,109,21,34,183
2005,Mike Wilks,PG,25,SAS,48,278,32,77,5,16,27,61,12,16,81
2005,Aaron Williams,C,33,TOT,42,315,29,63,0,0,29,63,15,17,73
2005,Aaron Williams,C,33,NJN,19,150,14,27,0,0,14,27,9,10,37
2005,Aaron Williams,C,33,TOR,23,165,15,36,0,0,15,36,6,7,36
2005,Eric Williams,SG,32,TOT,55,1322,142,330,28,73,114,257,112,161,424
2005,Eric Williams,SG,32,NJN,21,739,87,185,17,40,70,145,74,108,265
2005,Eric Williams,SG,32,TOR,34,583,55,145,11,33,44,112,38,53,159
2005,Frank Williams,SG,24,CHI,9,71,3,20,0,4,3,16,0,0,6
2005,Jason Williams,PG,29,MEM,71,1952,266,644,107,330,159,314,80,101,719
2005,Jerome Williams,SF,31,NYK,79,1211,122,243,0,5,122,238,115,172,359
2005,Mo Williams,PG,22,MIL,80,2254,323,737,32,99,291,638,136,160,814
2005,Scott Williams,C,36,CLE,19,152,12,41,0,1,12,40,9,11,33
2005,Corliss Williamson,PF,31,TOT,72,1527,273,584,0,2,273,582,195,244,741
2005,Corliss Williamson,PF,31,PHI,48,1056,194,417,0,2,194,415,130,165,518
2005,Corliss Williamson,PF,31,SAC,24,471,79,167,0,0,79,167,65,79,223
2005,Kevin Willis,C,42,ATL,29,344,35,90,0,2,35,88,17,23,87
2005,Loren Woods,C,26,TOR,45,712,71,164,0,1,71,163,34,59,176
2005,Qyntel Woods,SF,23,MIA,3,40,5,12,0,0,5,12,0,0,10
2005,Metta World,SF,25,IND,7,291,59,119,7,17,52,102,47,51,172
2005,Dorell Wright,SF,19,MIA,3,27,3,11,0,4,3,7,1,1,7
2005,Lorenzen Wright,C,29,MEM,80,2287,320,683,0,3,320,680,131,198,771
2005,Wang Zhizhi,C,27,MIA,20,92,17,36,2,3,15,33,7,12,43
,,,,,,,,,,,,,,,
2006,Shareef Abdur-Rahim,PF,29,SAC,72,1961,332,632,5,22,327,610,218,278,887
2006,Alex Acker,SG,23,DET,5,35,4,16,1,5,3,11,0,0,9
2006,Malik Allen,PF,27,CHI,54,701,121,247,1,1,120,246,23,38,266
2006,Ray Allen,SG,30,SEA,78,3022,681,1500,269,653,412,847,324,359,1955
2006,Tony Allen,PG,24,BOS,51,978,129,274,11,34,118,240,100,134,369
2006,Rafer Alston,PG,29,HOU,63,2431,280,738,102,312,178,426,99,143,761
2006,Chris Andersen,C,27,NOK,32,570,56,98,0,0,56,98,49,103,161
2006,Alan Anderson,SF,23,CHA,36,564,75,181,24,58,51,123,33,41,207
2006,Derek Anderson,SG,31,TOT,43,1047,108,303,40,134,68,169,93,111,349
2006,Derek Anderson,SG,31,HOU,20,582,68,173,19,67,49,106,61,73,216
2006,Derek Anderson,SG,31,MIA,23,465,40,130,21,67,19,63,32,38,133
2006,Shandon Anderson,SF,32,MIA,48,638,54,126,5,19,49,107,13,18,126
2006,Martynas Andriuskevicius,C,19,CLE,6,9,0,1,0,0,0,1,0,0,0
2006,Carmelo Anthony,SF,21,DEN,80,2941,756,1572,37,152,719,1420,573,709,2122
2006,Rafael Araujo,C,25,TOR,52,601,53,145,0,1,53,144,15,28,121
2006,Gilbert Arenas,PG,24,WAS,80,3384,746,1668,199,540,547,1128,655,799,2346
2006,Trevor Ariza,SF,20,TOT,57,999,93,226,1,5,92,221,77,127,264
2006,Trevor Ariza,SF,20,NYK,36,709,61,146,1,3,60,143,42,77,165
2006,Trevor Ariza,SF,20,ORL,21,290,32,80,0,2,32,78,35,50,99
2006,Darrell Armstrong,PG,37,DAL,62,622,43,128,11,48,32,80,33,42,130
2006,Carlos Arroyo,PG-SG,26,TOT,77,1194,168,378,7,20,161,358,106,137,449
2006,Carlos Arroyo,PG,26,DET,50,600,57,157,2,6,55,151,42,58,158
2006,Carlos Arroyo,SG,26,ORL,27,594,111,221,5,14,106,207,64,79,291
2006,Chucky Atkins,PG-SG,31,TOT,71,1713,226,573,97,274,129,299,129,163,678
2006,Chucky Atkins,SG,31,WAS,28,552,66,174,33,92,33,82,22,31,187
2006,Chucky Atkins,PG,31,MEM,43,1161,160,399,64,182,96,217,107,132,491
2006,Stacey Augmon,SF,37,ORL,36,385,25,73,0,0,25,73,21,30,71
2006,Vin Baker,C,34,LAC,8,85,7,15,0,0,7,15,13,18,27
2006,Marcus Banks,PG,24,TOT,58,1497,219,468,22,63,197,405,118,147,578
2006,Marcus Banks,PG,24,BOS,18,269,33,80,6,19,27,61,27,30,99
2006,Marcus Banks,PG,24,MIN,40,1228,186,388,16,44,170,344,91,117,479
2006,Leandro Barbosa,SG,23,PHO,57,1592,273,567,87,196,186,371,111,147,744
2006,Matt Barnes,PF-SF,25,TOT,56,631,70,140,3,15,67,125,32,47,175
2006,Matt Barnes,SF,25,NYK,6,93,11,30,1,4,10,26,3,4,26
2006,Matt Barnes,PF,25,PHI,50,538,59,110,2,11,57,99,29,43,149
2006,Andre Barrett,PG,23,TOT,19,282,38,104,2,14,36,90,9,12,87
2006,Andre Barrett,PG,23,PHO,2,21,3,7,0,1,3,6,3,3,9
2006,Andre Barrett,PG,23,TOR,17,261,35,97,2,13,33,84,6,9,78
2006,Earl Barron,C,24,MIA,8,45,5,16,0,0,5,16,3,4,13
2006,Brent Barry,SG,34,SAS,74,1259,156,345,80,202,76,143,39,59,431
2006,Jon Barry,SG,36,HOU,20,342,25,65,12,32,13,33,24,29,86
2006,Eddie Basden,SF,22,CHI,19,141,15,37,1,7,14,30,8,10,39
2006,Brandon Bass,PF,20,NOK,29,268,28,70,0,0,28,70,12,19,68
2006,Esteban Batista,PF,22,ATL,57,495,34,80,0,1,34,79,33,53,101
2006,Tony Battie,C,29,ORL,82,2215,280,552,0,6,280,546,89,134,649
2006,Shane Battier,SF,27,MEM,81,2839,303,621,65,165,238,456,147,208,818
2006,Lonny Baxter,C-PF,27,TOT,41,400,45,104,0,0,45,104,28,35,118
2006,Lonny Baxter,C,27,HOU,23,281,33,72,0,0,33,72,16,19,82
2006,Lonny Baxter,PF,27,CHA,18,119,12,32,0,0,12,32,12,16,36
2006,Charlie Bell,SG,26,MIL,59,1283,180,410,71,168,109,242,63,89,494
2006,Raja Bell,SG,29,PHO,79,2959,425,930,197,446,228,484,115,146,1162
2006,Jonathan Bender,SF,25,IND,2,21,4,5,0,0,4,5,2,2,10
2006,Mike Bibby,PG,27,SAC,82,3167,597,1382,192,497,405,885,342,403,1728
2006,Andris Biedrins,C,19,GSW,68,1000,118,185,0,0,118,185,22,72,258
2006,Chauncey Billups,PG,29,DET,81,2925,423,1012,184,425,239,587,465,520,1495
2006,Steve Blake,PG,25,POR,68,1781,206,470,76,184,130,286,72,91,560
2006,Andray Blatche,PF,19,WAS,29,175,26,67,3,13,23,54,10,12,65
2006,Mark Blount,C,30,TOT,81,2240,373,734,0,0,373,734,168,222,914
2006,Mark Blount,C,30,BOS,39,1083,194,380,0,0,194,380,97,127,485
2006,Mark Blount,C,30,MIN,42,1157,179,354,0,0,179,354,71,95,429
2006,Keith Bogans,SG-SF,25,TOT,72,1912,215,544,65,200,150,344,127,186,622
2006,Keith Bogans,SG,25,CHA,39,848,114,288,33,98,81,190,80,105,341
2006,Keith Bogans,SF,25,HOU,33,1064,101,256,32,102,69,154,47,81,281
2006,Andrew Bogut,PF,21,MIL,82,2348,323,606,0,3,323,603,122,194,768
2006,Matt Bonner,PF,25,TOR,78,1710,209,467,102,243,107,224,63,76,583
2006,Calvin Booth,C,29,WAS,33,250,20,47,1,2,19,45,5,9,46
2006,Carlos Boozer,PF,24,UTA,33,1025,219,399,0,0,219,399,99,137,537
2006,Chris Bosh,C,21,TOR,70,2751,549,1087,0,13,549,1074,474,581,1572
2006,Bruce Bowen,SF,34,SAS,82,2755,232,536,104,245,128,291,51,84,619
2006,Ryan Bowen,SF,30,HOU,68,652,37,124,3,22,34,102,11,14,88
2006,Earl Boykins,PG,29,DEN,60,1542,271,661,62,179,209,482,152,174,756
2006,Michael Bradley,PF,26,PHI,46,367,32,79,1,5,31,74,2,3,67
2006,Elton Brand,PF,26,LAC,79,3099,756,1435,1,3,755,1432,440,568,1953
2006,Primoz Brezec,C,26,CHA,79,2165,409,791,0,2,409,789,164,224,982
2006,Devin Brown,SG,27,UTA,81,1711,207,527,39,118,168,409,158,212,611
2006,Kwame Brown,C,23,LAL,72,1978,204,388,0,1,204,387,128,235,536
2006,P.J. Brown,C,36,NOK,75,2380,269,583,0,0,269,583,139,168,677
2006,Rick Brunson,PG,33,TOT,27,246,21,54,5,13,16,41,7,12,54
2006,Rick Brunson,PG,33,SEA,4,31,5,8,0,1,5,7,0,0,10
2006,Rick Brunson,PG,33,HOU,23,215,16,46,5,12,11,34,7,12,44
2006,Kobe Bryant,SG,27,LAL,80,3277,978,2173,180,518,798,1655,696,819,2832
2006,Greg Buckner,SG,29,DEN,73,1758,181,417,86,243,95,174,43,55,491
2006,Pat Burke,C,32,PHO,42,346,63,127,2,7,61,120,13,21,141
2006,Antonio Burks,PG,25,MEM,57,570,51,144,1,6,50,138,10,23,113
2006,Kevin Burleson,PG,26,CHA,39,340,22,88,10,54,12,34,16,17,70
2006,Caron Butler,SF,25,WAS,75,2708,494,1086,41,120,453,966,289,332,1318
2006,Jackie Butler,C,20,NYK,55,740,117,215,0,0,117,215,58,77,292
2006,Rasual Butler,SF,26,NOK,79,1875,257,633,92,242,165,391,79,114,685
2006,Andrew Bynum,C,18,LAL,46,338,33,82,0,0,33,82,8,27,74
2006,Will Bynum,PG,23,GSW,15,162,21,52,2,9,19,43,10,16,54
2006,Zarko Cabarkapa,PF,24,GSW,61,505,67,174,5,20,62,154,60,84,199
2006,Jose Calderon,SG,24,TOR,64,1487,132,312,7,43,125,269,78,92,349
2006,Marcus Camby,C,31,DEN,56,1857,302,649,1,11,301,638,111,156,716
2006,Brian Cardinal,PF,28,MEM,36,402,46,111,13,29,33,82,19,27,124
2006,Matt Carroll,SG,25,CHA,78,1275,192,476,72,185,120,291,138,168,594
2006,Anthony Carter,PG,30,MIN,45,589,53,137,4,15,49,122,40,55,150
2006,Vince Carter,SG,29,NJN,79,2906,653,1518,125,367,528,1151,480,601,1911
2006,Sam Cassell,PG,36,LAC,78,2653,493,1112,70,190,423,922,289,335,1345
2006,Kelvin Cato,C,31,TOT,27,333,36,84,0,0,36,84,26,35,98
2006,Kelvin Cato,C,31,ORL,23,299,31,72,0,0,31,72,26,35,88
2006,Kelvin Cato,C,31,DET,4,34,5,12,0,0,5,12,0,0,10
2006,Tyson Chandler,C,23,CHI,79,2121,160,283,0,1,160,282,97,193,417
2006,Calbert Cheaney,SF,34,GSW,42,448,42,108,0,8,42,100,8,8,92
2006,Josh Childress,SF,22,ATL,74,2249,278,504,32,65,246,439,154,201,742
2006,Doug Christie,SG,35,DAL,7,185,9,26,0,1,9,25,8,12,26
2006,Speedy Claxton,PG,27,NOK,71,2019,304,736,17,63,287,673,246,320,871
2006,Mateen Cleaves,PG,28,SEA,27,230,25,71,4,16,21,55,19,24,73
2006,Jarron Collins,C,27,UTA,79,1730,129,280,0,0,129,280,157,219,415
2006,Jason Collins,C,27,NJN,71,1895,104,262,3,12,101,250,44,86,255
2006,Nick Collison,PF,25,SEA,66,1448,207,394,0,3,207,391,79,113,493
2006,Brian Cook,PF,25,LAL,81,1535,261,511,36,84,225,427,84,101,642
2006,Jamal Crawford,SG,25,NYK,79,2555,366,879,101,293,265,586,295,357,1128
2006,Austin Croshere,PF,30,IND,50,1148,132,285,54,140,78,145,90,102,408
2006,Eddy Curry,C,23,NYK,72,1865,336,597,0,0,336,597,307,486,979
2006,Samuel Dalembert,C,24,PHI,66,1761,196,369,0,1,196,368,93,132,485
2006,Erick Dampier,C,30,DAL,82,1934,171,347,0,0,171,347,127,215,469
2006,Antonio Daniels,SG,30,WAS,80,2283,230,550,23,101,207,449,284,336,767
2006,Marquis Daniels,SG,25,DAL,62,1766,246,512,4,19,242,493,138,183,634
2006,Antonio Davis,PF-C,37,TOT,44,940,82,190,0,1,82,189,52,81,216
2006,Antonio Davis,PF,37,NYK,36,749,68,159,0,1,68,158,45,61,181
2006,Antonio Davis,C,37,TOR,8,191,14,31,0,0,14,31,7,20,35
2006,Baron Davis,PG,26,GSW,54,1971,335,861,102,324,233,537,195,289,967
2006,Dale Davis,C,36,DET,28,178,9,24,0,1,9,23,8,15,26
2006,Josh Davis,PF,25,TOT,6,17,2,7,0,2,2,5,2,3,6
2006,Josh Davis,PF,25,MIL,4,12,1,4,0,1,1,3,0,0,2
2006,Josh Davis,PF,25,HOU,1,0,0,0,0,0,0,0,0,0,0
2006,Josh Davis,PF,25,PHO,1,5,1,3,0,1,1,2,2,3,4
2006,Ricky Davis,SG-SF,26,TOT,78,3207,584,1304,73,242,511,1062,275,345,1516
2006,Ricky Davis,SG,26,BOS,42,1747,329,709,40,125,289,584,129,164,827
2006,Ricky Davis,SF,26,MIN,36,1460,255,595,33,117,222,478,146,181,689
2006,Carlos Delfino,SG,23,DET,68,726,91,226,20,60,71,166,45,67,247
2006,Tony Delk,PG-SG,32,TOT,24,385,71,161,20,47,51,114,20,27,182
2006,Tony Delk,SG,32,ATL,1,7,0,1,0,0,0,1,2,2,2
2006,Tony Delk,PG,32,DET,23,378,71,160,20,47,51,113,18,25,180
2006,Luol Deng,SF,20,CHI,78,2604,442,954,21,78,421,876,207,276,1112
2006,Boris Diaw,PF,23,PHO,81,2874,449,853,8,30,441,823,174,238,1080
2006,Dan Dickau,PG,27,BOS,19,234,17,46,10,20,7,26,18,18,62
2006,Travis Diener,PG,23,ORL,23,246,29,69,25,57,4,12,5,6,88
2006,Ike Diogu,PF,22,GSW,69,1031,175,334,0,0,175,334,136,168,486
2006,DeSagana Diop,C,24,DAL,81,1510,75,154,1,2,74,152,39,72,190
2006,Juan Dixon,SG,27,POR,76,1920,357,821,65,170,292,651,156,194,935
2006,Michael Doleac,C,28,MIA,31,371,37,88,0,0,37,88,24,30,98
2006,Keyon Dooling,PG,25,ORL,50,1137,178,405,13,43,165,362,101,121,470
2006,Chris Duhon,PG,23,CHI,74,2155,215,538,100,278,115,260,117,143,647
2006,Tim Duncan,PF,29,SAS,80,2784,574,1185,2,5,572,1180,335,533,1485
2006,Mike Dunleavy,SF,25,GSW,81,2578,331,816,74,260,257,556,196,252,932
2006,Ronald Dupree,SF,25,MIN,36,265,33,63,0,1,33,62,14,41,80
2006,John Edwards,C,24,ATL,40,296,31,64,0,0,31,64,8,11,70
2006,Howard Eisley,PG,33,TOT,32,394,34,103,13,42,21,61,20,24,101
2006,Howard Eisley,PG,33,LAC,13,112,4,17,1,4,3,13,0,0,9
2006,Howard Eisley,PG,33,DEN,19,282,30,86,12,38,18,48,20,24,92
2006,Monta Ellis,SG,20,GSW,49,886,132,318,28,82,104,236,42,59,334
2006,Francisco Elson,C,29,DEN,72,1579,151,284,1,5,150,279,49,74,352
2006,Melvin Ely,PF,27,CHA,57,1348,216,425,0,2,216,423,128,192,560
2006,Maurice Evans,SG,27,DET,80,1139,154,341,43,116,111,225,52,65,403
2006,Reggie Evans,PF,25,TOT,67,1393,131,268,0,1,131,267,115,217,377
2006,Reggie Evans,PF,25,SEA,41,788,88,173,0,1,88,172,66,120,242
2006,Reggie Evans,PF,25,DEN,26,605,43,95,0,0,43,95,49,97,135
2006,Daniel Ewing,SG,22,LAC,66,971,97,255,22,78,75,177,36,46,252
2006,Noel Felix,SF,24,SEA,12,82,6,25,1,3,5,22,5,8,18
2006,Raymond Felton,PG,21,CHA,80,2406,345,883,97,271,248,612,161,222,948
2006,Michael Finley,SG,32,SAS,77,2038,286,695,110,279,176,416,98,115,780
2006,Derek Fisher,PG,31,GSW,82,2589,364,887,117,295,247,592,244,293,1089
2006,Gerald Fitch,PG,23,MIA,18,239,30,89,7,26,23,63,17,23,84
2006,Marcus Fizer,PF,27,NOK,3,39,9,17,1,1,8,16,1,2,20
2006,Sharrod Ford,PF,24,PHO,3,13,2,3,0,0,2,3,0,0,4
2006,T.J. Ford,PG,22,MIL,72,2557,328,789,35,104,293,685,187,248,878
2006,Danny Fortson,C,29,SEA,23,276,27,51,0,0,27,51,33,43,87
2006,Jeff Foster,C,29,IND,63,1581,138,250,0,4,138,246,96,159,372
2006,Adonal Foyle,C,30,GSW,77,1824,152,300,0,0,152,300,41,67,345
2006,Richie Frahm,SG,28,TOT,33,342,39,100,23,70,16,30,7,10,108
2006,Richie Frahm,SG,28,MIN,25,225,24,65,15,48,9,17,3,5,66
2006,Richie Frahm,SG,28,HOU,8,117,15,35,8,22,7,13,4,5,42
2006,Steve Francis,PG-SG,28,TOT,70,2393,333,765,25,83,308,682,314,399,1005
2006,Steve Francis,PG,28,ORL,46,1734,249,575,18,70,231,505,231,290,747
2006,Steve Francis,SG,28,NYK,24,659,84,190,7,13,77,177,83,109,258
2006,Channing Frye,C,22,NYK,65,1572,305,640,3,9,302,631,189,229,802
2006,Dan Gadzuric,C,27,MIL,74,885,171,309,0,1,171,308,41,89,383
2006,Deng Gai,C,23,PHI,2,5,0,0,0,0,0,0,0,0,0
2006,Reece Gaines,PG,25,MIL,12,54,6,12,0,2,6,10,1,4,13
2006,Francisco Garcia,SF,24,SAC,67,1301,130,325,39,137,91,188,78,101,377
2006,Kevin Garnett,PF,29,MIN,76,2957,626,1191,8,30,618,1161,396,489,1656
2006,Pat Garrity,PF,29,ORL,57,938,101,242,50,129,51,113,30,37,282
2006,Pau Gasol,PF,25,MEM,80,3135,600,1194,3,12,597,1182,425,617,1628
2006,Devean George,SF,28,LAL,71,1542,170,425,50,160,120,265,58,86,448
2006,Eddie Gill,PG,27,IND,41,122,10,45,7,23,3,22,18,23,45
2006,Manu Ginobili,SG,28,SAS,65,1813,309,669,83,217,226,452,280,360,981
2006,Gordan Giricek,SG,28,UTA,37,956,166,383,18,59,148,324,43,57,393
2006,Anthony Goldwire,PG,34,LAC,3,22,1,7,0,2,1,5,0,0,2
2006,Ryan Gomes,PF,23,BOS,61,1376,173,355,3,9,170,346,112,149,461
2006,Drew Gooden,PF,24,CLE,79,2174,334,652,1,3,333,649,176,258,845
2006,Ben Gordon,SG,22,CHI,80,2482,486,1152,166,382,320,770,211,268,1349
2006,Joey Graham,SF,23,TOR,80,1581,198,414,29,87,169,327,108,133,533
2006,Stephen Graham,SG,23,TOT,22,175,21,54,2,10,19,44,14,15,58
2006,Stephen Graham,SG,23,HOU,6,38,6,16,1,5,5,11,4,4,17
2006,Stephen Graham,SG,23,CHI,3,20,1,5,1,4,0,1,2,2,5
2006,Stephen Graham,SG,23,CLE,13,117,14,33,0,1,14,32,8,9,36
2006,Danny Granger,SF,22,IND,78,1765,221,478,30,93,191,385,115,148,587
2006,Brian Grant,C,33,PHO,21,248,27,65,0,0,27,65,7,8,61
2006,Devin Green,SG,23,LAL,27,135,6,28,0,2,6,26,13,21,25
2006,Gerald Green,SG,20,BOS,32,374,66,138,6,20,60,118,29,37,167
2006,Willie Green,SG,24,PHI,10,153,28,66,10,19,18,47,4,5,70
2006,Orien Greene,PG,23,BOS,80,1235,100,253,9,40,91,213,45,68,254
2006,Adrian Griffin,SG,31,DAL,52,1245,98,204,0,2,98,202,41,53,237
2006,Eddie Griffin,C,23,MIN,70,1359,130,370,16,82,114,288,44,74,320
2006,Anthony Grundy,SG,26,ATL,12,108,19,38,5,15,14,23,9,14,52
2006,Richard Hamilton,SG,27,DET,80,2825,649,1322,55,120,594,1202,256,303,1609
2006,Zendon Hamilton,C,30,TOT,12,49,7,14,0,0,7,14,12,18,26
2006,Zendon Hamilton,C,30,CLE,11,46,7,13,0,0,7,13,11,16,25
2006,Zendon Hamilton,C,30,PHI,1,3,0,1,0,0,0,1,1,2,1
2006,Anfernee Hardaway,SF,34,NYK,4,72,4,14,0,1,4,13,2,2,10
2006,Matt Harpring,SF,29,UTA,71,1944,322,678,14,39,308,639,227,313,885
2006,Al Harrington,PF,25,ATL,76,2782,551,1220,66,191,485,1029,243,350,1411
2006,Othella Harrington,C,32,CHI,72,824,135,273,0,0,135,273,77,123,347
2006,Devin Harris,PG,22,DAL,56,1275,190,405,5,21,185,384,169,236,554
2006,David Harrison,C,23,IND,67,1034,148,294,0,0,148,294,89,174,385
2006,Jason Hart,PG,27,SAC,66,818,86,221,9,31,77,190,37,56,218
2006,Udonis Haslem,PF,25,MIA,81,2491,300,591,0,2,300,589,157,199,757
2006,Trenton Hassell,SG,26,MIN,77,2514,286,616,7,23,279,593,131,176,710
2006,Chuck Hayes,PF,22,HOU,40,535,59,105,0,1,59,104,29,45,147
2006,Jarvis Hayes,SG,24,WAS,21,516,77,183,17,47,60,136,25,30,196
2006,Brendan Haywood,C,26,WAS,79,1879,222,432,0,0,222,432,131,224,575
2006,Luther Head,SG,23,HOU,80,2310,254,630,113,313,141,317,86,123,707
2006,Alan Henderson,C,33,CLE,51,531,47,91,0,0,47,91,33,49,127
2006,Nene Hilario,PF,23,DEN,1,3,0,1,0,0,0,1,0,0,0
2006,Grant Hill,SF,33,ORL,21,613,119,243,2,8,117,235,78,102,318
2006,Kirk Hinrich,PG,25,CHI,81,2955,451,1078,126,341,325,737,256,314,1284
2006,Julius Hodge,SG,22,DEN,14,33,5,13,0,0,5,13,3,8,13
2006,Randy Holcomb,SF,26,CHI,4,11,1,1,0,0,1,1,0,0,2
2006,Robert Horry,PF,35,SAS,63,1182,112,292,53,144,59,148,44,68,321
2006,Eddie House,PG,27,PHO,81,1421,320,759,123,316,197,443,33,41,796
2006,Dwight Howard,PF,20,ORL,82,3021,468,881,0,2,468,879,356,598,1292
2006,Josh Howard,SF,25,DAL,59,1915,350,743,27,63,323,680,196,267,923
2006,Juwan Howard,PF,32,HOU,80,2537,394,859,0,4,394,855,154,191,942
2006,Troy Hudson,PG,29,MIN,36,800,127,333,40,101,87,232,48,52,342
2006,Larry Hughes,SG,27,CLE,36,1281,192,469,28,76,164,393,146,193,558
2006,Kris Humphries,PF,20,UTA,62,619,77,203,0,5,77,198,34,65,188
2006,Lindsey Hunter,PG,35,DET,30,353,37,100,11,43,26,57,2,4,87
2006,Steven Hunter,C,24,PHI,69,1312,175,291,0,0,175,291,71,138,421
2006,Andre Iguodala,SF,22,PHI,82,3086,344,688,56,158,288,530,263,349,1007
2006,Zydrunas Ilgauskas,C,30,CLE,78,2283,450,889,0,5,450,884,317,380,1217
2006,Didier Ilunga-Mbenga,C,25,DAL,43,237,32,60,0,1,32,59,10,20,74
2006,Allen Iverson*,PG,30,PHI,72,3103,815,1822,72,223,743,1599,675,829,2377
2006,Royal Ivey,PG,24,ATL,73,978,116,264,4,10,112,254,24,33,260
2006,Jarrett Jack,SG,22,POR,79,1599,189,428,20,76,169,352,128,160,526
2006,Bobby Jackson,PG,32,MEM,71,1775,286,748,129,332,157,416,107,146,808
2006,Jermaine Jackson,PG,29,MIL,30,202,11,26,1,4,10,22,12,14,35
2006,Jim Jackson,SF,35,TOT,40,512,47,160,18,74,29,86,9,13,121
2006,Jim Jackson,SF,35,PHO,27,420,38,129,14,63,24,66,9,13,99
2006,Jim Jackson,SF,35,LAL,13,92,9,31,4,11,5,20,0,0,22
2006,Luke Jackson,SF,24,CLE,36,315,29,85,12,36,17,49,26,33,96
2006,Marc Jackson,C,31,TOT,64,1027,174,369,1,2,173,367,66,82,415
2006,Marc Jackson,C,31,NJN,37,433,66,148,0,0,66,148,38,48,170
2006,Marc Jackson,C,31,NOK,27,594,108,221,1,2,107,219,28,34,245
2006,Stephen Jackson,SG,27,IND,81,2910,472,1148,117,339,355,809,268,341,1329
2006,Jerome James,C,30,NYK,45,406,56,121,0,0,56,121,25,40,137
2006,LeBron James,SF,21,CLE,79,3361,875,1823,127,379,748,1444,601,814,2478
2006,Mike James,PG,30,TOR,79,2925,576,1228,169,382,407,846,283,338,1604
2006,Antawn Jamison,SF,29,WAS,82,3288,660,1494,147,373,513,1121,217,297,1684
2006,Marko Jaric,PG,27,MIN,75,2102,226,566,40,133,186,433,95,138,587
2006,Sarunas Jasikevicius,PG,29,IND,75,1557,170,429,86,236,84,193,121,133,547
2006,Al Jefferson,PF,21,BOS,59,1062,189,379,0,4,189,375,86,134,464
2006,Richard Jefferson,SF,25,NJN,78,3059,495,1005,60,188,435,817,471,580,1521
2006,Jared Jeffries,PF,24,WAS,77,1951,187,415,16,50,171,365,99,168,489
2006,Amir Johnson,SF,18,DET,3,39,7,10,2,3,5,7,4,4,20
2006,Anthony Johnson,PG,31,IND,75,1981,267,603,51,155,216,448,106,141,691
2006,DerMarr Johnson,SG,25,DEN,58,924,132,306,56,160,76,146,34,42,354
2006,Ervin Johnson,C,38,MIL,18,81,7,17,0,0,7,17,1,2,15
2006,Joe Johnson,SG,24,ATL,82,3340,632,1395,128,360,504,1035,261,330,1653
2006,Linton Johnson,SF,25,TOT,36,524,61,149,13,36,48,113,18,27,153
2006,Linton Johnson,SF,25,NJN,9,35,5,10,0,0,5,10,1,4,11
2006,Linton Johnson,SF,25,NOK,27,489,56,139,13,36,43,103,17,23,142
2006,Dahntay Jones,SF,25,MEM,71,967,109,263,3,21,106,242,60,93,281
2006,Damon Jones,PG,29,CLE,82,2089,190,491,140,371,50,120,32,50,552
2006,Dwayne Jones,PF,22,BOS,14,87,4,10,0,0,4,10,6,13,14
2006,Eddie Jones,SG,34,MEM,75,2437,292,722,133,374,159,348,168,215,885
2006,Fred Jones,SG,26,IND,68,1837,233,559,63,187,170,372,122,160,651
2006,James Jones,SF,25,PHO,75,1772,243,581,110,285,133,296,103,121,699
2006,Jumaine Jones,PF,26,CHA,76,2089,298,736,115,335,183,401,88,121,799
2006,Chris Kaman,C,23,LAC,78,2560,369,706,0,2,369,704,194,252,932
2006,Jason Kapono,SF,24,MIA,51,665,79,177,21,53,58,124,28,33,207
2006,Mario Kasun,C,25,ORL,28,213,31,69,0,0,31,69,18,23,80
2006,Viktor Khryapa,SF,23,POR,69,1492,158,342,10,30,148,312,77,111,403
2006,Jason Kidd,PG,32,NJN,80,2975,366,905,139,395,227,510,194,244,1065
2006,Andrei Kirilenko,SF,24,UTA,69,2604,336,730,36,117,300,613,346,495,1054
2006,Linas Kleiza,PF,21,DEN,61,519,77,173,2,13,75,160,57,81,213
2006,Brevin Knight,PG,30,CHA,69,2351,308,772,3,13,305,759,252,314,871
2006,Yaroslav Korolev,SF,18,LAC,24,127,9,30,2,7,7,23,7,10,27
2006,Kyle Korver,SF,24,PHI,82,2563,327,761,184,438,143,323,101,119,939
2006,Nenad Krstic,PF,22,NJN,80,2469,447,881,1,4,446,877,185,265,1080
2006,Toni Kukoc,PF,37,MIL,65,1018,116,298,45,147,71,151,40,56,317
2006,Raef LaFrentz,PF,29,BOS,82,2033,238,552,112,286,126,266,51,75,639
2006,Maciej Lampe,C,20,TOT,6,28,2,11,0,0,2,11,0,2,4
2006,Maciej Lampe,C,20,NOK,2,16,0,4,0,0,0,4,0,0,0
2006,Maciej Lampe,C,20,HOU,4,12,2,7,0,0,2,7,0,2,4
2006,David Lee,SF,22,NYK,67,1129,137,230,0,0,137,230,71,123,345
2006,Voshon Lenard,SG,32,TOT,26,458,75,191,25,78,50,113,16,31,191
2006,Voshon Lenard,SG,32,DEN,12,238,42,103,10,35,32,68,5,13,99
2006,Voshon Lenard,SG,32,POR,14,220,33,88,15,43,18,45,11,18,92
2006,Rashard Lewis,SF,26,SEA,78,2876,538,1151,142,370,396,781,350,428,1568
2006,Randy Livingston,PG,30,CHI,5,22,0,2,0,0,0,2,0,0,0
2006,Shaun Livingston,PG,20,LAC,61,1525,149,349,1,8,148,341,53,77,352
2006,John Lucas,PG,23,HOU,13,107,14,36,2,9,12,27,0,0,30
2006,Tyronn Lue,PG,28,ATL,51,1234,192,418,58,127,134,291,118,138,560
2006,Arvydas Macijauskas,SG,26,NOK,19,135,14,41,3,12,11,29,13,15,44
2006,Mark Madsen,C,30,MIN,62,676,27,66,0,7,27,59,20,47,74
2006,Corey Maggette,SF,26,LAC,32,943,167,375,24,71,143,304,212,256,570
2006,Jamaal Magloire,C,27,MIL,82,2465,287,615,0,0,287,615,178,333,752
2006,Stephon Marbury,PG,28,NYK,60,2193,349,774,33,104,316,670,246,326,977
2006,Shawn Marion,PF,27,PHO,81,3263,716,1365,96,290,620,1075,241,298,1769
2006,Sean Marks,PF,30,SAS,25,181,37,71,0,3,37,68,7,12,81
2006,Donyell Marshall,PF,32,CLE,81,2077,265,671,128,395,137,276,92,123,750
2006,Rawle Marshall,SF,23,DAL,23,241,24,60,1,3,23,57,22,29,71
2006,Darrick Martin,PG,34,TOR,40,339,34,97,16,40,18,57,18,24,102
2006,Kenyon Martin,PF,28,DEN,56,1546,297,600,5,22,292,578,121,170,720
2006,Kevin Martin,SG,22,SAC,72,1913,262,546,66,179,196,367,188,222,778
2006,Desmond Mason,SF,28,NOK,70,2102,275,690,1,6,274,684,206,302,757
2006,Jason Maxiell,PF,22,DET,26,159,23,54,0,0,23,54,14,42,60
2006,Sean May,PF,21,CHA,23,398,70,171,0,5,70,166,49,64,189
2006,Rashad McCants,SG,21,MIN,79,1362,241,535,67,180,174,355,78,106,627
2006,Walter McCarty,SF,31,LAC,36,353,33,99,10,45,23,54,12,21,88
2006,Antonio McDyess,PF,31,DET,82,1733,285,560,0,2,285,558,68,122,638
2006,Tracy McGrady,SF,26,HOU,47,1745,410,1011,73,234,337,777,254,340,1147
2006,Jeff McInnis,SG,31,NJN,28,486,63,143,3,16,60,127,20,29,149
2006,Aaron McKie,PG,33,LAL,14,121,3,12,0,2,3,10,1,2,7
2006,Keith McLeod,PG,26,UTA,66,1232,120,340,24,82,96,258,106,133,370
2006,Stanislav Medvedenko,PF,26,LAL,2,6,1,2,0,0,1,2,0,0,2
2006,Chris Mihm,C,26,LAL,59,1541,230,459,0,0,230,459,144,201,604
2006,Aaron Miles,PG,22,GSW,19,118,6,18,0,0,6,18,4,4,16
2006,C.J. Miles,PG,18,UTA,23,203,28,76,5,20,23,56,18,24,79
2006,Darius Miles,SF,24,POR,40,1286,235,510,2,10,233,500,87,163,559
2006,Darko Milicic,C,20,TOT,55,767,119,234,0,2,119,232,28,50,266
2006,Darko Milicic,C,20,DET,25,140,17,33,0,2,17,31,3,8,37
2006,Darko Milicic,C,20,ORL,30,627,102,201,0,0,102,201,25,42,229
2006,Andre Miller,PG,29,DEN,82,2937,404,872,5,27,399,845,313,424,1126
2006,Brad Miller,C,29,SAC,79,2923,434,877,34,88,400,789,280,338,1182
2006,Mike Miller,SG,25,MEM,74,2268,354,760,138,339,216,421,168,210,1014
2006,Yao Ming*,C,25,HOU,57,1949,467,900,0,1,467,899,337,395,1271
2006,Cuttino Mobley,SF,30,LAC,79,2979,429,1008,83,245,346,763,229,273,1170
2006,Nazr Mohammed,C,28,SAS,80,1389,190,377,0,0,190,377,113,144,493
2006,Sergei Monia,SF,22,TOT,26,343,29,87,9,34,20,53,10,14,77
2006,Sergei Monia,SF,22,POR,23,336,29,85,9,33,20,52,8,12,75
2006,Sergei Monia,SF,22,SAC,3,7,0,2,0,1,0,1,2,2,2
2006,Mikki Moore,C,30,SEA,47,583,54,124,0,2,54,122,46,62,154
2006,Terence Morris,SF,27,ORL,22,192,16,49,0,2,16,47,3,3,35
2006,Alonzo Mourning*,C,35,MIA,65,1302,188,315,0,1,188,314,133,224,509
2006,Troy Murphy,PF,25,GSW,74,2516,363,838,58,181,305,657,251,319,1035
2006,Lamond Murray,SF,32,NJN,57,576,72,181,27,78,45,103,25,40,196
2006,Ronald Murray,SG,26,TOT,76,2112,321,768,37,141,284,627,172,242,851
2006,Ronald Murray,SG,26,SEA,48,1085,179,451,17,76,162,375,99,138,474
2006,Ronald Murray,SG,26,CLE,28,1027,142,317,20,65,122,252,73,104,377
2006,Dikembe Mutombo*,C,39,HOU,64,955,50,95,0,0,50,95,69,91,169
2006,Boniface N'Dong,C,28,LAC,23,152,22,53,0,1,22,52,6,9,50
2006,Bostjan Nachbar,PF-SF,25,TOT,36,502,54,156,19,71,35,85,30,44,157
2006,Bostjan Nachbar,PF,25,NOK,25,405,42,124,17,57,25,67,25,36,126
2006,Bostjan Nachbar,SF,25,NJN,11,97,12,32,2,14,10,18,5,8,31
2006,Lee Nailon,PF,30,PHI,22,237,40,80,0,0,40,80,13,15,93
2006,Eduardo Najera,PF,29,DEN,64,1449,127,301,4,12,123,289,89,114,347
2006,Steve Nash,PG,31,PHO,79,2796,541,1056,150,342,391,714,257,279,1489
2006,Jameer Nelson,PG,23,ORL,62,1784,347,719,70,165,277,554,141,181,905
2006,Rasho Nesterovic,C,29,SAS,80,1515,172,334,0,2,172,332,18,30,362
2006,Ira Newble,SG,31,CLE,36,353,17,57,3,13,14,44,11,16,48
2006,Andres Nocioni,PF,26,CHI,82,2239,383,831,93,238,290,593,204,242,1063
2006,Moochie Norris,PG,32,TOT,45,424,46,112,4,14,42,98,29,42,125
2006,Moochie Norris,PG,32,HOU,29,241,26,65,0,5,26,60,13,17,65
2006,Moochie Norris,PG,32,NOK,16,183,20,47,4,9,16,38,16,25,60
2006,Dirk Nowitzki,PF,27,DAL,81,3089,751,1564,110,271,641,1293,539,598,2151
2006,Jermaine O'Neal,PF,27,IND,51,1802,380,805,3,10,377,795,261,368,1024
2006,Shaquille O'Neal*,C,33,MIA,59,1806,480,800,0,0,480,800,221,471,1181
2006,Fabricio Oberto,C,30,SAS,59,490,44,93,0,2,44,91,15,27,103
2006,Lamar Odom,PF,26,LAL,80,3221,445,925,80,215,365,710,216,313,1186
2006,Emeka Okafor,PF,23,CHA,26,874,131,316,0,0,131,316,82,125,344
2006,Mehmet Okur,PF,26,UTA,82,2945,519,1128,80,234,439,894,354,454,1472
2006,Kevin Ollie,SG,33,PHI,70,1069,75,174,1,3,74,171,41,49,192
2006,Michael Olowokandi,C,30,TOT,48,919,107,240,0,0,107,240,24,47,238
2006,Michael Olowokandi,C,30,MIN,32,752,87,195,0,0,87,195,19,39,193
2006,Michael Olowokandi,C,30,BOS,16,167,20,45,0,0,20,45,5,8,45
2006,Greg Ostertag,C,32,UTA,60,807,61,124,0,0,61,124,24,48,146
2006,Bo Outlaw,PF,34,ORL,32,355,35,58,0,0,35,58,5,8,75
2006,Travis Outlaw,PF,21,POR,69,1153,162,368,14,53,148,315,62,89,400
2006,Andre Owens,PG,25,UTA,23,210,27,74,3,16,24,58,12,18,69
2006,Zaza Pachulia,C,21,ATL,78,2452,307,681,0,2,307,679,297,404,911
2006,Scott Padgett,PF,29,NJN,62,718,71,201,42,121,29,80,27,34,211
2006,Milt Palacio,PG,27,UTA,71,1376,171,403,1,16,170,387,98,150,441
2006,Jannero Pargo,PG,26,CHI,57,646,109,292,39,103,70,189,17,21,274
2006,Smush Parker,PG,24,LAL,82,2773,348,779,120,328,228,451,125,180,941
2006,Tony Parker,PG,23,SAS,80,2715,623,1136,11,36,612,1100,253,358,1510
2006,Ruben Patterson,SF-SG,30,TOT,71,1792,327,635,1,13,326,622,203,338,858
2006,Ruben Patterson,SF,30,POR,45,1056,188,379,0,7,188,372,138,226,514
2006,Ruben Patterson,SG,30,DEN,26,736,139,256,1,6,138,250,65,112,344
2006,Chris Paul,PG,20,NOK,78,2808,407,947,50,177,357,770,394,465,1258
2006,Sasha Pavlovic,SG,22,CLE,53,813,87,212,35,96,52,116,32,49,241
2006,Gary Payton*,PG,37,MIA,81,2305,230,547,66,230,164,317,100,126,626
2006,Kendrick Perkins,C,21,BOS,68,1332,137,266,0,2,137,264,80,130,354
2006,Morris Peterson,SG,28,TOR,82,3140,478,1096,177,448,301,648,241,294,1374
2006,Johan Petro,C,20,SEA,68,1282,153,300,0,0,153,300,47,75,353
2006,Eric Piatkowski,SG,35,CHI,29,228,24,61,9,33,15,28,2,5,59
2006,Paul Pierce,SF,28,BOS,79,3084,689,1462,111,314,578,1148,627,812,2116
2006,Mickael Pietrus,SF,23,GSW,52,1179,169,418,56,176,113,242,87,143,481
2006,Zoran Planinic,PG,23,NJN,56,596,66,183,13,56,53,127,46,66,191
2006,Pavel Podkolzin,C,21,DAL,1,18,0,2,0,0,0,2,3,6,3
2006,Scot Pollard,C,30,IND,45,771,70,154,0,0,70,154,29,38,169
2006,James Posey,SF,29,MIA,67,1914,159,395,117,290,42,105,48,61,483
2006,Vitaly Potapenko,C,30,TOT,33,353,37,71,0,0,37,71,10,17,84
2006,Vitaly Potapenko,C,30,SEA,24,321,32,64,0,0,32,64,10,17,74
2006,Vitaly Potapenko,C,30,SAC,9,32,5,7,0,0,5,7,0,0,10
2006,Josh Powell,PF,23,DAL,37,429,37,81,0,0,37,81,36,45,110
2006,Ronnie Price,PG,22,SAC,29,150,21,58,6,27,15,31,12,12,60
2006,Tayshaun Prince,SF,25,DET,82,2898,455,999,64,183,391,816,182,238,1156
2006,Laron Profit,SG,28,LAL,25,279,40,84,3,18,37,66,21,24,104
2006,Joel Przybilla,C,26,POR,56,1395,131,239,0,0,131,239,82,154,344
2006,Vladimir Radmanovic,PF,25,TOT,77,1974,262,643,138,354,124,289,93,114,755
2006,Vladimir Radmanovic,PF,25,SEA,47,1089,154,384,72,196,82,188,55,62,435
2006,Vladimir Radmanovic,PF,25,LAC,30,885,108,259,66,158,42,101,38,52,320
2006,Shavlik Randolph,PF,22,PHI,57,487,44,97,0,0,44,97,43,71,131
2006,Zach Randolph,PF,24,POR,74,2545,536,1229,16,55,520,1174,245,343,1333
2006,Theo Ratliff,C,32,POR,55,1301,108,189,0,0,108,189,54,83,270
2006,Zeljko Rebraca,C,33,LAC,29,412,52,96,0,0,52,96,31,41,135
2006,Michael Redd,SG,26,MIL,80,3130,682,1516,163,413,519,1103,501,571,2028
2006,Justin Reed,SF,24,TOT,72,997,119,295,0,1,119,294,87,120,325
2006,Justin Reed,SF,24,BOS,32,291,25,74,0,0,25,74,25,40,75
2006,Justin Reed,SF,24,MIN,40,706,94,221,0,1,94,220,62,80,250
2006,Jason Richardson,SG,25,GSW,75,2877,641,1438,183,477,458,961,276,410,1741
2006,Quentin Richardson,SF,25,NYK,55,1442,163,459,64,188,99,271,61,91,451
2006,Luke Ridnour,PG,24,SEA,79,2625,334,799,43,149,291,650,199,227,910
2006,Anthony Roberson,PG,22,MEM,16,88,14,31,5,10,9,21,2,2,35
2006,Lawrence Roberts,C,23,MEM,33,181,20,44,0,2,20,42,11,23,51
2006,Bernard Robinson,SF,25,CHA,66,1303,157,365,2,21,155,344,106,134,422
2006,Clifford Robinson,PF,39,NJN,80,1863,219,513,60,175,159,338,52,79,550
2006,Nate Robinson,PG,21,NYK,72,1544,230,565,58,146,172,419,152,202,670
2006,Jalen Rose,SF-SG,33,TOT,72,1983,290,685,59,172,231,513,248,318,887
2006,Jalen Rose,SF,33,TOR,46,1236,180,446,31,115,149,331,166,217,557
2006,Jalen Rose,SG,33,NYK,26,747,110,239,28,57,82,182,82,101,330
2006,Malik Rose,PF,31,NYK,72,1119,105,281,1,1,104,280,107,137,318
2006,Quinton Ross,SG,24,LAC,67,1515,130,308,0,7,130,301,57,75,317
2006,Michael Ruffin,C,29,WAS,76,1010,34,77,0,2,34,75,37,74,105
2006,Kareem Rush,SG,25,CHA,47,1111,181,469,57,164,124,305,55,77,474
2006,Bryon Russell,SF,35,DEN,1,3,0,0,0,0,0,0,0,0,0
2006,John Salmons,SG,26,PHI,82,2059,219,521,26,87,193,434,155,200,619
2006,Jamal Sampson,PF,22,SAC,12,39,5,7,0,0,5,7,0,2,10
2006,Melvin Sanders,SG,25,SAS,16,113,16,33,2,3,14,30,7,10,41
2006,Brian Scalabrine,PF,27,BOS,71,938,74,193,31,87,43,106,26,36,205
2006,Alex Scales,SG,27,SAS,1,0,0,0,0,0,0,0,0,0,0
2006,Luke Schenscher,C,23,CHI,20,149,16,26,0,0,16,26,4,13,36
2006,Ha Seung-Jin,C,20,POR,27,212,18,31,0,0,18,31,8,17,44
2006,Wayne Simien,PF,22,MIA,43,414,58,120,0,0,58,120,30,34,146
2006,Bobby Simmons,SF,25,MIL,75,2538,366,808,105,250,261,558,165,200,1002
2006,James Singleton,SF,24,LAC,59,753,77,151,10,20,67,131,39,50,203
2006,Brian Skinner,PF-C,29,TOT,65,944,82,160,0,0,82,160,27,56,191
2006,Brian Skinner,PF,29,SAC,38,429,38,69,0,0,38,69,12,27,88
2006,Brian Skinner,C,29,POR,27,515,44,91,0,0,44,91,15,29,103
2006,Charles Smith,SG,30,TOT,22,210,30,72,15,38,15,34,5,8,80
2006,Charles Smith,SG,30,POR,21,208,30,71,15,37,15,34,5,8,80
2006,Charles Smith,SG,30,DEN,1,2,0,1,0,1,0,0,0,0,0
2006,Donta Smith,SG,22,ATL,23,127,15,27,2,4,13,23,6,12,38
2006,J.R. Smith,SG,20,NOK,55,989,144,366,52,140,92,226,83,101,423
2006,Joe Smith,PF,30,MIL,44,887,145,305,0,2,145,303,89,115,379
2006,Josh Smith,SF,20,ATL,80,2559,329,774,34,110,295,664,210,292,902
2006,Eric Snow,PG,32,CLE,82,2351,163,399,1,10,162,389,64,93,391
2006,Kirk Snyder,SG,22,NOK,68,1310,205,453,46,129,159,324,86,117,542
2006,Darius Songaila,PF,27,CHI,62,1329,236,491,2,5,234,486,94,115,568
2006,Pape Sow,C,24,TOR,42,590,53,123,0,0,53,123,41,57,147
2006,Jerry Stackhouse,SG,31,DAL,55,1525,242,603,36,130,206,473,195,221,715
2006,DeShawn Stevenson,SG,24,ORL,82,2648,359,781,2,15,357,766,180,242,900
2006,Peja Stojakovic,SF,28,TOT,71,2601,445,1018,162,404,283,614,238,260,1290
2006,Peja Stojakovic,SF,28,SAC,31,1147,171,424,71,179,100,245,98,105,511
2006,Peja Stojakovic,SF,28,IND,40,1454,274,594,91,225,183,369,140,155,779
2006,Awvee Storey,SF,28,WAS,25,116,16,41,3,7,13,34,8,14,43
2006,Damon Stoudamire,PG,32,MEM,27,862,114,287,36,104,78,183,53,62,317
2006,Salim Stoudamire,SG,23,ATL,61,1236,204,492,82,216,122,276,99,110,589
2006,Amar'e Stoudemire,C,23,PHO,3,50,9,27,0,1,9,26,8,9,26
2006,Mike Sweetney,C,23,CHI,66,1222,200,444,0,0,200,444,133,204,533
2006,Robert Swift,C,20,SEA,47,987,124,241,0,0,124,241,53,91,301
2006,Stromile Swift,C,26,HOU,66,1344,225,458,0,2,225,456,136,209,586
2006,Wally Szczerbiak,SF,28,TOT,72,2729,493,1012,102,255,391,757,278,310,1366
2006,Wally Szczerbiak,SF,28,MIN,40,1555,292,590,58,143,234,447,163,182,805
2006,Wally Szczerbiak,SF,28,BOS,32,1174,201,422,44,112,157,310,115,128,561
2006,Chris Taft,C,20,GSW,17,144,23,38,0,0,23,38,1,6,47
2006,Donell Taylor,SG,23,WAS,51,465,53,136,4,17,49,119,30,43,140
2006,Maurice Taylor,PF,29,NYK,67,1210,182,389,0,1,182,388,58,83,422
2006,Sebastian Telfair,PG,20,POR,68,1641,228,578,57,162,171,416,130,175,643
2006,Jason Terry,PG,28,DAL,80,2798,516,1099,171,416,345,683,168,210,1371
2006,Billy Thomas,SG,30,WAS,17,131,13,40,10,30,3,10,2,2,38
2006,Etan Thomas,C,27,WAS,71,1121,131,246,0,0,131,246,75,125,337
2006,James Thomas,PF,25,TOT,22,150,10,19,0,0,10,19,8,14,28
2006,James Thomas,PF,25,PHI,15,124,7,13,0,0,7,13,8,14,22
2006,James Thomas,PF,25,CHI,7,26,3,6,0,0,3,6,0,0,6
2006,John Thomas,C,30,TOT,16,127,6,15,0,0,6,15,3,4,15
2006,John Thomas,C,30,MEM,3,25,2,2,0,0,2,2,0,0,4
2006,John Thomas,C,30,ATL,11,66,3,7,0,0,3,7,3,4,9
2006,John Thomas,C,30,NJN,2,36,1,6,0,0,1,6,0,0,2
2006,Kenny Thomas,PF,28,SAC,82,2293,305,604,0,1,305,603,138,204,748
2006,Kurt Thomas,C,33,PHO,53,1411,190,391,0,0,190,391,75,92,455
2006,Tim Thomas,PF-SF,28,TOT,29,666,113,262,46,111,67,151,28,42,300
2006,Tim Thomas,SF,28,CHI,3,32,6,16,1,6,5,10,0,0,13
2006,Tim Thomas,PF,28,PHO,26,634,107,246,45,105,62,141,28,42,287
2006,Dijon Thompson,SG,22,PHO,10,43,11,25,4,11,7,14,2,2,28
2006,Jamaal Tinsley,PG,27,IND,42,1122,158,386,16,70,142,316,58,91,390
2006,Jake Tsakalidis,C,26,MEM,51,732,100,165,0,0,100,165,57,87,257
2006,Nikoloz Tskitishvili,SF-PF,22,TOT,17,99,13,37,1,3,12,34,9,14,36
2006,Nikoloz Tskitishvili,PF,22,MIN,5,13,1,4,0,0,1,4,1,2,3
2006,Nikoloz Tskitishvili,SF,22,PHO,12,86,12,33,1,3,11,30,8,12,33
2006,Ronny Turiaf,C,23,LAL,23,161,15,30,0,0,15,30,15,27,45
2006,Hedo Turkoglu,SF,26,ORL,78,2615,398,877,114,283,284,594,255,296,1165
2006,Ime Udoka,SF,28,NYK,8,114,9,24,1,3,8,21,3,6,22
2006,Beno Udrih,PG,23,SAS,54,586,106,233,24,70,82,163,39,50,275
2006,Nick Van,PG,34,SAS,65,986,136,343,55,154,81,189,28,41,355
2006,Keith Van,SF,30,DAL,53,1090,164,387,50,136,114,251,94,113,472
2006,Anderson Varejao,C,23,CLE,48,760,79,150,0,1,79,149,61,119,219
2006,Jacque Vaughn,SG,30,NJN,80,1234,107,245,1,6,106,239,59,81,274
2006,Charlie Villanueva,PF,21,TOR,81,2361,435,940,70,214,365,726,113,160,1053
2006,Jake Voskuhl,C,28,CHA,51,818,114,261,1,3,113,258,41,60,270
2006,Jackson Vroman,PF,24,NOK,41,406,26,66,0,0,26,66,21,44,73
2006,Sasha Vujacic,PG,21,LAL,82,1449,108,312,59,172,49,140,46,52,321
2006,Dwyane Wade,SG,24,MIA,75,2892,699,1413,13,76,686,1337,629,803,2040
2006,Von Wafer,SG,20,LAL,16,73,6,38,2,17,4,21,6,8,20
2006,Antoine Walker,PF,29,MIA,82,2199,391,898,137,383,254,515,81,129,1000
2006,Samaki Walker,PF,29,IND,7,22,0,2,0,0,0,2,2,2,2
2006,Ben Wallace,C,31,DET,82,2890,237,465,0,4,237,461,123,296,597
2006,Gerald Wallace,SF,23,CHA,55,1895,317,589,14,50,303,539,188,306,836
2006,Rasheed Wallace,PF,31,DET,80,2780,459,1067,155,434,304,633,136,183,1209
2006,Matt Walsh,SG,23,MIA,2,3,1,1,0,0,1,1,0,2,2
2006,Luke Walton,SF,25,LAL,69,1333,135,328,18,55,117,273,57,76,345
2006,Hakim Warrick,PF,23,MEM,68,724,101,228,0,0,101,228,76,115,278
2006,Earl Watson,PG,26,TOT,70,1578,219,509,110,272,109,237,75,111,623
2006,Earl Watson,PG,26,DEN,46,975,121,282,68,172,53,110,37,59,347
2006,Earl Watson,PG,26,SEA,24,603,98,227,42,100,56,127,38,52,276
2006,Chris Webber,PF,32,PHI,75,2893,617,1422,21,77,596,1345,263,348,1518
2006,Martell Webster,SF,19,POR,61,1070,139,348,65,182,74,166,61,71,404
2006,Bonzi Wells,SG,29,SAC,52,1684,284,613,10,45,274,568,129,190,707
2006,Jiri Welsch,SF,26,MIL,58,866,86,222,14,49,72,173,65,87,251
2006,David Wesley,SG,35,HOU,71,2372,226,561,99,271,127,290,151,187,702
2006,David West,PF,25,NOK,74,2526,530,1036,3,11,527,1025,199,236,1262
2006,Delonte West,PG,22,BOS,71,2418,333,684,84,218,249,466,86,101,836
2006,Robert Whaley,C,23,UTA,23,212,23,57,0,0,23,57,3,6,49
2006,Chris Wilcox,C-PF,23,TOT,77,1529,257,450,0,2,257,448,112,153,626
2006,Chris Wilcox,C,23,LAC,48,657,90,168,0,2,90,166,38,59,218
2006,Chris Wilcox,PF,23,SEA,29,872,167,282,0,0,167,282,74,94,408
2006,Damien Wilkins,SF,26,SEA,82,1525,193,435,14,56,179,379,136,162,536
2006,Mike Wilks,PG,26,TOT,47,348,29,90,3,19,26,71,25,41,86
2006,Mike Wilks,PG,26,CLE,37,243,17,59,2,14,15,45,6,12,42
2006,Mike Wilks,PG,26,SEA,10,105,12,31,1,5,11,26,19,29,44
2006,Aaron Williams,C,34,TOT,48,791,91,176,0,0,91,176,40,58,222
2006,Aaron Williams,C,34,TOR,14,99,10,19,0,0,10,19,5,6,25
2006,Aaron Williams,C,34,NOK,34,692,81,157,0,0,81,157,35,52,197
2006,Alvin Williams,PG,31,TOR,1,10,0,3,0,2,0,1,1,2,1
2006,Deron Williams,PG,21,UTA,80,2307,339,805,91,219,248,586,95,135,864
2006,Eric Williams,SF,33,TOR,28,352,29,75,5,18,24,57,28,38,91
2006,Jason Williams,PG,30,MIA,59,1874,268,606,107,288,161,318,85,98,728
2006,Lou Williams,PG,19,PHI,30,145,23,52,2,9,21,43,8,13,56
2006,Marvin Williams,PF,19,ATL,79,1952,235,531,13,53,222,478,189,253,672
2006,Mo Williams,PG,23,MIL,58,1531,267,629,73,191,194,438,96,113,703
2006,Corliss Williamson,SF,32,SAC,37,362,43,103,2,2,41,101,38,49,126
2006,Loren Woods,C,27,TOR,27,324,28,59,0,1,28,58,6,14,62
2006,Qyntel Woods,SF,24,NYK,49,1013,129,254,22,60,107,194,49,76,329
2006,Metta World,SF,26,TOT,56,2207,350,867,78,253,272,614,206,305,984
2006,Metta World,SF,26,IND,16,603,109,237,18,54,91,183,74,121,310
2006,Metta World,SF,26,SAC,40,1604,241,630,60,199,181,431,132,184,674
2006,Antoine Wright,SG,21,NJN,39,370,29,81,1,15,28,66,11,22,70
2006,Bracey Wright,SG,21,MIN,7,135,21,51,6,17,15,34,14,16,62
2006,Dorell Wright,SF,20,MIA,20,132,20,43,3,6,17,37,15,17,58
2006,Lorenzen Wright,C,30,MEM,78,1689,194,406,0,2,194,404,66,117,454
2006,Derrick Zimmerman,PG,24,NJN,2,32,2,3,0,0,2,3,0,0,4
,,,,,,,,,,,,,,,
2007,Shareef Abdur-Rahim,C,30,SAC,80,2015,310,654,3,20,307,634,170,234,793
2007,Hassan Adams,SG,22,NJN,61,495,75,135,0,1,75,134,24,36,174
2007,Maurice Ager,SG,22,DAL,32,214,22,70,5,15,17,55,20,33,69
2007,LaMarcus Aldridge,C,21,POR,63,1392,241,479,0,2,241,477,83,115,565
2007,Malik Allen,PF,28,CHI,60,638,107,258,0,1,107,257,28,34,242
2007,Ray Allen,SG,31,SEA,55,2219,505,1153,165,443,340,710,279,309,1454
2007,Tony Allen,SG,25,BOS,33,805,133,259,8,33,125,226,105,134,379
2007,Rafer Alston,PG,30,HOU,82,3040,383,1020,192,529,191,491,130,177,1088
2007,Lou Amundson,PF,24,TOT,11,89,6,15,0,0,6,15,4,10,16
2007,Lou Amundson,PF,24,UTA,1,2,0,0,0,0,0,0,0,0,0
2007,Lou Amundson,PF,24,PHI,10,87,6,15,0,0,6,15,4,10,16
2007,Alan Anderson,SG,24,CHA,17,256,37,81,5,20,32,61,19,23,98
2007,Derek Anderson,SF,32,CHA,50,1190,126,294,54,152,72,142,93,106,399
2007,Carmelo Anthony,SF,22,DEN,65,2486,691,1453,40,149,651,1304,459,568,1881
2007,Rafael Araujo,C,26,UTA,28,248,27,65,0,0,27,65,18,29,72
2007,Gilbert Arenas,PG,25,WAS,74,2942,647,1548,205,584,442,964,606,718,2105
2007,Trevor Ariza,SG,21,ORL,57,1278,200,371,0,7,200,364,106,171,506
2007,Darrell Armstrong,PG,38,IND,81,1275,156,377,72,214,84,163,73,93,457
2007,Hilton Armstrong,C,22,NOK,56,634,68,125,0,0,68,125,40,67,176
2007,Carlos Arroyo,PG,27,ORL,72,1304,203,478,14,51,189,427,132,166,552
2007,Chucky Atkins,PG,32,MEM,75,2064,310,715,116,306,194,409,252,311,988
2007,James Augustine,PF,22,ORL,2,7,1,3,0,0,1,3,0,0,2
2007,Kelenna Azubuike,SG,23,GSW,41,669,98,220,34,79,64,141,61,78,291
2007,Renaldo Balkman,SF,22,NYK,68,1064,139,275,5,27,134,248,51,90,334
2007,Marcus Banks,PG,25,PHO,45,503,84,196,5,29,79,167,48,60,221
2007,Leandro Barbosa,SG,24,PHO,80,2613,529,1111,190,438,339,673,196,232,1444
2007,J.J. Barea,PG,22,DAL,33,191,28,78,6,21,22,57,16,24,78
2007,Andrea Bargnani,PF,21,TOR,65,1629,267,625,100,268,167,357,117,142,751
2007,Matt Barnes,PF,26,GSW,76,1813,275,628,106,290,169,338,90,123,746
2007,Andre Barrett,PG,24,CHI,6,29,4,8,0,0,4,8,0,0,8
2007,Earl Barron,C,25,MIA,28,203,24,83,0,1,24,82,17,18,65
2007,Brent Barry,SG,35,SAS,75,1631,202,425,128,287,74,138,103,117,635
2007,Brandon Bass,PF,21,NOK,21,162,15,44,0,1,15,43,12,16,42
2007,Maceo Baston,PF,31,IND,47,405,49,76,3,7,46,69,37,47,138
2007,Esteban Batista,PF,23,ATL,13,81,8,16,0,0,8,16,4,7,20
2007,Tony Battie,PF,30,ORL,66,1575,176,360,0,1,176,359,52,77,404
2007,Shane Battier,SF,28,HOU,82,2988,292,654,157,373,135,281,88,113,829
2007,Charlie Bell,SG,27,MIL,82,2848,426,974,127,361,299,613,131,168,1110
2007,Raja Bell,SG,30,PHO,78,2917,410,950,205,496,205,454,118,152,1143
2007,Mike Bibby,PG,28,SAC,82,2784,471,1166,173,481,298,685,288,347,1403
2007,Andris Biedrins,C,20,GSW,82,2382,348,581,0,0,348,581,87,167,783
2007,Chauncey Billups,PG,30,DET,70,2533,348,815,109,316,239,499,386,437,1191
2007,Steve Blake,PG,26,TOT,82,2225,209,509,67,208,142,301,43,64,528
2007,Steve Blake,PG,26,MIL,33,583,45,129,19,68,26,61,11,20,120
2007,Steve Blake,PG,26,DEN,49,1642,164,380,48,140,116,240,32,44,408
2007,Will Blalock,PG,23,DET,14,166,9,30,1,5,8,25,6,6,25
2007,Andray Blatche,PF,20,WAS,56,682,86,197,4,27,82,170,30,49,206
2007,Mark Blount,C,31,MIN,82,2544,427,839,9,31,418,808,147,195,1010
2007,Keith Bogans,SG,26,ORL,59,990,99,245,53,137,46,108,47,63,298
2007,Andrew Bogut,C,22,MIL,66,2258,348,629,1,5,347,624,112,194,809
2007,Matt Bonner,PF,26,SAS,56,653,106,237,36,94,70,143,27,38,275
2007,Josh Boone,PF,22,NJN,61,669,99,171,0,0,99,171,56,103,254
2007,Calvin Booth,C,30,WAS,44,380,31,66,1,2,30,64,6,10,69
2007,Carlos Boozer,PF,25,UTA,74,2557,647,1154,0,0,647,1154,255,372,1549
2007,Chris Bosh,C,22,TOR,69,2658,543,1094,12,35,531,1059,463,590,1561
2007,Bruce Bowen,SF,35,SAS,82,2464,189,467,89,232,100,235,43,73,510
2007,Earl Boykins,PG,30,TOT,66,2031,323,769,95,239,228,530,220,245,961
2007,Earl Boykins,PG,30,DEN,31,877,156,378,41,110,115,268,119,131,472
2007,Earl Boykins,PG,30,MIL,35,1154,167,391,54,129,113,262,101,114,489
2007,Cedric Bozeman,SG,23,ATL,23,199,11,39,2,13,9,26,2,6,26
2007,Elton Brand,PF,27,LAC,80,3077,645,1211,1,1,644,1210,351,461,1642
2007,Ronnie Brewer,SG,21,UTA,56,675,102,193,0,9,102,184,56,83,260
2007,Primoz Brezec,C,27,CHA,58,838,122,274,1,3,121,271,43,68,288
2007,Andre Brown,PF,25,SEA,38,271,42,74,0,1,42,73,9,15,93
2007,Dee Brown,PG,22,UTA,49,450,32,98,6,28,26,70,24,37,94
2007,Devin Brown,SG,28,NOK,58,1662,233,555,81,227,152,328,123,155,670
2007,Kwame Brown,C,24,LAL,41,1132,143,242,0,1,143,241,59,134,345
2007,P.J. Brown,PF,37,CHI,72,1456,170,418,0,2,170,416,96,122,436
2007,Shannon Brown,SG,21,CLE,23,202,28,74,7,25,21,49,10,14,73
2007,Kobe Bryant,SG,28,LAL,77,3140,813,1757,137,398,676,1359,667,768,2430
2007,Greg Buckner,SG,30,DAL,76,1372,123,299,32,103,91,196,27,34,305
2007,Pat Burke,C,33,PHO,23,164,23,65,6,22,17,43,8,13,60
2007,Caron Butler,SF,26,WAS,63,2474,451,975,18,72,433,903,283,328,1203
2007,Jackie Butler,C,21,SAS,11,103,16,35,0,0,16,35,9,10,41
2007,Rasual Butler,SF,27,NOK,81,2223,314,788,134,363,180,425,56,87,818
2007,Andrew Bynum,C,19,LAL,82,1793,247,443,0,3,247,440,143,214,637
2007,Jose Calderon,PG,25,TOR,77,1614,263,505,25,75,238,430,117,143,668
2007,Marcus Camby,C,32,DEN,70,2369,312,659,0,2,312,657,161,221,785
2007,Brian Cardinal,PF,29,MEM,28,313,42,85,18,44,24,41,25,27,127
2007,Rodney Carney,SF,22,PHI,67,1169,182,392,25,72,157,320,53,87,442
2007,Matt Carroll,SG,26,CHA,72,1878,285,658,111,267,174,391,188,208,869
2007,Anthony Carter,PG,31,DEN,2,37,3,8,0,2,3,6,0,0,6
2007,Vince Carter,SG,30,NJN,82,3126,726,1598,156,437,570,1161,462,576,2070
2007,Sam Cassell,PG,37,LAC,58,1407,261,625,32,109,229,516,160,182,714
2007,Kelvin Cato,C,32,NYK,18,95,7,22,0,0,7,22,8,12,22
2007,Tyson Chandler,C,24,NOK,73,2525,292,468,0,1,292,467,106,201,690
2007,Josh Childress,SG,23,ATL,55,2024,261,518,26,77,235,441,167,210,715
2007,Doug Christie,SG,36,LAC,7,82,5,17,1,6,4,11,2,3,13
2007,Speedy Claxton,PG,28,ATL,42,1054,91,278,6,28,85,250,33,60,221
2007,Jarron Collins,C,28,UTA,82,913,75,170,0,0,75,170,54,83,204
2007,Jason Collins,PF,28,NJN,80,1844,55,151,0,2,55,149,59,127,169
2007,Mardy Collins,SF,22,NYK,52,777,87,228,13,47,74,181,48,82,235
2007,Nick Collison,C,26,SEA,82,2378,318,636,0,2,318,634,154,199,790
2007,Will Conroy,PG-SG,24,TOT,7,52,0,3,0,0,0,3,0,4,0
2007,Will Conroy,SG,24,MEM,3,17,0,0,0,0,0,0,0,0,0
2007,Will Conroy,PG,24,LAC,4,35,0,3,0,0,0,3,0,4,0
2007,Brian Cook,PF,26,LAL,65,1018,185,408,46,115,139,293,34,47,450
2007,Jamal Crawford,SG,26,NYK,59,2198,354,886,103,322,251,564,228,272,1039
2007,Austin Croshere,PF,31,DAL,61,727,78,222,26,91,52,131,45,52,227
2007,Eddy Curry,C,24,NYK,81,2849,585,1016,1,1,584,1015,405,659,1576
2007,Samuel Dalembert,C,25,PHI,82,2535,356,658,0,2,356,656,167,224,879
2007,Erick Dampier,C,31,DAL,76,1915,209,334,0,0,209,334,119,191,537
2007,Antonio Daniels,SG,31,WAS,80,1761,172,389,19,63,153,326,208,250,571
2007,Marquis Daniels,SG,26,IND,45,800,129,281,6,26,123,255,56,80,320
2007,Baron Davis,PG,27,GSW,63,2221,452,1030,85,280,367,750,275,369,1264
2007,Dale Davis,C,37,DET,46,464,33,74,0,0,33,74,17,26,83
2007,Paul Davis,C,22,LAC,31,180,22,52,0,0,22,52,7,10,51
2007,Ricky Davis,SF,27,MIN,81,3021,506,1089,123,310,383,779,239,285,1374
2007,Carlos Delfino,SG,24,DET,82,1372,156,376,46,138,110,238,70,89,428
2007,Luol Deng,SF,21,CHI,82,3071,630,1218,1,7,629,1211,279,359,1540
2007,Boris Diaw,PF,24,PHO,73,2268,306,569,15,45,291,524,82,120,709
2007,Yakhouba Diawara,SG,24,DEN,64,1177,100,292,49,170,51,122,35,53,284
2007,Dan Dickau,PG,28,POR,50,444,54,151,16,61,38,90,42,53,166
2007,Travis Diener,PG,24,ORL,26,288,34,80,18,50,16,30,12,15,98
2007,Ike Diogu,PF,23,TOT,59,760,127,266,0,0,127,266,112,140,366
2007,Ike Diogu,PF,23,GSW,17,222,44,83,0,0,44,83,35,44,123
2007,Ike Diogu,PF,23,IND,42,538,83,183,0,0,83,183,77,96,243
2007,DeSagana Diop,C,25,DAL,81,1480,71,151,0,1,71,150,48,86,190
2007,Juan Dixon,SG,28,TOT,81,1926,299,703,79,226,220,477,101,116,778
2007,Juan Dixon,SG,28,POR,55,1243,189,444,52,143,137,301,60,72,490
2007,Juan Dixon,SG,28,TOR,26,683,110,259,27,83,83,176,41,44,288
2007,Michael Doleac,C,29,MIA,56,698,82,175,0,1,82,174,36,41,200
2007,Keyon Dooling,SG,26,ORL,66,1435,188,458,31,96,157,362,114,141,521
2007,Quincy Douby,PG,22,SAC,42,359,48,126,12,50,36,76,11,15,119
2007,Chris Duhon,PG,24,CHI,78,1906,197,483,88,245,109,238,76,101,558
2007,Tim Duncan,C,30,SAS,80,2726,618,1131,1,9,617,1122,362,568,1599
2007,Mike Dunleavy,SG-PF,26,TOT,82,2580,384,850,70,224,314,626,211,269,1049
2007,Mike Dunleavy,PF,26,GSW,39,1051,166,370,36,104,130,266,78,101,446
2007,Mike Dunleavy,SG,26,IND,43,1529,218,480,34,120,184,360,133,168,603
2007,Ronald Dupree,SF,26,DET,19,94,11,31,0,0,11,31,3,9,25
2007,Monta Ellis,SG,21,GSW,77,2638,480,1010,39,143,441,867,273,358,1272
2007,Francisco Elson,C,30,SAS,70,1332,144,282,0,2,144,280,62,80,350
2007,Melvin Ely,PF-C,28,TOT,30,309,29,80,0,0,29,80,31,47,89
2007,Melvin Ely,PF,28,CHA,24,244,23,60,0,0,23,60,24,35,70
2007,Melvin Ely,C,28,SAS,6,65,6,20,0,0,6,20,7,12,19
2007,Maurice Evans,SG,28,LAL,76,1732,234,542,48,133,186,409,122,155,638
2007,Reggie Evans,PF,26,DEN,66,1127,117,215,0,0,117,215,91,183,325
2007,Daniel Ewing,PG,23,LAC,61,712,65,161,14,44,51,117,35,45,179
2007,Jordan Farmar,PG,20,LAL,72,1090,124,294,45,137,79,157,27,38,320
2007,Desmon Farmer,SG,25,SEA,8,32,5,15,2,8,3,7,1,1,13
2007,Raymond Felton,PG,22,CHA,78,2832,393,1024,103,312,290,712,204,256,1093
2007,Michael Finley,SF,33,SAS,82,1823,273,663,104,286,169,377,90,98,740
2007,Derek Fisher,SG,32,UTA,82,2287,258,675,48,156,210,519,262,307,826
2007,T.J. Ford,PG,23,TOR,75,2243,393,902,21,69,372,833,240,293,1047
2007,Danny Fortson,C,30,SEA,14,158,15,30,0,1,15,29,10,13,40
2007,Jeff Foster,C,30,IND,75,1740,122,260,0,1,122,259,78,122,322
2007,Randy Foye,PG,23,MIN,82,1879,300,691,68,185,232,506,164,192,832
2007,Adonal Foyle,C,31,GSW,48,475,48,85,0,0,48,85,11,25,107
2007,Steve Francis,SG,29,NYK,44,1237,140,343,42,111,98,232,175,211,497
2007,Matt Freije,PF,25,ATL,19,147,16,54,3,22,13,32,5,6,40
2007,Channing Frye,PF,23,NYK,72,1896,298,689,3,18,295,671,85,108,684
2007,Dan Gadzuric,C,28,MIL,54,840,108,228,0,1,108,227,42,90,258
2007,Jorge Garbajosa,PF,29,TOR,67,1909,222,529,66,193,156,336,57,78,567
2007,Francisco Garcia,SF,25,SAC,79,1410,163,380,53,149,110,231,95,114,474
2007,Kevin Garnett,PF,30,MIN,76,2995,638,1341,12,56,626,1285,416,498,1704
2007,Pat Garrity,PF,30,ORL,33,277,22,70,11,32,11,38,16,18,71
2007,Pau Gasol,C,26,MEM,59,2133,462,858,3,11,459,847,299,400,1226
2007,Rudy Gay,SF,20,MEM,78,2103,321,760,52,143,269,617,152,209,846
2007,Mickael Gelabale,SF,23,SEA,70,1239,122,264,11,47,111,217,66,82,321
2007,Devean George,SF,29,DAL,60,1283,146,370,53,150,93,220,36,48,381
2007,Daniel Gibson,PG,20,CLE,60,988,98,231,52,124,46,107,28,39,276
2007,Manu Ginobili,SG,29,SAS,75,2060,396,854,128,323,268,531,320,372,1240
2007,Gordan Giricek,SG,29,UTA,61,1188,176,381,52,122,124,259,71,87,475
2007,Andreas Glyniadakis,C,25,SEA,13,81,8,17,0,0,8,17,1,2,17
2007,Ryan Gomes,PF,24,BOS,73,2275,338,723,16,42,322,681,189,233,881
2007,Drew Gooden,PF,25,CLE,80,2238,371,784,1,6,370,778,142,199,885
2007,Ben Gordon,SG,23,CHI,82,2704,609,1338,155,375,454,963,380,440,1753
2007,Joey Graham,SF,24,TOR,79,1319,192,388,9,31,183,357,110,131,503
2007,Stephen Graham,SG,24,POR,14,165,17,40,3,11,14,29,8,9,45
2007,Danny Granger,SF,23,IND,82,2785,398,868,110,288,288,580,236,294,1142
2007,Gerald Green,SF,21,BOS,81,1780,310,739,95,258,215,481,128,159,843
2007,Willie Green,SG,25,PHI,74,1842,357,868,51,157,306,711,74,111,839
2007,Orien Greene,SG,24,IND,41,254,23,62,2,11,21,51,15,25,63
2007,Lynn Greer,SG,27,MIL,41,432,61,141,18,52,43,89,27,32,167
2007,Adrian Griffin,SF,32,CHI,54,585,61,129,0,6,61,123,15,19,137
2007,Eddie Griffin,PF,24,MIN,13,92,7,27,0,1,7,26,4,5,18
2007,Mike Hall,SF,22,WAS,2,13,1,4,0,0,1,4,0,0,2
2007,Richard Hamilton,SG,28,DET,75,2763,547,1170,44,129,503,1041,347,403,1485
2007,Matt Harpring,SF,30,UTA,77,1965,322,656,13,39,309,617,237,309,894
2007,Al Harrington,PF,26,TOT,78,2563,495,1083,127,293,368,790,168,242,1285
2007,Al Harrington,PF,26,IND,36,1208,223,487,54,118,169,369,72,101,572
2007,Al Harrington,PF,26,GSW,42,1355,272,596,73,175,199,421,96,141,713
2007,Junior Harrington,PG,26,MEM,29,543,57,137,7,26,50,111,31,46,152
2007,Othella Harrington,PF,33,CHA,26,220,25,56,0,0,25,56,17,22,67
2007,Devin Harris,PG,23,DAL,80,2081,292,593,14,50,278,543,215,261,813
2007,David Harrison,C,24,IND,24,190,30,58,0,0,30,58,11,22,71
2007,Jason Hart,PG,28,TOT,36,846,100,224,7,29,93,195,42,47,249
2007,Jason Hart,PG,28,SAC,13,100,15,30,3,6,12,24,10,11,43
2007,Jason Hart,PG,28,LAC,23,746,85,194,4,23,81,171,32,36,206
2007,Udonis Haslem,PF,26,MIA,79,2483,353,717,0,4,353,713,138,203,844
2007,Trenton Hassell,SG,27,MIN,76,2223,217,443,6,25,211,418,72,92,512
2007,Chuck Hayes,PF,23,HOU,78,1714,192,335,0,0,192,335,55,89,439
2007,Jarvis Hayes,SF,25,WAS,81,1626,224,546,66,183,158,363,71,84,585
2007,Brendan Haywood,C,27,WAS,77,1740,198,355,0,0,198,355,115,210,511
2007,Luther Head,SG,24,HOU,80,2211,306,700,177,401,129,299,83,105,872
2007,Alan Henderson,PF,34,PHI,38,418,43,67,0,0,43,67,33,47,119
2007,Walter Herrmann,PF,27,CHA,48,936,174,330,53,115,121,215,41,53,442
2007,Nene Hilario,C,24,DEN,64,1715,294,516,0,1,294,515,195,283,783
2007,Grant Hill,SG,34,ORL,65,2009,342,660,2,12,340,648,248,324,934
2007,Kirk Hinrich,PG,26,CHI,80,2839,475,1061,140,337,335,724,237,284,1327
2007,Robert Hite,SG,23,MIA,12,136,19,60,5,23,14,37,8,12,51
2007,Julius Hodge,SG,23,TOT,9,65,6,12,0,0,6,12,3,4,15
2007,Julius Hodge,SG,23,DEN,4,37,2,5,0,0,2,5,2,2,6
2007,Julius Hodge,SG,23,MIL,5,28,4,7,0,0,4,7,1,2,9
2007,Ryan Hollins,C,22,CHA,27,185,20,36,0,0,20,36,24,40,64
2007,Robert Horry,PF,36,SAS,68,1124,90,251,50,149,40,102,38,64,268
2007,Eddie House,SG,28,NJN,56,946,180,421,75,175,105,246,33,36,468
2007,Dwight Howard,C,21,ORL,82,3023,526,873,1,2,525,871,390,666,1443
2007,Josh Howard,SF,26,DAL,70,2455,493,1075,92,239,401,836,243,294,1321
2007,Juwan Howard,PF,33,HOU,80,2123,309,665,0,0,309,665,155,188,773
2007,Troy Hudson,PG,30,MIN,34,554,74,195,28,80,46,115,26,32,202
2007,Larry Hughes,SG,28,CLE,70,2596,381,953,74,222,307,731,209,309,1045
2007,Kris Humphries,PF,21,TOR,60,670,87,185,0,0,87,185,53,79,227
2007,Lindsey Hunter,PG,36,DET,52,745,94,244,38,119,56,125,30,33,256
2007,Steven Hunter,PF,25,PHI,70,1605,188,326,0,0,188,326,74,151,450
2007,Andre Iguodala,SG,23,PHI,76,3062,443,991,48,155,395,836,452,551,1386
2007,Zydrunas Ilgauskas,C,31,CLE,78,2130,385,793,0,1,385,792,155,192,925
2007,Mile Ilic,C,22,NJN,5,6,0,3,0,0,0,3,0,0,0
2007,Didier Ilunga-Mbenga,C,26,DAL,21,79,5,16,0,0,5,16,7,8,17
2007,Ersan Ilyasova,PF,19,MIL,66,973,139,363,54,148,85,215,70,89,402
2007,Allen Iverson*,SG-PG,31,TOT,65,2761,581,1313,62,197,519,1116,485,610,1709
2007,Allen Iverson*,PG,31,PHI,15,640,151,366,12,53,139,313,154,174,468
2007,Allen Iverson*,SG,31,DEN,50,2121,430,947,50,144,380,803,331,436,1241
2007,Royal Ivey,PG,25,ATL,53,539,64,143,5,16,59,127,24,35,157
2007,Jarrett Jack,PG,23,POR,79,2651,320,705,63,180,257,525,243,279,946
2007,Bobby Jackson,SG,33,NOK,56,1330,204,518,54,165,150,353,130,168,592
2007,Luke Jackson,SF,25,TOT,13,138,19,43,5,17,14,26,5,9,48
2007,Luke Jackson,SF,25,LAC,3,16,1,8,1,4,0,4,0,0,3
2007,Luke Jackson,SF,25,TOR,10,122,18,35,4,13,14,22,5,9,45
2007,Marc Jackson,PF,32,NOK,56,1025,159,388,0,1,159,387,90,103,408
2007,Stephen Jackson,SF-SG,28,TOT,75,2479,409,944,100,311,309,633,243,299,1161
2007,Stephen Jackson,SG,28,IND,37,1186,180,430,41,138,139,292,120,146,521
2007,Stephen Jackson,SF,28,GSW,38,1293,229,514,59,173,170,341,123,153,640
2007,Jerome James,C,31,NYK,41,273,33,79,0,0,33,79,10,18,76
2007,LeBron James,SF,22,CLE,78,3190,772,1621,99,310,673,1311,489,701,2132
2007,Mike James,PG,31,MIN,82,2069,297,703,80,215,217,488,154,184,828
2007,Antawn Jamison,PF,30,WAS,70,2662,512,1139,138,379,374,760,226,307,1388
2007,Marko Jaric,SG,28,MIN,70,1555,136,325,32,85,104,240,67,88,371
2007,Sarunas Jasikevicius,SG-PG,30,TOT,63,973,128,322,44,130,84,192,86,95,386
2007,Sarunas Jasikevicius,SG,30,IND,37,664,91,221,32,86,59,135,59,64,273
2007,Sarunas Jasikevicius,PG,30,GSW,26,309,37,101,12,44,25,57,27,31,113
2007,Al Jefferson,C,22,BOS,69,2319,453,882,0,1,453,881,201,295,1107
2007,Richard Jefferson,SF,26,NJN,55,1956,303,665,52,145,251,520,239,326,897
2007,Jared Jeffries,SF,25,NYK,55,1307,95,206,2,20,93,186,31,68,223
2007,Alexander Johnson,PF,23,MEM,59,753,91,169,0,0,91,169,78,118,260
2007,Amir Johnson,PF,19,DET,8,124,18,33,0,3,18,30,11,14,47
2007,Anthony Johnson,PG,32,TOT,67,1301,142,343,25,73,117,270,46,61,355
2007,Anthony Johnson,PG,32,DAL,40,562,60,146,11,29,49,117,21,29,152
2007,Anthony Johnson,PG,32,ATL,27,739,82,197,14,44,68,153,25,32,203
2007,DerMarr Johnson,SF,26,DEN,39,419,50,154,19,88,31,66,16,21,135
2007,Joe Johnson,SG,25,ATL,57,2359,536,1139,119,312,417,827,235,314,1426
2007,Linton Johnson,PF,26,NOK,54,720,93,190,10,30,83,160,30,37,226
2007,Bobby Jones,SF,23,PHI,44,336,43,93,1,9,42,84,23,41,110
2007,Dahntay Jones,SG,26,MEM,78,1671,220,461,5,12,215,449,138,174,583
2007,Damon Jones,PG,30,CLE,60,1173,137,355,89,231,48,124,30,44,393
2007,Dwayne Jones,PF,23,CLE,4,18,0,1,0,0,0,1,3,6,3
2007,Eddie Jones,SG,35,TOT,64,1594,178,422,78,222,100,200,59,75,493
2007,Eddie Jones,SG,35,MEM,29,561,57,151,22,74,35,77,25,34,161
2007,Eddie Jones,SG,35,MIA,35,1033,121,271,56,148,65,123,34,41,332
2007,Fred Jones,SG,27,TOT,63,1319,139,361,39,128,100,233,95,114,412
2007,Fred Jones,SG,27,TOR,39,870,96,249,32,101,64,148,73,88,297
2007,Fred Jones,SG,27,POR,24,449,43,112,7,27,36,85,22,26,115
2007,James Jones,SF,26,PHO,76,1376,162,440,90,238,72,202,71,81,485
2007,Jumaine Jones,SF,27,PHO,18,138,14,51,10,32,4,19,2,2,40
2007,Solomon Jones,PF,22,ATL,58,666,65,128,0,1,65,127,59,75,189
2007,Chris Kaman,C,24,LAC,75,2176,294,652,0,1,294,651,166,224,754
2007,Jason Kapono,SF,25,MIA,67,1767,278,563,108,210,170,353,66,74,730
2007,Viktor Khryapa,PF,24,CHI,33,231,27,70,0,6,27,64,19,26,73
2007,Jason Kidd,PG,33,NJN,80,2933,369,908,124,361,245,547,179,230,1041
2007,Tarence Kinsey,SG,22,MEM,48,967,139,304,13,46,126,258,78,98,369
2007,Andrei Kirilenko,SF,25,UTA,70,2049,197,418,16,75,181,343,174,239,584
2007,Linas Kleiza,PF,22,DEN,79,1488,200,474,83,221,117,253,115,135,598
2007,Brevin Knight,PG,31,CHA,45,1273,152,363,1,18,151,345,103,128,408
2007,Yaroslav Korolev,SF,19,LAC,10,41,4,16,1,5,3,11,3,6,12
2007,Kyle Korver,SF,25,PHI,74,2288,372,845,132,307,240,538,191,209,1067
2007,Nenad Krstic,C,23,NJN,26,848,170,323,0,1,170,322,86,121,426
2007,Raef LaFrentz,PF,30,POR,27,352,39,102,2,23,37,79,20,26,100
2007,James Lang,C,23,WAS,11,55,4,9,0,0,4,9,3,5,11
2007,David Lee,PF,23,NYK,58,1731,240,400,0,0,240,400,141,173,621
2007,Rashard Lewis,SF,27,SEA,60,2348,463,1005,151,387,312,618,265,315,1342
2007,Randy Livingston,PG,31,SEA,4,26,0,3,0,0,0,3,0,0,0
2007,Shaun Livingston,PG,21,LAC,54,1611,208,449,5,16,203,433,82,116,503
2007,Kyle Lowry,PG,20,MEM,10,175,14,38,3,8,11,30,25,28,56
2007,John Lucas,PG,24,HOU,47,383,62,156,15,59,47,97,15,19,154
2007,Tyronn Lue,PG,29,ATL,56,1488,218,524,56,161,162,363,144,163,636
2007,Mark Madsen,C,31,MIN,56,473,23,43,0,0,23,43,15,29,61
2007,Corey Maggette,SF,27,LAC,75,2291,367,808,13,65,354,743,519,633,1266
2007,Jamaal Magloire,C,28,POR,81,1703,199,395,0,0,199,395,131,242,529
2007,Renaldo Major,PF,24,GSW,1,27,2,10,0,0,2,10,1,2,5
2007,Stephon Marbury,PG,29,NYK,74,2748,395,952,123,345,272,607,297,386,1210
2007,Shawn Marion,SF,28,PHO,80,3010,561,1071,80,252,481,819,201,248,1403
2007,Damir Markota,PF,21,MIL,30,170,19,52,6,16,13,36,7,11,51
2007,Sean Marks,PF,31,PHO,3,17,2,6,0,1,2,5,2,2,6
2007,Donyell Marshall,PF,33,CLE,81,1360,209,493,95,271,114,222,53,80,566
2007,Rawle Marshall,SG,24,IND,40,361,32,89,4,18,28,71,31,45,99
2007,Darrick Martin,PG,35,TOR,31,220,33,94,13,37,20,57,15,21,94
2007,Kenyon Martin,PF,29,DEN,2,63,8,16,0,1,8,15,3,12,19
2007,Kevin Martin,SG,23,SAC,80,2818,505,1067,127,333,378,734,481,570,1618
2007,Desmond Mason,SF,29,NOK,75,2575,407,900,0,0,407,900,214,323,1028
2007,Roger Mason,SG,26,WAS,62,492,59,179,33,102,26,77,14,16,165
2007,Jason Maxiell,C,23,DET,67,943,131,262,0,0,131,262,72,137,334
2007,Sean May,PF,22,CHA,35,838,164,328,2,3,162,325,86,112,416
2007,Rashad McCants,SG,22,MIN,37,554,62,177,20,75,42,102,40,58,184
2007,Chris McCray,SG,22,MIL,5,12,0,3,0,0,0,3,0,0,0
2007,Antonio McDyess,PF,32,DET,82,1729,284,540,0,0,284,540,96,139,664
2007,Ivan McFarlin,PF,24,PHI,11,41,5,13,0,1,5,12,5,7,15
2007,Tracy McGrady,SG,27,HOU,71,2539,638,1480,126,381,512,1099,345,488,1747
2007,Jeff McInnis,PG,32,CHA,38,702,71,181,1,8,70,173,22,32,165
2007,Aaron McKie,SF,34,LAL,10,131,11,17,0,0,11,17,0,0,22
2007,Keith McLeod,PG,27,TOT,48,718,73,188,16,45,57,143,69,78,231
2007,Keith McLeod,PG,27,GSW,26,379,41,105,9,23,32,82,47,53,138
2007,Keith McLeod,PG,27,IND,22,339,32,83,7,22,25,61,22,25,93
2007,Stanislav Medvedenko,C,27,ATL,14,81,12,29,1,2,11,27,17,20,42
2007,Pops Mensah-Bonsu,PF,23,DAL,12,71,11,17,0,0,11,17,7,18,29
2007,C.J. Miles,SG,19,UTA,37,373,40,116,7,32,33,84,14,23,101
2007,Darko Milicic,PF,21,ORL,80,1913,249,548,0,1,249,547,141,230,639
2007,Andre Miller,PG,30,TOT,80,2966,424,909,5,35,419,874,222,283,1075
2007,Andre Miller,PG,30,DEN,23,822,117,248,4,16,113,232,62,85,300
2007,Andre Miller,PG,30,PHI,57,2144,307,661,1,19,306,642,160,198,775
2007,Brad Miller,C,30,SAC,63,1783,224,494,5,33,219,461,115,149,568
2007,Mike Miller,SG,26,MEM,70,2740,465,1010,202,498,263,512,161,203,1293
2007,Paul Millsap,PF,21,UTA,82,1472,209,398,1,3,208,395,140,208,559
2007,Yao Ming*,C,26,HOU,48,1624,423,819,0,2,423,817,356,413,1202
2007,Cuttino Mobley,SG,31,LAC,78,2841,388,882,101,246,287,636,200,239,1077
2007,Nazr Mohammed,C,29,DET,51,773,118,222,0,0,118,222,50,82,286
2007,Mikki Moore,C,31,NJN,79,2082,308,506,0,1,308,505,160,235,776
2007,Randolph Morris,C,21,NYK,5,44,1,6,0,0,1,6,2,6,4
2007,Adam Morrison,PF,22,CHA,78,2326,355,944,87,258,268,686,120,169,917
2007,Alonzo Mourning*,C,36,MIA,77,1572,238,425,0,0,238,425,185,308,661
2007,Troy Murphy,PF,26,TOT,68,1852,266,581,58,147,208,434,108,145,698
2007,Troy Murphy,PF,26,GSW,26,667,81,180,22,59,59,121,47,66,231
2007,Troy Murphy,PF,26,IND,42,1185,185,401,36,88,149,313,61,79,467
2007,Ronald Murray,SG,27,DET,69,1477,177,438,24,83,153,355,87,120,465
2007,Dikembe Mutombo*,C,40,HOU,75,1289,85,153,0,0,85,153,60,87,230
2007,Bostjan Nachbar,SF,26,NJN,76,1532,226,495,112,265,114,230,132,164,696
2007,Eduardo Najera,PF,30,DEN,75,1658,204,354,1,12,203,342,88,123,497
2007,Steve Nash,PG,32,PHO,76,2682,517,971,156,343,361,628,222,247,1412
2007,Jameer Nelson,PG,24,ORL,77,2331,376,875,65,194,311,681,183,221,1000
2007,Rasho Nesterovic,C,30,TOR,80,1676,230,421,0,1,230,420,34,50,494
2007,Ira Newble,SF,32,CLE,15,129,16,37,8,15,8,22,6,10,46
2007,Andres Nocioni,PF,27,CHI,53,1406,273,584,80,209,193,375,123,145,749
2007,David Noel,PF,22,MIL,68,792,65,177,17,53,48,124,37,43,184
2007,Steve Novak,SF,23,HOU,35,191,18,50,13,39,5,11,2,2,51
2007,Dirk Nowitzki,PF,28,DAL,78,2820,673,1341,72,173,601,1168,498,551,1916
2007,Patrick O'Bryant,C,20,GSW,16,119,10,32,0,0,10,32,11,17,31
2007,Jermaine O'Neal,C,28,IND,69,2459,498,1141,0,7,498,1134,343,447,1339
2007,Shaquille O'Neal*,C,34,MIA,40,1135,283,479,0,0,283,479,124,294,690
2007,Fabricio Oberto,PF,31,SAS,79,1365,158,281,0,0,158,281,33,51,349
2007,Lamar Odom,PF,27,LAL,56,2202,319,681,54,182,265,499,198,283,890
2007,Emeka Okafor,C,24,CHA,67,2329,394,740,0,0,394,740,175,295,963
2007,Mehmet Okur,C,27,UTA,80,2664,490,1061,129,336,361,725,296,387,1405
2007,Kevin Ollie,PG,34,PHI,53,919,81,187,0,2,81,185,37,45,199
2007,Michael Olowokandi,C,31,BOS,24,234,19,46,0,0,19,46,2,3,40
2007,Bo Outlaw,PF,35,ORL,41,460,34,51,0,0,34,51,13,22,81
2007,Travis Outlaw,PF,22,POR,67,1532,246,567,10,37,236,530,143,181,645
2007,Zaza Pachulia,C,22,ATL,72,2026,291,614,0,1,291,613,293,373,875
2007,Scott Padgett,PF,30,TOT,31,231,16,56,8,33,8,23,6,13,46
2007,Scott Padgett,PF,30,HOU,24,198,15,49,8,29,7,20,6,11,44
2007,Scott Padgett,PF,30,MEM,7,33,1,7,0,4,1,3,0,2,2
2007,Jannero Pargo,PG,27,NOK,82,1710,283,692,81,209,202,483,104,122,751
2007,Anthony Parker,SG,31,TOR,73,2437,328,687,115,261,213,426,132,158,903
2007,Smush Parker,PG,25,LAL,82,2457,342,785,110,301,232,484,113,175,907
2007,Tony Parker,PG,24,SAS,77,2499,570,1096,15,38,555,1058,274,350,1429
2007,Ruben Patterson,SF,31,MIL,81,2508,475,867,3,19,472,848,241,376,1194
2007,Chris Paul,PG,21,NOK,64,2353,381,871,50,143,331,728,292,357,1104
2007,Sasha Pavlovic,SG,23,CLE,67,1534,222,490,60,148,162,342,100,126,604
2007,Gary Payton*,PG,38,MIA,68,1503,144,366,32,123,112,243,38,57,358
2007,Kendrick Perkins,C,22,BOS,72,1576,132,269,0,3,132,266,60,100,324
2007,Morris Peterson,SF,29,TOR,71,1515,222,517,106,295,116,222,84,123,634
2007,Johan Petro,C,21,SEA,81,1510,226,438,0,0,226,438,50,77,502
2007,Eric Piatkowski,SG,36,PHO,11,73,9,25,7,18,2,7,2,2,27
2007,Paul Pierce,SG,29,BOS,47,1740,373,850,107,275,266,575,320,402,1173
2007,Mickael Pietrus,SF,24,GSW,72,1937,286,586,93,240,193,346,136,210,801
2007,Kevinn Pinkney,PF,23,BOS,6,100,12,27,1,2,11,25,6,9,31
2007,Scot Pollard,C,31,CLE,24,109,11,26,0,0,11,26,2,4,24
2007,James Posey,SF,30,MIA,71,1919,186,432,97,259,89,173,81,98,550
2007,Vitaly Potapenko,C,31,SAC,3,13,0,4,0,0,0,4,0,0,0
2007,Leon Powe,C,23,BOS,63,720,79,177,0,2,79,175,106,144,264
2007,Josh Powell,PF,24,TOT,37,353,43,93,0,0,43,93,30,42,116
2007,Josh Powell,PF,24,IND,7,64,2,15,0,0,2,15,8,12,12
2007,Josh Powell,PF,24,GSW,30,289,41,78,0,0,41,78,22,30,104
2007,Roger Powell,SF,24,UTA,3,13,0,3,0,1,0,2,2,2,2
2007,Ronnie Price,PG,23,SAC,58,563,67,172,21,65,46,107,37,55,192
2007,Tayshaun Prince,SF,26,DET,82,3001,459,997,81,210,378,787,172,224,1171
2007,Joel Przybilla,C,27,POR,43,701,37,78,0,0,37,78,10,27,84
2007,Chris Quinn,PG,23,MIA,42,408,48,131,20,57,28,74,25,37,141
2007,Vladimir Radmanovic,PF,26,LAL,55,986,134,316,40,118,94,198,53,73,361
2007,Shavlik Randolph,PF,23,PHI,13,179,23,48,0,0,23,48,12,22,58
2007,Zach Randolph,PF,25,POR,68,2425,600,1286,14,48,586,1238,394,481,1608
2007,Theo Ratliff,C,33,BOS,2,44,1,3,0,0,1,3,3,4,5
2007,Allan Ray,SG,22,BOS,47,710,100,259,48,116,52,143,42,55,290
2007,Michael Redd,SF,27,MIL,53,2036,477,1025,117,306,360,719,345,416,1416
2007,J.J. Redick,PG,22,ORL,42,622,80,195,38,98,42,97,54,60,252
2007,Justin Reed,PF,25,MIN,41,318,40,107,0,0,40,107,26,30,106
2007,Jared Reiner,C,24,MIL,27,244,15,43,0,0,15,43,3,10,33
2007,Jason Richardson,SG,26,GSW,51,1675,306,734,110,301,196,433,92,140,814
2007,Jeremy Richardson,SG-SF,22,TOT,6,20,3,6,2,3,1,3,0,0,8
2007,Jeremy Richardson,SG,22,ATL,5,19,3,6,2,3,1,3,0,0,8
2007,Jeremy Richardson,SF,22,POR,1,1,0,0,0,0,0,0,0,0,0
2007,Quentin Richardson,SF,26,NYK,49,1621,228,545,97,258,131,287,83,120,636
2007,Luke Ridnour,PG,25,SEA,71,2091,301,695,49,139,252,556,128,159,779
2007,Anthony Roberson,PG,23,GSW,20,227,44,104,21,55,23,49,2,3,111
2007,Lawrence Roberts,PF,24,MEM,54,969,94,208,0,2,94,206,95,131,283
2007,Bernard Robinson,SG-SF,26,TOT,31,278,19,62,0,2,19,60,23,27,61
2007,Bernard Robinson,SG,26,CHA,21,241,16,54,0,2,16,52,19,22,51
2007,Bernard Robinson,SF,26,NJN,10,37,3,8,0,0,3,8,4,5,10
2007,Clifford Robinson,C,40,NJN,50,955,81,218,25,66,56,152,16,36,203
2007,Nate Robinson,PG,22,NYK,64,1356,227,523,83,213,144,310,108,139,645
2007,Sergio Rodriguez,PG,20,POR,67,862,101,239,24,85,77,154,21,26,247
2007,Rajon Rondo,PG,20,BOS,78,1831,188,450,6,29,182,421,119,184,501
2007,Jalen Rose,SF,34,PHO,29,246,38,86,21,47,17,39,11,12,108
2007,Malik Rose,PF,32,NYK,65,810,74,186,2,8,72,178,42,52,192
2007,Quinton Ross,SG,25,LAC,81,1700,177,379,2,10,175,369,68,87,424
2007,Brandon Roy,SG,22,POR,57,2015,349,765,55,146,294,619,202,241,955
2007,Michael Ruffin,PF,30,WAS,30,271,5,18,0,0,5,18,7,19,17
2007,John Salmons,SG,27,SAC,79,2135,236,517,40,112,196,405,159,204,671
2007,Jamal Sampson,C,23,DEN,22,125,9,14,0,1,9,13,6,14,24
2007,Brian Scalabrine,PF,28,BOS,54,1027,77,191,44,110,33,81,18,23,216
2007,Luke Schenscher,C,24,POR,11,118,7,23,0,0,7,23,5,7,19
2007,Thabo Sefolosha,SG,22,CHI,71,868,109,256,15,42,94,214,23,45,256
2007,Mouhamed Sene,C,20,SEA,28,169,18,49,0,0,18,49,17,29,53
2007,Wayne Simien,PF,23,MIA,8,93,9,23,0,0,9,23,5,7,23
2007,Cedric Simmons,PF,21,NOK,43,534,55,132,0,0,55,132,16,33,126
2007,James Singleton,PF,25,LAC,53,376,30,82,3,14,27,68,22,29,85
2007,Brian Skinner,PF,30,MIL,67,1523,124,253,0,0,124,253,46,79,294
2007,Uros Slokar,C,23,TOR,20,72,14,26,1,2,13,24,9,13,38
2007,Craig Smith,PF,23,MIN,82,1537,246,463,0,6,246,457,116,186,608
2007,J.R. Smith,SG,21,DEN,63,1471,284,644,149,382,135,262,102,126,819
2007,Joe Smith,PF,31,TOT,65,1503,214,477,0,5,214,472,125,148,553
2007,Joe Smith,PF,31,DEN,11,148,23,48,0,1,23,47,10,12,56
2007,Joe Smith,PF,31,PHI,54,1355,191,429,0,4,191,425,115,136,497
2007,Josh Smith,SF,21,ATL,72,2647,436,993,38,152,398,841,268,387,1178
2007,Steven Smith,PF,23,PHI,8,28,2,8,0,0,2,8,1,2,5
2007,Eric Snow,PG,33,CLE,82,1929,135,324,0,4,135,320,72,113,342
2007,Kirk Snyder,SF,23,HOU,39,563,66,146,11,44,55,102,49,75,192
2007,Darius Songaila,PF,28,WAS,37,700,118,225,0,2,118,223,46,54,282
2007,Pape Sow,C,25,TOR,7,34,3,9,0,0,3,9,4,6,10
2007,Vassilis Spanoulis,SG,24,HOU,31,272,23,72,5,29,18,43,34,42,85
2007,Jerry Stackhouse,SF,32,DAL,67,1615,280,654,62,162,218,492,182,215,804
2007,DeShawn Stevenson,SG,25,WAS,82,2419,347,753,74,183,273,570,152,216,920
2007,Peja Stojakovic,SF,29,NOK,13,425,83,196,34,84,49,112,31,38,231
2007,Damon Stoudamire,PG,33,MEM,62,1501,171,437,59,175,112,262,66,83,467
2007,Salim Stoudamire,SG,24,ATL,61,1034,177,425,56,155,121,270,61,68,471
2007,Amar'e Stoudemire,C,24,PHO,82,2689,607,1055,0,3,607,1052,457,585,1671
2007,Mike Sweetney,C,24,CHI,48,385,58,134,0,0,58,134,37,66,153
2007,Stromile Swift,C,27,MEM,54,1029,161,346,0,5,161,341,97,134,419
2007,Wally Szczerbiak,SF,29,BOS,32,900,161,388,44,106,117,282,113,126,479
2007,Donell Taylor,SG,24,WAS,47,369,56,140,3,17,53,123,11,21,126
2007,Maurice Taylor,PF,30,SAC,12,103,8,28,0,0,8,28,8,13,24
2007,Sebastian Telfair,PG,21,BOS,78,1578,176,474,37,128,139,346,90,110,479
2007,Jason Terry,SG,29,DAL,81,2846,514,1063,162,370,352,693,160,199,1350
2007,Etan Thomas,C,28,WAS,65,1246,159,277,0,0,159,277,77,138,395
2007,Kenny Thomas,PF,29,SAC,62,1412,146,303,0,1,146,302,39,76,331
2007,Kurt Thomas,C,34,PHO,67,1208,126,259,0,1,126,258,56,71,308
2007,Tim Thomas,PF,29,LAC,76,2054,299,723,136,356,163,367,102,144,836
2007,Tyrus Thomas,PF,20,CHI,72,966,134,282,0,2,134,280,106,175,374
2007,Dijon Thompson,SF,23,ATL,6,50,6,15,0,2,6,13,5,6,17
2007,Jamaal Tinsley,PG,28,IND,72,2243,346,889,61,193,285,696,172,239,925
2007,Jake Tsakalidis,C,27,TOT,36,390,29,72,0,0,29,72,26,39,84
2007,Jake Tsakalidis,C,27,MEM,23,258,20,50,0,0,20,50,14,24,54
2007,Jake Tsakalidis,C,27,HOU,13,132,9,22,0,0,9,22,12,15,30
2007,P.J. Tucker,SF,21,TOR,17,83,11,22,0,0,11,22,8,14,30
2007,Ronny Turiaf,C,24,LAL,72,1087,147,268,0,1,147,267,89,134,383
2007,Hedo Turkoglu,SF,27,ORL,73,2268,345,823,109,281,236,542,171,219,970
2007,Ime Udoka,SF,29,POR,75,2144,237,514,89,219,148,295,66,89,629
2007,Beno Udrih,PG,24,SAS,73,948,127,344,33,115,94,229,53,60,340
2007,Anderson Varejao,C,24,CLE,81,1932,191,401,0,9,191,392,165,268,547
2007,Jacque Vaughn,PG,31,SAS,64,760,71,167,1,2,70,165,49,65,192
2007,Charlie Villanueva,PF,22,MIL,39,984,180,383,29,86,151,297,73,89,462
2007,Marcus Vinicius,SF,22,NOK,13,103,7,15,3,7,4,8,5,7,22
2007,Jake Voskuhl,C,29,CHA,73,1043,121,255,0,0,121,255,77,113,319
2007,Sasha Vujacic,SG,22,LAL,73,935,105,268,60,161,45,107,43,49,313
2007,Dwyane Wade,SG,25,MIA,51,1931,472,962,21,79,451,883,432,535,1397
2007,Von Wafer,SF,21,LAC,1,1,0,1,0,1,0,0,0,0,0
2007,Dajuan Wagner,SG,23,GSW,1,7,1,1,1,1,0,0,1,2,4
2007,Antoine Walker,PF,30,MIA,78,1818,265,668,84,305,181,363,46,105,660
2007,Ben Wallace,C,32,CHI,77,2697,192,424,1,5,191,419,109,267,494
2007,Gerald Wallace,SF,24,CHA,72,2640,478,952,39,120,439,832,309,447,1304
2007,Rasheed Wallace,C,32,DET,75,2419,357,843,104,296,253,547,108,137,926
2007,Luke Walton,SF,26,LAL,60,1982,264,557,48,124,216,433,108,145,684
2007,Hakim Warrick,PF,24,MEM,82,2152,373,712,0,8,373,704,299,388,1045
2007,Earl Watson,PG,27,SEA,77,2152,263,687,92,280,171,407,108,147,726
2007,Chris Webber,PF,33,TOT,61,1821,289,639,4,11,285,628,102,160,684
2007,Chris Webber,PF,33,PHI,18,544,89,230,2,5,87,225,18,28,198
2007,Chris Webber,PF,33,DET,43,1277,200,409,2,6,198,403,84,132,486
2007,Martell Webster,SF,20,POR,82,1759,195,492,91,250,104,242,93,132,574
2007,Bonzi Wells,SF,30,HOU,28,590,85,207,1,7,84,200,46,82,217
2007,David Wesley,SG,36,CLE,35,352,22,75,9,38,13,37,20,28,73
2007,David West,PF,26,NOK,52,1900,377,792,8,25,369,767,187,227,949
2007,Delonte West,SG,23,BOS,69,2219,306,717,65,178,241,539,168,197,845
2007,James White,SG,24,SAS,6,137,18,41,2,7,16,34,12,15,50
2007,Chris Wilcox,PF,24,SEA,82,2586,433,819,0,6,433,813,240,351,1106
2007,Damien Wilkins,SF,27,SEA,82,2037,262,602,50,122,212,480,150,170,724
2007,Mike Wilks,PG,27,SEA,47,534,66,141,5,15,61,126,33,42,170
2007,Aaron Williams,PF,35,LAC,38,374,29,53,0,1,29,52,18,22,76
2007,Alvin Williams,PG,32,LAC,2,10,0,2,0,1,0,1,2,4,2
2007,Deron Williams,PG,22,UTA,80,2950,494,1083,82,255,412,828,227,296,1297
2007,Eric Williams,SF,34,TOT,21,121,19,47,8,19,11,28,8,14,54
2007,Eric Williams,SF,34,SAS,16,88,15,34,8,17,7,17,4,7,42
2007,Eric Williams,SF,34,CHA,5,33,4,13,0,2,4,11,4,7,12
2007,Jason Williams,PG,31,MIA,61,1865,235,569,100,295,135,274,94,103,664
2007,Justin Williams,C,22,SAC,26,333,54,88,0,1,54,87,23,63,131
2007,Lou Williams,PG,20,PHI,61,688,93,211,12,37,81,174,64,92,262
2007,Marcus Williams,PG,21,NJN,79,1315,208,526,46,163,162,363,72,85,534
2007,Marvin Williams,PF,20,ATL,64,2179,306,706,11,45,295,661,216,265,839
2007,Mo Williams,PG,24,MIL,68,2472,468,1049,79,228,389,821,159,186,1174
2007,Shammond Williams,PG,31,LAL,30,345,35,86,20,50,15,36,4,6,94
2007,Shawne Williams,SG,20,IND,46,556,75,160,19,52,56,108,11,20,180
2007,Shelden Williams,PF,23,ATL,81,1514,166,365,2,4,164,361,110,144,444
2007,Corliss Williamson,PF,33,SAC,68,1337,236,463,0,2,236,461,148,207,620
2007,Kevin Willis,PF,44,DAL,5,43,5,13,0,0,5,13,2,2,12
2007,Metta World,SF,27,SAC,70,2641,458,1040,93,260,365,780,307,415,1316
2007,Antoine Wright,SG,22,NJN,63,1137,110,251,19,59,91,192,44,73,283
2007,Bracey Wright,SG,22,MIN,19,190,24,60,6,20,18,40,13,18,67
2007,Dorell Wright,SF,21,MIA,66,1292,162,364,5,34,157,330,64,86,393
2007,Lorenzen Wright,C,31,ATL,67,1035,82,183,0,0,82,183,9,32,173
,,,,,,,,,,,,,,,
2008,Shareef Abdur-Rahim,PF,31,SAC,6,51,3,14,0,0,3,14,4,4,10
2008,Arron Afflalo,SG,22,DET,75,970,99,241,10,48,89,193,68,87,276
2008,Maurice Ager,SG,23,TOT,26,165,21,65,3,19,18,46,6,12,51
2008,Maurice Ager,SG,23,DAL,12,77,5,27,0,8,5,19,5,6,15
2008,Maurice Ager,SG,23,NJN,14,88,16,38,3,11,13,27,1,6,36
2008,Blake Ahearn,PG,23,MIA,12,177,15,57,10,34,5,23,30,31,70
2008,LaMarcus Aldridge,PF,22,POR,76,2649,561,1160,1,7,560,1153,227,298,1350
2008,Malik Allen,PF,29,TOT,73,1096,157,327,1,2,156,325,23,25,338
2008,Malik Allen,PF,29,NJN,48,763,124,261,1,2,123,259,12,13,261
2008,Malik Allen,PF,29,DAL,25,333,33,66,0,0,33,66,11,12,77
2008,Ray Allen,SG,32,BOS,73,2624,439,986,180,452,259,534,215,237,1273
2008,Tony Allen,SG,26,BOS,75,1373,169,389,18,57,151,332,138,181,494
2008,Lance Allred,C,26,CLE,3,10,1,4,0,0,1,4,1,2,3
2008,Morris Almond,SG,22,UTA,9,39,4,15,1,4,3,11,4,6,13
2008,Rafer Alston,PG,31,HOU,74,2526,364,924,143,407,221,517,98,137,969
2008,Lou Amundson,PF,25,PHI,16,64,8,16,0,0,8,16,2,7,18
2008,Chris Andersen,C,29,NOH,5,34,2,7,0,0,2,7,2,4,6
2008,Derek Anderson,SG,33,CHA,28,396,47,125,19,52,28,73,28,38,141
2008,Carmelo Anthony,SF,23,DEN,77,2806,728,1481,58,164,670,1317,464,590,1978
2008,Joel Anthony,PF,25,MIA,24,498,28,60,0,0,28,60,29,49,85
2008,Gilbert Arenas,PG,26,WAS,13,425,78,196,22,78,56,118,74,96,252
2008,Trevor Ariza,SF,22,TOT,35,546,69,136,5,18,64,118,49,75,192
2008,Trevor Ariza,SF,22,ORL,11,115,14,31,0,3,14,28,8,15,36
2008,Trevor Ariza,SF,22,LAL,24,431,55,105,5,15,50,90,41,60,156
2008,Darrell Armstrong,PG,39,NJN,50,549,40,110,23,69,17,41,20,30,123
2008,Hilton Armstrong,C,23,NOH,65,732,67,148,0,0,67,148,44,70,178
2008,Carlos Arroyo,PG,28,ORL,62,1269,157,348,29,84,128,264,87,102,430
2008,Chucky Atkins,SG,33,DEN,24,352,42,122,25,79,17,43,4,9,113
2008,James Augustine,PF,23,ORL,25,149,18,34,0,0,18,34,4,8,40
2008,Kelenna Azubuike,SG,24,GSW,81,1732,261,587,71,195,190,392,99,138,692
2008,Renaldo Balkman,SF,23,NYK,65,952,91,186,1,12,90,174,41,95,224
2008,Marcus Banks,PG,26,TOT,36,569,86,191,40,102,46,89,27,35,239
2008,Marcus Banks,PG,26,PHO,24,310,44,109,25,65,19,44,12,16,125
2008,Marcus Banks,PG,26,MIA,12,259,42,82,15,37,27,45,15,19,114
2008,Leandro Barbosa,SG,25,PHO,82,2421,472,1021,164,422,308,599,175,213,1283
2008,J.J. Barea,PG,23,DAL,44,460,71,170,21,54,50,116,28,35,191
2008,Andrea Bargnani,PF,22,TOR,78,1861,280,725,90,261,190,464,142,169,792
2008,Matt Barnes,PF,27,GSW,73,1414,187,442,53,181,134,261,59,79,486
2008,Andre Barrett,PG,25,LAC,4,25,2,5,1,3,1,2,1,2,6
2008,Earl Barron,C,26,MIA,46,889,132,327,1,13,131,314,61,87,326
2008,Brent Barry,SF,36,SAS,31,554,77,160,48,112,29,48,19,20,221
2008,Brandon Bass,C,22,DAL,79,1557,246,493,0,4,246,489,162,197,654
2008,Maceo Baston,PF,32,TOR,15,103,17,25,0,0,17,25,7,10,41
2008,Shane Battier,SF,29,HOU,80,2907,265,619,139,369,126,250,75,101,744
2008,Marco Belinelli,PG,21,GSW,33,241,36,93,16,41,20,52,7,9,95
2008,Charlie Bell,SG,28,MIL,68,1628,185,486,74,217,111,269,70,87,514
2008,Raja Bell,SG,31,PHO,75,2646,317,753,176,439,141,314,79,91,889
2008,Mike Bibby,PG,29,TOT,48,1573,248,603,93,248,155,355,78,100,667
2008,Mike Bibby,PG,29,SAC,15,473,78,192,24,61,54,131,23,31,203
2008,Mike Bibby,PG,29,ATL,33,1100,170,411,69,187,101,224,55,69,464
2008,Andris Biedrins,C,21,GSW,76,2078,340,543,0,0,340,543,116,187,796
2008,Chauncey Billups,PG,31,DET,78,2522,393,877,137,342,256,535,401,437,1324
2008,Steve Blake,PG,27,POR,81,2424,261,640,121,298,140,342,49,64,692
2008,Andray Blatche,PF,21,WAS,82,1675,254,536,3,13,251,523,107,154,618
2008,Mark Blount,C,32,MIA,69,1542,238,515,17,44,221,471,88,138,581
2008,Keith Bogans,SG,27,ORL,82,2198,241,588,148,409,93,179,81,110,711
2008,Andrew Bogut,C,23,MIL,78,2720,465,910,0,7,465,903,189,322,1119
2008,Matt Bonner,PF,27,SAS,68,853,121,291,46,137,75,154,38,44,326
2008,Josh Boone,PF,23,NJN,70,1773,238,434,0,0,238,434,99,217,575
2008,Calvin Booth,C,31,PHI,31,204,9,27,0,0,9,27,6,10,24
2008,Carlos Boozer,PF,26,UTA,81,2827,709,1297,0,1,709,1296,290,393,1708
2008,Chris Bosh,C,23,TOR,67,2425,507,1027,10,25,497,1002,472,559,1496
2008,Bruce Bowen,SF,36,SAS,81,2448,174,428,90,215,84,213,45,69,483
2008,Ryan Bowen,SF,32,NOH,53,660,49,100,0,1,49,99,16,29,114
2008,Earl Boykins,PG,31,CHA,36,577,61,172,14,44,47,128,49,59,185
2008,Elton Brand,PF,28,LAC,8,274,52,114,0,0,52,114,37,47,141
2008,Corey Brewer,SF,21,MIN,79,1803,182,486,7,36,175,450,88,110,459
2008,Ronnie Brewer,SG,22,UTA,76,2088,354,634,11,50,343,584,195,257,914
2008,Primoz Brezec,C,28,TOT,50,475,44,94,0,0,44,94,24,40,112
2008,Primoz Brezec,C,28,CHA,20,267,17,43,0,0,17,43,3,5,37
2008,Primoz Brezec,C,28,DET,17,98,10,13,0,0,10,13,7,14,27
2008,Primoz Brezec,C,28,TOR,13,110,17,38,0,0,17,38,14,21,48
2008,Aaron Brooks,PG,23,HOU,51,608,93,225,36,109,57,116,42,49,264
2008,Andre Brown,PF,26,MEM,33,286,39,78,0,0,39,78,22,49,100
2008,Devin Brown,SG,29,CLE,78,1762,217,531,45,146,172,385,107,142,586
2008,Kwame Brown,C,25,TOT,38,713,72,142,0,0,72,142,40,98,184
2008,Kwame Brown,C,25,LAL,23,509,53,103,0,0,53,103,26,64,132
2008,Kwame Brown,C,25,MEM,15,204,19,39,0,0,19,39,14,34,52
2008,P.J. Brown,PF,38,BOS,18,209,14,41,0,1,14,40,11,16,39
2008,Shannon Brown,SG,22,TOT,21,240,44,126,9,30,35,96,17,29,114
2008,Shannon Brown,SG,22,CLE,15,218,41,111,9,29,32,82,14,23,105
2008,Shannon Brown,SG,22,CHI,6,22,3,15,0,1,3,14,3,6,9
2008,Kobe Bryant,SG,29,LAL,82,3192,775,1690,150,415,625,1275,623,742,2323
2008,Greg Buckner,SG,31,MIN,31,520,45,117,15,50,30,67,19,22,124
2008,Caron Butler,SF,27,WAS,58,2314,439,943,66,185,373,758,236,262,1180
2008,Rasual Butler,SF,28,NOH,51,875,91,260,44,133,47,127,26,31,252
2008,Andrew Bynum,C,20,LAL,35,1008,189,297,0,0,189,297,82,118,460
2008,Jose Calderon,PG,26,TOR,82,2484,367,707,79,184,288,523,109,120,922
2008,Marcus Camby,C,33,DEN,79,2758,286,635,6,20,280,615,143,202,721
2008,Brian Cardinal,PF,30,MEM,37,440,43,126,25,81,18,45,13,19,124
2008,Rodney Carney,SF,23,PHI,70,1039,158,392,38,120,120,272,55,81,409
2008,Matt Carroll,SG,27,CHA,80,2016,252,589,105,241,147,348,111,138,720
2008,Anthony Carter,PG,32,DEN,70,1960,218,476,45,129,173,347,64,85,545
2008,Vince Carter,SG,31,NJN,76,2959,587,1287,98,273,489,1014,350,429,1622
2008,Sam Cassell,PG,38,TOT,55,1274,233,532,23,76,210,456,127,144,616
2008,Sam Cassell,PG,38,LAC,38,975,183,402,14,54,169,348,106,119,486
2008,Sam Cassell,PG,38,BOS,17,299,50,130,9,22,41,108,21,25,130
2008,Tyson Chandler,C,25,NOH,79,2783,377,605,0,1,377,604,175,295,929
2008,Wilson Chandler,SF,20,NYK,35,685,106,242,9,30,97,212,34,54,255
2008,Josh Childress,SF,24,ATL,76,2274,327,573,22,60,305,513,222,275,898
2008,Jarron Collins,C,29,UTA,70,702,36,82,0,1,36,81,46,74,118
2008,Jason Collins,C,29,TOT,74,1172,53,113,0,1,53,112,34,74,140
2008,Jason Collins,C,29,NJN,43,684,23,54,0,0,23,54,14,36,60
2008,Jason Collins,C,29,MEM,31,488,30,59,0,1,30,58,20,38,80
2008,Mardy Collins,SG,23,NYK,46,634,57,175,8,32,49,143,23,38,145
2008,Nick Collison,PF,27,SEA,78,2223,322,641,0,2,322,639,123,167,767
2008,Mike Conley,PG,20,MEM,53,1381,189,442,30,91,159,351,90,123,498
2008,Brian Cook,PF,27,TOT,51,629,88,234,43,115,45,119,19,21,238
2008,Brian Cook,PF,27,LAL,6,70,4,21,2,10,2,11,4,4,14
2008,Brian Cook,PF,27,ORL,45,559,84,213,41,105,43,108,15,17,224
2008,Daequan Cook,SG,20,MIA,59,1441,196,514,79,238,117,276,47,57,518
2008,Jamal Crawford,SG,27,NYK,80,3190,570,1391,176,494,394,897,329,381,1645
2008,Javaris Crittenton,SG,20,TOT,50,679,98,233,10,37,88,196,72,104,278
2008,Javaris Crittenton,SG,20,LAL,22,171,26,53,1,3,25,50,19,28,72
2008,Javaris Crittenton,SG,20,MEM,28,508,72,180,9,34,63,146,53,76,206
2008,Austin Croshere,PF,32,GSW,44,457,61,137,22,61,39,76,29,32,173
2008,Eddy Curry,C,25,NYK,59,1530,297,544,0,0,297,544,187,300,781
2008,Samuel Dalembert,C,26,PHI,82,2724,339,661,0,1,339,660,186,263,864
2008,Erick Dampier,C,32,DAL,72,1755,178,277,0,0,178,277,84,146,440
2008,Antonio Daniels,PG,32,WAS,71,2161,205,447,17,74,188,373,170,219,597
2008,Marquis Daniels,SG,27,IND,74,1546,241,561,27,102,214,459,97,139,606
2008,Jermareo Davidson,SF,23,CHA,38,322,51,125,0,0,51,125,18,28,120
2008,Baron Davis,PG,28,GSW,82,3196,650,1526,173,525,477,1001,318,424,1791
2008,Glen Davis,C,22,BOS,69,940,107,221,0,0,107,221,99,150,313
2008,Paul Davis,PF,23,LAC,22,194,24,65,0,0,24,65,6,10,54
2008,Ricky Davis,SF,28,MIA,82,2963,420,971,135,333,285,638,155,197,1130
2008,Carlos Delfino,SG,25,TOR,82,1928,251,632,120,314,131,318,116,156,738
2008,Luol Deng,SF,22,CHI,63,2128,429,896,8,22,421,874,204,265,1070
2008,Boris Diaw,PF,25,PHO,82,2308,308,646,13,41,295,605,96,129,725
2008,Yakhouba Diawara,SG,25,DEN,54,542,55,134,21,66,34,68,22,31,153
2008,Guillermo Diaz,SG,22,LAC,6,18,1,4,0,1,1,3,3,5,5
2008,Dan Dickau,PG,29,LAC,67,1040,124,296,36,108,88,188,68,82,352
2008,Kaniel Dickens,PF,29,CLE,5,12,1,3,0,0,1,3,0,0,2
2008,Travis Diener,PG,25,IND,66,1356,159,430,74,233,85,197,64,71,456
2008,Ike Diogu,PF,24,IND,30,305,64,134,0,0,64,134,40,47,168
2008,DeSagana Diop,C,26,TOT,79,1295,94,180,0,0,94,180,38,70,226
2008,DeSagana Diop,C,26,DAL,52,894,67,115,0,0,67,115,24,40,158
2008,DeSagana Diop,C,26,NJN,27,401,27,65,0,0,27,65,14,30,68
2008,Juan Dixon,PG,29,TOT,53,668,106,258,30,72,76,186,21,26,263
2008,Juan Dixon,PG,29,TOR,36,424,59,160,17,39,42,121,18,19,153
2008,Juan Dixon,PG,29,DET,17,244,47,98,13,33,34,65,3,7,110
2008,Michael Doleac,C,30,MIN,24,257,28,63,0,0,28,63,1,2,57
2008,Keyon Dooling,PG,27,ORL,72,1334,198,423,22,65,176,358,163,193,581
2008,Quincy Douby,PG,23,SAC,74,876,132,335,42,122,90,213,48,52,354
2008,Jared Dudley,PF,22,CHA,73,1384,163,348,9,41,154,307,87,118,422
2008,Chris Duhon,PG,25,CHI,66,1490,133,344,54,155,79,189,65,80,385
2008,Tim Duncan,C,31,SAS,78,2651,585,1178,0,4,585,1174,338,463,1508
2008,Mike Dunleavy,SG,27,IND,82,2953,532,1117,165,389,367,728,336,403,1565
2008,Ronald Dupree,SF,27,TOT,5,21,1,3,0,0,1,3,2,2,4
2008,Ronald Dupree,SF,27,DET,1,3,0,0,0,0,0,0,0,0,0
2008,Ronald Dupree,SF,27,SEA,4,18,1,3,0,0,1,3,2,2,4
2008,Kevin Durant,SG,19,SEA,80,2768,587,1366,59,205,528,1161,391,448,1624
2008,Monta Ellis,SG,22,GSW,81,3071,652,1227,12,52,640,1175,320,417,1636
2008,Francisco Elson,C,31,TOT,63,813,92,236,0,1,92,235,26,37,210
2008,Francisco Elson,C,31,SAS,41,534,62,148,0,0,62,148,20,24,144
2008,Francisco Elson,C,31,SEA,22,279,30,88,0,1,30,87,6,13,66
2008,Melvin Ely,C,29,NOH,52,621,85,180,0,0,85,180,32,58,202
2008,Maurice Evans,SG,29,TOT,75,1720,262,545,81,209,181,336,59,83,664
2008,Maurice Evans,SG,29,LAL,7,96,9,28,1,7,8,21,12,15,31
2008,Maurice Evans,SG,29,ORL,68,1624,253,517,80,202,173,315,47,68,633
2008,Reggie Evans,PF,27,PHI,81,1879,152,346,1,1,151,345,120,257,425
2008,Jordan Farmar,PG,21,LAL,82,1690,291,631,114,307,177,324,53,78,749
2008,Nick Fazekas,PF,22,TOT,26,269,46,82,0,2,46,80,15,22,107
2008,Nick Fazekas,PF,22,DAL,4,9,2,5,0,0,2,5,0,0,4
2008,Nick Fazekas,PF,22,LAC,22,260,44,77,0,2,44,75,15,22,103
2008,Raymond Felton,PG,23,CHA,79,2972,412,997,56,200,356,797,260,325,1140
2008,Kyrylo Fesenko,C,21,UTA,9,70,6,16,0,0,6,16,2,4,14
2008,Michael Finley,SG,34,SAS,82,2204,315,761,132,357,183,404,64,80,826
2008,Derek Fisher,PG,33,LAL,82,2249,339,777,112,276,227,501,166,188,956
2008,T.J. Ford,PG,24,TOR,51,1199,246,524,15,51,231,473,110,125,617
2008,Jeff Foster,C,31,IND,77,1884,205,373,0,3,205,370,86,145,496
2008,Randy Foye,PG,24,MIN,39,1259,198,462,61,148,137,314,53,65,510
2008,Adonal Foyle,C,32,ORL,82,774,70,153,0,0,70,153,16,34,156
2008,Richie Frahm,SG,30,LAC,10,163,20,54,7,25,13,29,0,2,47
2008,Steve Francis,PG,30,HOU,10,199,19,57,4,17,15,40,13,23,55
2008,Channing Frye,C,24,POR,78,1342,221,453,3,10,218,443,85,109,530
2008,Dan Gadzuric,C,29,MIL,51,534,64,154,0,1,64,153,33,63,161
2008,Jorge Garbajosa,PF,30,TOR,7,74,8,25,6,16,2,9,0,0,22
2008,Francisco Garcia,SF,26,SAC,79,2096,348,752,113,289,235,463,162,208,971
2008,Thomas Gardner,SG,22,CHI,4,45,9,23,3,12,6,11,0,2,21
2008,Kevin Garnett,PF,31,BOS,71,2328,534,990,0,11,534,979,269,336,1337
2008,Pat Garrity,PF,31,ORL,31,284,27,80,8,37,19,43,4,5,66
2008,Pau Gasol,C,27,TOT,66,2351,475,890,4,16,471,874,292,362,1246
2008,Pau Gasol,C,27,MEM,39,1433,279,557,4,15,275,542,176,215,738
2008,Pau Gasol,C,27,LAL,27,918,196,333,0,1,196,332,116,147,508
2008,Rudy Gay,SF,21,MEM,81,3000,625,1355,134,387,491,968,248,316,1632
2008,Mickael Gelabale,SG,24,SEA,39,465,69,157,16,37,53,120,14,18,168
2008,Devean George,SF,30,DAL,53,821,74,207,22,68,52,139,24,34,194
2008,Daniel Gibson,PG,21,CLE,58,1765,201,465,118,268,83,197,85,105,605
2008,Eddie Gill,PG,29,TOT,14,154,12,31,5,15,7,16,9,9,38
2008,Eddie Gill,PG,29,NJN,13,149,12,29,5,14,7,15,9,9,38
2008,Eddie Gill,PG,29,SEA,1,5,0,2,0,1,0,1,0,0,0
2008,Manu Ginobili,SG,30,SAS,74,2299,453,984,156,389,297,595,380,442,1442
2008,Gordan Giricek,SG,30,TOT,56,831,133,302,36,99,97,203,23,26,325
2008,Gordan Giricek,SG,30,UTA,22,279,41,102,12,34,29,68,1,1,95
2008,Gordan Giricek,SG,30,PHI,12,110,13,41,5,15,8,26,6,8,37
2008,Gordan Giricek,SG,30,PHO,22,442,79,159,19,50,60,109,16,17,193
2008,Ryan Gomes,PF,25,MIN,82,2434,392,857,59,179,333,678,190,229,1033
2008,Drew Gooden,PF,26,TOT,69,2122,332,740,0,6,332,734,162,215,826
2008,Drew Gooden,PF,26,CLE,51,1564,232,523,0,3,232,520,110,151,574
2008,Drew Gooden,PF,26,CHI,18,558,100,217,0,3,100,214,52,64,252
2008,Ben Gordon,SG,24,CHI,72,2291,464,1069,142,346,322,723,266,293,1336
2008,Marcin Gortat,C,23,ORL,6,41,8,17,0,0,8,17,2,3,18
2008,Joey Graham,SF,25,TOR,38,331,49,113,2,3,47,110,38,45,138
2008,Stephen Graham,SF,25,IND,22,128,34,58,7,14,27,44,12,16,87
2008,Danny Granger,SF,24,IND,80,2876,537,1205,171,423,366,782,322,378,1567
2008,Aaron Gray,C,23,CHI,61,613,103,204,0,1,103,203,56,99,262
2008,Gerald Green,SF,22,TOT,30,362,52,151,15,39,37,112,34,41,153
2008,Gerald Green,SF,22,MIN,29,358,49,148,15,39,34,109,34,41,147
2008,Gerald Green,SF,22,HOU,1,4,3,3,0,0,3,3,0,0,6
2008,Jeff Green,SF,21,SEA,80,2253,320,749,21,76,299,673,177,238,838
2008,Taurean Green,SG-PG,21,TOT,17,74,7,25,2,11,5,14,11,12,27
2008,Taurean Green,PG,21,POR,8,44,4,16,1,8,3,8,8,8,17
2008,Taurean Green,SG,21,DEN,9,30,3,9,1,3,2,6,3,4,10
2008,Willie Green,SG,26,PHI,74,1970,379,870,51,179,328,691,112,148,921
2008,Orien Greene,SG,25,SAC,7,61,3,11,0,1,3,10,0,0,6
2008,Adrian Griffin,SG-SF,33,TOT,35,307,30,76,0,0,30,76,5,9,65
2008,Adrian Griffin,SG,33,CHI,22,222,24,60,0,0,24,60,3,7,51
2008,Adrian Griffin,SF,33,SEA,13,85,6,16,0,0,6,16,2,2,14
2008,Richard Hamilton,SG,29,DET,72,2424,499,1030,62,141,437,889,184,221,1244
2008,Anfernee Hardaway,SF,36,MIA,16,325,22,60,8,19,14,41,8,9,60
2008,Matt Harpring,SF,31,UTA,76,1374,237,474,2,10,235,464,146,205,622
2008,Al Harrington,C,27,GSW,81,2190,401,923,153,408,248,515,147,190,1102
2008,Othella Harrington,C,34,CHA,22,166,18,42,0,0,18,42,10,16,46
2008,Devin Harris,PG,24,TOT,64,2022,321,693,56,167,265,526,248,301,946
2008,Devin Harris,PG,24,DAL,39,1184,187,387,25,70,162,317,161,196,560
2008,Devin Harris,PG,24,NJN,25,838,134,306,31,97,103,209,87,105,386
2008,Mike Harris,PF,24,HOU,17,159,27,54,0,2,27,52,8,13,62
2008,David Harrison,C,25,IND,55,702,90,170,0,0,90,170,49,96,229
2008,Jason Hart,PG,29,UTA,57,606,58,180,11,31,47,149,38,45,165
2008,Udonis Haslem,PF,27,MIA,49,1805,237,507,0,0,237,507,115,142,589
2008,Trenton Hassell,SG,28,TOT,63,773,57,135,2,9,55,126,7,10,123
2008,Trenton Hassell,SG,28,DAL,37,463,37,80,1,4,36,76,1,2,76
2008,Trenton Hassell,SG,28,NJN,26,310,20,55,1,5,19,50,6,8,47
2008,Spencer Hawes,C,19,SAC,71,931,146,318,4,21,142,297,38,58,334
2008,Chuck Hayes,PF,24,HOU,79,1575,113,221,0,3,113,218,11,24,237
2008,Jarvis Hayes,SF,26,DET,82,1287,217,504,73,194,144,310,45,60,552
2008,Brendan Haywood,C,28,WAS,80,2228,316,599,0,0,316,599,216,294,848
2008,Luther Head,SG,25,HOU,73,1379,206,477,79,225,127,252,66,81,557
2008,Walter Herrmann,PF,28,TOT,45,373,56,144,20,64,36,80,21,25,153
2008,Walter Herrmann,PF,28,CHA,17,174,25,65,9,26,16,39,9,10,68
2008,Walter Herrmann,PF,28,DET,28,199,31,79,11,38,20,41,12,15,85
2008,Nene Hilario,PF,25,DEN,16,266,29,71,0,1,29,70,27,49,85
2008,Grant Hill,SF,35,PHO,70,2222,358,712,33,104,325,608,170,196,919
2008,Kirk Hinrich,PG,27,CHI,75,2380,330,797,84,240,246,557,118,142,862
2008,Ryan Hollins,PF,23,CHA,60,532,46,94,0,0,46,94,55,82,147
2008,Al Horford,C,21,ATL,81,2540,333,668,0,5,333,663,155,212,821
2008,Robert Horry,PF,37,SAS,45,583,38,119,18,70,20,49,18,28,112
2008,Eddie House,PG,29,BOS,78,1480,217,531,117,298,100,233,33,36,584
2008,Dwight Howard,C,22,ORL,82,3088,583,974,0,4,583,970,529,897,1695
2008,Josh Howard,SF,27,DAL,76,2757,567,1247,67,210,500,1037,312,384,1513
2008,Juwan Howard,PF,34,DAL,50,353,23,64,0,0,23,64,11,14,57
2008,Troy Hudson,PG,31,GSW,9,93,9,31,4,12,5,19,6,6,28
2008,Larry Hughes,PG-SG,29,TOT,68,2020,305,801,67,194,238,607,150,188,827
2008,Larry Hughes,PG,29,CLE,40,1210,180,478,43,126,137,352,88,108,491
2008,Larry Hughes,SG,29,CHI,28,810,125,323,24,68,101,255,62,80,336
2008,Kris Humphries,PF,22,TOR,70,925,161,333,0,2,161,331,75,124,397
2008,Lindsey Hunter,PG,37,DET,24,215,22,64,7,26,15,38,7,9,58
2008,Steven Hunter,C,26,DEN,19,120,15,28,0,0,15,28,9,20,39
2008,Andre Iguodala,SF,24,PHI,82,3242,582,1277,101,307,481,970,365,506,1630
2008,Zydrunas Ilgauskas,C,32,CLE,73,2222,417,879,0,1,417,878,195,243,1029
2008,Didier Ilunga-Mbenga,C,27,TOT,42,326,39,84,0,0,39,84,5,12,83
2008,Didier Ilunga-Mbenga,C,27,GSW,16,130,9,23,0,0,9,23,1,2,19
2008,Didier Ilunga-Mbenga,C,27,LAL,26,196,30,61,0,0,30,61,4,10,64
2008,Allen Iverson*,SG,32,DEN,82,3424,712,1556,95,275,617,1281,645,797,2164
2008,Royal Ivey,PG,26,MIL,75,1437,149,378,35,107,114,271,85,117,418
2008,Jarrett Jack,SG,24,POR,82,2229,267,620,65,190,202,430,215,248,814
2008,Bobby Jackson,SG-PG,34,TOT,72,1389,204,506,81,226,123,280,64,81,553
2008,Bobby Jackson,SG,34,NOH,46,891,116,296,53,144,63,152,40,49,325
2008,Bobby Jackson,PG,34,HOU,26,498,88,210,28,82,60,128,24,32,228
2008,Luke Jackson,SF,26,MIA,14,228,26,80,11,30,15,50,16,23,79
2008,Stephen Jackson,SF,29,GSW,73,2855,488,1204,182,501,306,703,308,370,1466
2008,Casey Jacobsen,SG,26,MEM,53,547,39,115,16,72,23,43,13,17,107
2008,Jerome James,C,32,NYK,2,5,1,1,0,0,1,1,2,2,4
2008,LeBron James,SF,23,CLE,75,3027,794,1642,113,359,681,1283,549,771,2250
2008,Mike James,PG,32,TOT,54,720,101,290,31,97,70,193,39,48,272
2008,Mike James,PG,32,HOU,33,537,79,226,24,74,55,152,33,42,215
2008,Mike James,PG,32,NOH,21,183,22,64,7,23,15,41,6,6,57
2008,Antawn Jamison,PF,31,WAS,79,3061,618,1417,120,354,498,1063,333,438,1689
2008,Marko Jaric,SG,29,MIN,75,2189,227,528,46,127,181,401,121,163,621
2008,Al Jefferson,C,23,MIN,82,2919,721,1441,0,5,721,1436,284,394,1726
2008,Richard Jefferson,SF,27,NJN,82,3200,619,1328,77,213,542,1115,542,679,1857
2008,Jared Jeffries,SF,26,NYK,73,1325,108,270,4,25,104,245,49,93,269
2008,Yi Jianlian,PF,20,MIL,66,1647,219,520,6,21,213,499,122,145,566
2008,Alexander Johnson,PF,24,MIA,43,549,61,125,0,0,61,125,57,83,179
2008,Amir Johnson,PF,20,DET,62,764,92,165,0,0,92,165,37,55,221
2008,Anthony Johnson,PG,33,TOT,69,1531,155,355,42,93,113,262,35,43,387
2008,Anthony Johnson,PG,33,ATL,42,1121,115,267,27,63,88,204,26,32,283
2008,Anthony Johnson,PG,33,SAC,27,410,40,88,15,30,25,58,9,11,104
2008,DerMarr Johnson,SF,27,SAS,5,28,7,14,3,9,4,5,0,2,17
2008,Joe Johnson,SG,26,ATL,82,3343,647,1497,169,444,478,1053,316,379,1779
2008,Linton Johnson,PF,27,TOT,8,63,9,19,1,3,8,16,2,2,21
2008,Linton Johnson,PF,27,PHO,6,53,7,14,1,2,6,12,0,0,15
2008,Linton Johnson,PF,27,TOR,2,10,2,5,0,1,2,4,2,2,6
2008,Bobby Jones,C-SF,24,TOT,47,531,60,140,18,53,42,87,40,51,178
2008,Bobby Jones,C,24,DEN,25,222,26,64,9,23,17,41,23,28,84
2008,Bobby Jones,SF,24,MEM,9,137,14,36,3,13,11,23,9,10,40
2008,Bobby Jones,SF,24,HOU,4,9,2,4,0,0,2,4,0,0,4
2008,Bobby Jones,SF,24,MIA,6,143,17,32,6,15,11,17,8,13,48
2008,Bobby Jones,SF,24,SAS,3,20,1,4,0,2,1,2,0,0,2
2008,Dahntay Jones,SG,27,SAC,25,206,23,53,1,6,22,47,34,51,81
2008,Damon Jones,SG,31,CLE,67,1336,151,363,115,276,36,87,20,28,437
2008,Dwayne Jones,PF,24,CLE,56,472,25,47,0,1,25,46,28,58,78
2008,Eddie Jones,SG,36,DAL,47,922,66,180,34,116,32,64,10,14,176
2008,Fred Jones,SG,28,NYK,70,1757,182,432,74,192,108,240,94,126,532
2008,James Jones,SF,27,POR,58,1276,143,327,91,205,52,122,86,98,463
2008,Solomon Jones,PF,23,ATL,35,145,12,30,0,2,12,28,11,20,35
2008,Chris Kaman,C,25,LAC,56,2083,338,700,0,4,338,696,202,265,878
2008,Jason Kapono,SF,26,TOR,81,1530,243,498,57,118,186,380,37,43,580
2008,Coby Karl,SG,24,LAL,17,71,9,26,4,13,5,13,8,10,30
2008,Viktor Khryapa,PF,25,CHI,9,105,12,31,0,1,12,30,8,14,32
2008,Jason Kidd,PG,34,TOT,80,2906,305,793,119,312,186,481,135,165,864
2008,Jason Kidd,PG,34,NJN,51,1895,201,549,84,236,117,313,91,111,577
2008,Jason Kidd,PG,34,DAL,29,1011,104,244,35,76,69,168,44,54,287
2008,Tarence Kinsey,SG,23,MEM,11,96,16,38,3,7,13,31,5,6,40
2008,Andrei Kirilenko,SF,26,UTA,72,2217,275,544,44,116,231,428,198,257,792
2008,Linas Kleiza,SF,23,DEN,79,1889,311,659,94,277,217,382,164,213,880
2008,Brevin Knight,PG,32,LAC,74,1674,138,342,0,6,138,336,62,71,338
2008,Kyle Korver,SG-PF,26,TOT,75,1732,255,575,111,296,144,279,119,130,740
2008,Kyle Korver,PF,26,PHI,25,657,90,227,38,108,52,119,31,34,249
2008,Kyle Korver,SG,26,UTA,50,1075,165,348,73,188,92,160,88,96,491
2008,Nenad Krstic,C,24,NJN,45,812,123,300,0,2,123,298,52,69,298
2008,Raef LaFrentz,C,31,POR,39,291,27,61,0,4,27,57,11,19,65
2008,Carl Landry,PF,24,HOU,42,711,135,219,0,1,135,218,72,109,342
2008,Keith Langford,SG,24,SAS,2,10,1,4,0,0,1,4,0,0,2
2008,Stephane Lasme,PF-SF,25,TOT,16,303,32,71,0,0,32,71,19,32,83
2008,Stephane Lasme,SF,25,GSW,1,0,0,0,0,0,0,0,0,0,0
2008,Stephane Lasme,PF,25,MIA,15,303,32,71,0,0,32,71,19,32,83
2008,Acie Law,PG,23,ATL,56,865,95,237,7,34,88,203,38,48,235
2008,David Lee,PF,24,NYK,81,2356,341,618,0,2,341,616,194,237,876
2008,Rashard Lewis,PF,28,ORL,81,3076,516,1135,226,553,290,582,218,260,1476
2008,Kyle Lowry,PG,21,MEM,82,2089,256,592,36,140,220,452,243,348,791
2008,Tyronn Lue,PG,30,TOT,50,736,113,253,39,86,74,167,25,32,290
2008,Tyronn Lue,PG,30,ATL,33,564,86,196,30,69,56,127,24,28,226
2008,Tyronn Lue,PG,30,DAL,17,172,27,57,9,17,18,40,1,4,64
2008,Mark Madsen,PF,32,MIN,20,151,3,19,0,0,3,19,3,12,9
2008,Corey Maggette,SF,28,LAC,70,2502,458,1000,78,203,380,797,553,681,1547
2008,Jamaal Magloire,C,29,TOT,31,286,18,55,0,0,18,55,20,44,56
2008,Jamaal Magloire,C,29,NJN,24,259,15,49,0,0,15,49,14,31,44
2008,Jamaal Magloire,C,29,DAL,7,27,3,6,0,0,3,6,6,13,12
2008,Ian Mahinmi,C,21,SAS,6,23,6,12,0,0,6,12,9,9,21
2008,Stephon Marbury,PG,30,NYK,24,805,111,265,28,74,83,191,83,116,333
2008,Shawn Marion,PF,29,TOT,63,2315,400,787,66,198,334,589,106,150,972
2008,Shawn Marion,PF,29,PHO,47,1713,304,578,58,167,246,411,77,108,743
2008,Shawn Marion,PF,29,MIA,16,602,96,209,8,31,88,178,29,42,229
2008,Sean Marks,C,32,PHO,19,130,23,43,1,4,22,39,12,19,59
2008,Donyell Marshall,PF,34,TOT,26,340,32,98,15,53,17,45,19,22,98
2008,Donyell Marshall,PF,34,CLE,11,156,13,44,8,23,5,21,7,9,41
2008,Donyell Marshall,PF,34,SEA,15,184,19,54,7,30,12,24,12,13,57
2008,Darrick Martin,PG,36,TOR,17,141,10,43,2,16,8,27,5,6,27
2008,Kenyon Martin,PF,30,DEN,71,2159,376,699,2,11,374,688,123,212,877
2008,Kevin Martin,SG,24,SAC,61,2216,417,914,107,266,310,648,502,578,1443
2008,Desmond Mason,SF,30,MIL,59,1702,230,477,0,0,230,477,114,173,574
2008,Roger Mason,PG,27,WAS,80,1708,266,600,130,327,136,273,62,71,724
2008,Jason Maxiell,C,24,DET,82,1768,240,446,0,1,240,445,171,270,651
2008,Rashad McCants,SG,23,MIN,75,2020,428,944,142,349,286,595,116,155,1114
2008,Jelani McCoy,C,30,DEN,6,33,1,1,0,0,1,1,1,2,3
2008,Antonio McDyess,PF,33,DET,78,2285,293,600,0,2,293,598,97,156,683
2008,Tracy McGrady,SG,28,HOU,66,2440,548,1307,86,295,462,1012,245,358,1427
2008,Dominic McGuire,SG,22,WAS,70,695,39,103,1,6,38,97,14,32,93
2008,Jeff McInnis,PG,33,CHA,54,1410,108,249,3,19,105,230,23,30,242
2008,Josh McRoberts,PF,20,POR,8,28,6,10,0,1,6,9,0,0,12
2008,Chris Mihm,C,28,LAL,23,278,32,95,0,0,32,95,18,27,82
2008,C.J. Miles,SG,20,UTA,60,689,113,236,30,77,83,159,41,52,297
2008,Darko Milicic,C,22,MEM,70,1663,219,500,0,1,219,499,67,121,505
2008,Andre Miller,PG,31,PHI,82,3016,569,1156,3,34,566,1122,257,333,1398
2008,Brad Miller,C,31,SAC,72,2513,337,728,28,90,309,638,262,309,964
2008,Mike Miller,SG,27,MEM,70,2474,414,824,155,359,259,465,164,212,1147
2008,Paul Millsap,PF,22,UTA,82,1702,253,502,0,4,253,498,155,229,661
2008,Yao Ming*,C,27,HOU,55,2044,432,852,0,2,432,850,345,406,1209
2008,Cuttino Mobley,SG,32,LAC,77,2702,377,870,67,192,310,678,163,199,984
2008,Nazr Mohammed,C,30,TOT,82,1650,272,528,0,1,272,527,95,163,639
2008,Nazr Mohammed,C,30,DET,21,228,28,59,0,1,28,58,13,30,69
2008,Nazr Mohammed,C,30,CHA,61,1422,244,469,0,0,244,469,82,133,570
2008,Jamario Moon,SF,27,TOR,78,2166,279,575,40,122,239,453,63,85,661
2008,Mikki Moore,PF,32,SAC,82,2385,282,489,0,2,282,487,134,182,698
2008,Randolph Morris,C,22,NYK,18,181,21,58,0,0,21,58,14,29,56
2008,Alonzo Mourning*,C,37,MIA,25,389,52,95,0,0,52,95,45,76,149
2008,Troy Murphy,PF,27,IND,75,2106,315,693,94,236,221,457,192,241,916
2008,Ronald Murray,PG,28,TOT,42,874,154,367,20,63,134,304,68,98,396
2008,Ronald Murray,PG,28,DET,19,347,57,139,6,27,51,112,22,37,142
2008,Ronald Murray,PG,28,IND,23,527,97,228,14,36,83,192,46,61,254
2008,Dikembe Mutombo*,C,41,HOU,39,619,43,80,0,0,43,80,32,45,118
2008,Bostjan Nachbar,PF,27,NJN,75,1660,245,609,94,262,151,347,154,196,738
2008,Eduardo Najera,PF,31,DEN,78,1664,174,368,53,147,121,221,63,89,464
2008,Steve Nash,PG,33,PHO,81,2780,485,962,179,381,306,581,222,245,1371
2008,Juan Carlos,SG,27,MEM,82,2117,308,766,156,432,152,334,124,146,896
2008,Jameer Nelson,PG,25,ORL,69,1961,283,603,64,154,219,449,125,151,755
2008,Rasho Nesterovic,C,31,TOR,71,1486,257,467,1,3,256,464,37,49,552
2008,Ira Newble,SG-SF,33,TOT,49,698,76,174,16,49,60,125,20,26,188
2008,Ira Newble,SG,33,CLE,41,650,71,158,15,45,56,113,20,26,177
2008,Ira Newble,SF,33,SEA,2,17,2,7,0,2,2,5,0,0,4
2008,Ira Newble,SF,33,LAL,6,31,3,9,1,2,2,7,0,0,7
2008,Demetris Nichols,SF,23,TOT,14,44,6,23,3,13,3,10,0,0,15
2008,Demetris Nichols,SF,23,CLE,3,14,1,8,0,3,1,5,0,0,2
2008,Demetris Nichols,SF,23,CHI,11,30,5,15,3,10,2,5,0,0,13
2008,Joakim Noah,C,22,CHI,74,1534,177,367,0,1,177,366,134,194,488
2008,Andres Nocioni,SF,28,CHI,82,2021,379,877,126,346,253,531,196,243,1080
2008,Steve Novak,SF,24,HOU,35,264,49,102,34,71,15,31,3,4,135
2008,Dirk Nowitzki,PF,29,DAL,77,2769,630,1314,79,220,551,1094,478,544,1817
2008,Patrick O'Bryant,C,21,GSW,24,99,16,29,0,0,16,29,3,5,35
2008,Jermaine O'Neal,C,29,IND,42,1206,225,512,0,5,225,507,121,163,571
2008,Shaquille O'Neal*,C,35,TOT,61,1748,331,558,0,0,331,558,170,338,832
2008,Shaquille O'Neal*,C,35,MIA,33,945,191,329,0,0,191,329,88,178,470
2008,Shaquille O'Neal*,C,35,PHO,28,803,140,229,0,0,140,229,82,160,362
2008,Fabricio Oberto,PF,32,SAS,82,1644,180,296,0,1,180,295,37,61,397
2008,Lamar Odom,PF,28,LAL,77,2921,417,795,31,113,386,682,229,328,1094
2008,Emeka Okafor,C,25,CHA,82,2718,460,860,0,0,460,860,213,374,1133
2008,Mehmet Okur,C,28,UTA,72,2390,374,841,114,294,260,547,185,230,1047
2008,Kevin Ollie,SG,35,PHI,40,300,29,69,0,1,29,68,12,15,70
2008,Bo Outlaw,PF,36,ORL,2,7,2,3,0,0,2,3,0,0,4
2008,Travis Outlaw,PF,23,POR,82,2186,417,964,40,101,377,863,218,294,1092
2008,Andre Owens,PG,27,IND,31,392,40,107,18,40,22,67,25,34,123
2008,Zaza Pachulia,C,23,ATL,62,944,107,245,0,3,107,242,108,153,322
2008,Jannero Pargo,SG,28,NOH,80,1497,254,652,65,186,189,466,71,81,644
2008,Anthony Parker,SG,32,TOR,82,2634,395,829,133,304,262,525,102,125,1025
2008,Smush Parker,PG,26,TOT,28,592,64,184,18,78,46,106,19,28,165
2008,Smush Parker,PG,26,MIA,9,183,17,54,6,24,11,30,3,4,43
2008,Smush Parker,PG,26,LAC,19,409,47,130,12,54,35,76,16,24,122
2008,Tony Parker,PG,25,SAS,69,2312,515,1043,17,66,498,977,248,347,1295
2008,Ruben Patterson,SF,32,LAC,20,327,39,86,0,2,39,84,24,43,102
2008,Chris Paul,PG,22,NOH,80,3006,630,1291,92,249,538,1042,332,390,1684
2008,Sasha Pavlovic,SG,24,CLE,51,1188,146,403,34,114,112,289,53,77,379
2008,Oleksiy Pecherov,C,22,WAS,35,320,44,125,17,60,27,65,20,31,125
2008,Kendrick Perkins,C,23,BOS,78,1912,214,348,0,1,214,347,114,183,542
2008,Kosta Perovic,C,22,GSW,7,38,3,10,0,0,3,10,4,6,10
2008,Morris Peterson,SG,30,NOH,76,1796,215,516,113,287,102,229,65,85,608
2008,Johan Petro,C,22,SEA,72,1310,184,439,0,1,184,438,64,87,432
2008,Eric Piatkowski,SF,37,PHO,16,113,12,33,11,26,1,7,4,4,39
2008,Paul Pierce,SF,30,BOS,80,2874,509,1098,143,365,366,733,409,485,1570
2008,Mickael Pietrus,SF,25,GSW,66,1316,170,387,66,183,104,204,66,98,472
2008,Scot Pollard,C,32,BOS,22,173,12,23,0,0,12,23,15,22,39
2008,James Posey,PF,31,BOS,74,1821,173,414,106,279,67,135,93,115,545
2008,Leon Powe,C,24,BOS,56,809,154,269,0,1,154,268,137,193,445
2008,Josh Powell,C,25,LAC,64,1228,145,315,0,3,145,312,63,87,353
2008,Kasib Powell,SF,26,MIA,11,304,35,95,8,33,27,62,6,9,84
2008,Ronnie Price,PG,24,UTA,61,588,88,204,26,75,62,129,26,38,228
2008,Tayshaun Prince,SF,27,DET,82,2694,421,940,53,146,368,794,185,241,1080
2008,Gabe Pruitt,PG,21,BOS,15,95,14,39,3,12,11,27,1,2,32
2008,Joel Przybilla,C,28,POR,77,1819,144,250,0,1,144,249,83,122,371
2008,Chris Quinn,PG,24,MIA,60,1340,158,373,64,159,94,214,85,98,465
2008,Vladimir Radmanovic,SF,27,LAL,65,1483,198,437,95,234,103,203,52,65,543
2008,Shavlik Randolph,PF,24,PHI,9,27,4,14,0,0,4,14,0,0,8
2008,Zach Randolph,C,26,NYK,69,2244,486,1058,22,80,464,978,223,289,1217
2008,Theo Ratliff,C-PF,34,TOT,26,437,41,85,0,1,41,84,29,43,111
2008,Theo Ratliff,PF,34,MIN,10,214,23,45,0,1,23,44,17,25,63
2008,Theo Ratliff,C,34,DET,16,223,18,40,0,0,18,40,12,18,48
2008,Michael Redd,SG,28,MIL,72,2702,550,1243,130,359,420,884,402,490,1632
2008,J.J. Redick,SG,23,ORL,34,276,48,108,17,43,31,65,27,34,140
2008,Chris Richard,C,23,MIN,52,556,41,87,0,0,41,87,16,27,98
2008,Jason Richardson,SF,27,CHA,82,3149,648,1468,243,599,405,869,249,331,1788
2008,Jeremy Richardson,SG-SF,23,TOT,27,132,16,44,7,19,9,25,2,2,41
2008,Jeremy Richardson,SF,23,MEM,3,15,0,6,0,2,0,4,0,0,0
2008,Jeremy Richardson,SG,23,SAS,5,29,3,7,2,5,1,2,2,2,10
2008,Jeremy Richardson,SF,23,ATL,19,88,13,31,5,12,8,19,0,0,31
2008,Quentin Richardson,SF,27,NYK,65,1841,199,555,69,214,130,341,60,88,527
2008,Luke Ridnour,PG,26,SEA,61,1223,147,368,21,71,126,297,78,91,393
2008,Nate Robinson,PG,23,NYK,72,1883,331,782,97,292,234,490,154,196,913
2008,Sergio Rodriguez,PG,21,POR,72,628,69,196,17,58,52,138,25,38,180
2008,Rajon Rondo,PG,21,BOS,77,2306,351,713,5,19,346,694,107,175,814
2008,Malik Rose,PF,33,NYK,49,494,66,180,2,7,64,173,37,51,171
2008,Quinton Ross,SG,26,LAC,76,1505,131,335,9,21,122,314,40,60,311
2008,Brandon Roy,SG,23,POR,74,2792,531,1170,73,215,458,955,281,373,1416
2008,Michael Ruffin,C,31,MIL,46,632,33,62,0,0,33,62,25,63,91
2008,Kareem Rush,SG,27,IND,71,1504,228,569,102,262,126,307,30,42,588
2008,John Salmons,SG,28,SAC,81,2517,381,799,39,120,342,679,214,260,1015
2008,Cheikh Samb,C,23,DET,4,31,3,4,0,0,3,4,1,2,7
2008,Brian Scalabrine,PF,29,BOS,48,512,29,94,15,46,14,48,15,20,88
2008,Luis Scola,PF,27,HOU,82,2024,345,670,0,3,345,667,157,235,847
2008,Thabo Sefolosha,SG,23,CHI,69,1436,180,421,29,88,151,333,75,104,464
2008,Mouhamed Sene,C,21,SEA,13,62,11,24,0,0,11,24,8,17,30
2008,Ramon Sessions,PG,21,MIL,17,450,51,117,3,7,48,110,32,41,137
2008,Bobby Simmons,SF,27,MIL,70,1521,209,496,60,171,149,325,53,70,531
2008,Cedric Simmons,PF,22,TOT,14,87,4,14,0,0,4,14,0,10,8
2008,Cedric Simmons,PF,22,CLE,7,68,2,6,0,0,2,6,0,8,4
2008,Cedric Simmons,PF,22,CHI,7,19,2,8,0,0,2,8,0,2,4
2008,Courtney Sims,C,24,IND,3,11,0,1,0,0,0,1,0,0,0
2008,Brian Skinner,C,31,PHO,66,844,92,198,2,3,90,195,33,63,219
2008,Craig Smith,PF,24,MIN,77,1547,297,528,0,9,297,519,133,200,727
2008,J.R. Smith,SG,22,DEN,74,1421,311,674,157,390,154,284,128,178,907
2008,Jason Smith,PF,21,PHI,76,1107,141,310,4,14,137,296,54,82,340
2008,Joe Smith,PF,32,TOT,77,1726,312,653,0,3,312,650,154,204,778
2008,Joe Smith,PF,32,CHI,50,1146,225,483,0,1,225,482,109,135,559
2008,Joe Smith,PF,32,CLE,27,580,87,170,0,2,87,168,45,69,219
2008,Josh Smith,PF,22,ATL,81,2873,518,1133,25,99,493,1034,333,469,1394
2008,Eric Snow,PG,34,CLE,22,305,6,38,0,2,6,36,10,22,22
2008,Kirk Snyder,SF-PF,24,TOT,36,761,96,189,5,23,91,166,64,88,261
2008,Kirk Snyder,PF,24,HOU,9,81,13,28,2,9,11,19,6,11,34
2008,Kirk Snyder,SF,24,MIN,27,680,83,161,3,14,80,147,58,77,227
2008,Darius Songaila,C,29,WAS,80,1554,214,467,0,2,214,465,67,73,495
2008,Jerry Stackhouse,SG,33,DAL,58,1412,213,526,60,184,153,342,132,148,618
2008,DeShawn Stevenson,SG,26,WAS,82,2564,301,780,158,413,143,367,157,197,917
2008,Peja Stojakovic,SF,30,NOH,77,2711,451,1026,231,524,220,502,130,140,1263
2008,Awvee Storey,SG,30,MIL,26,259,39,89,0,7,39,82,14,29,92
2008,Damon Stoudamire,PG,34,TOT,60,1037,120,337,50,149,70,188,27,34,317
2008,Damon Stoudamire,PG,34,MEM,29,624,77,194,36,94,41,100,21,26,211
2008,Damon Stoudamire,PG,34,SAS,31,413,43,143,14,55,29,88,6,8,106
2008,Salim Stoudamire,PG,25,ATL,35,402,65,180,29,85,36,95,41,50,200
2008,Amar'e Stoudemire,C,25,PHO,79,2677,714,1211,5,31,709,1180,556,691,1989
2008,D.J. Strawberry,SG,22,PHO,33,270,29,92,6,25,23,67,9,19,73
2008,Rodney Stuckey,PG,21,DET,57,1081,153,382,3,16,150,366,127,156,436
2008,Robert Swift,C,22,SEA,8,98,6,17,0,0,6,17,2,2,14
2008,Stromile Swift,PF,28,TOT,56,844,135,265,0,2,135,263,73,109,343
2008,Stromile Swift,PF,28,MEM,35,549,93,177,0,2,93,175,52,81,238
2008,Stromile Swift,PF,28,NJN,21,295,42,88,0,0,42,88,21,28,105
2008,Wally Szczerbiak,SF,30,TOT,75,1736,311,722,90,218,221,504,149,175,861
2008,Wally Szczerbiak,SF,30,SEA,50,1180,236,513,71,166,165,347,113,134,656
2008,Wally Szczerbiak,SF,30,CLE,25,556,75,209,19,52,56,157,36,41,205
2008,Sebastian Telfair,PG,22,MIN,60,1933,223,556,32,114,191,442,78,105,556
2008,Jason Terry,SG,30,DAL,82,2579,471,1008,136,363,335,645,191,223,1269
2008,Billy Thomas,SF,32,TOT,11,42,4,17,4,16,0,1,2,2,14
2008,Billy Thomas,SF,32,NJN,4,8,0,3,0,3,0,0,2,2,2
2008,Billy Thomas,SF,32,CLE,7,34,4,14,4,13,0,1,0,0,12
2008,Kenny Thomas,PF,30,SAC,23,281,16,38,0,0,16,38,0,5,32
2008,Kurt Thomas,C-PF,35,TOT,70,1584,195,396,0,1,195,395,53,80,443
2008,Kurt Thomas,C,35,SEA,42,1060,139,271,0,0,139,271,39,56,317
2008,Kurt Thomas,PF,35,SAS,28,524,56,125,0,1,56,124,14,24,126
2008,Tim Thomas,PF,30,LAC,63,1940,291,705,83,271,208,434,115,153,780
2008,Tyrus Thomas,PF,21,CHI,74,1330,186,440,1,6,185,434,129,174,502
2008,Al Thornton,PF,24,LAC,79,2158,374,871,43,130,331,741,214,288,1005
2008,Jamaal Tinsley,PG,29,IND,39,1293,176,463,40,141,136,322,72,100,464
2008,Alando Tucker,SF,23,PHO,6,48,8,22,1,4,7,18,5,6,22
2008,Ronny Turiaf,C,25,LAL,78,1458,188,397,0,1,188,396,140,186,516
2008,Hedo Turkoglu,SF,28,ORL,82,3026,556,1219,166,415,390,804,324,391,1602
2008,Ime Udoka,PF,30,SAS,73,1316,159,375,61,165,98,210,44,58,423
2008,Beno Udrih,PG,25,SAC,65,2080,328,708,53,137,275,571,125,147,834
2008,Anderson Varejao,C,25,CLE,48,1320,136,295,0,2,136,293,49,82,321
2008,Jacque Vaughn,PG,32,SAS,74,1139,121,283,3,10,118,273,61,80,306
2008,Charlie Villanueva,PF,23,MIL,76,1829,354,814,55,185,299,629,123,157,886
2008,Marcus Vinicius,SF,23,NOH,13,69,9,20,5,12,4,8,5,11,28
2008,Jake Voskuhl,C,30,MIL,44,386,37,80,0,0,37,80,24,29,98
2008,Sasha Vujacic,SG,23,LAL,72,1279,219,482,118,270,101,212,76,91,632
2008,Dwyane Wade,SG,26,MIA,51,1954,439,937,22,77,417,860,354,467,1254
2008,Von Wafer,SG,22,TOT,29,154,17,61,4,26,13,35,8,12,46
2008,Von Wafer,SG,22,DEN,21,90,10,38,1,15,9,23,6,8,27
2008,Von Wafer,SG,22,POR,8,64,7,23,3,11,4,12,2,4,19
2008,Antoine Walker,PF,31,MIN,46,892,136,375,61,188,75,187,35,66,368
2008,Ben Wallace,C-PF,33,TOT,72,2205,138,352,0,4,138,348,72,169,348
2008,Ben Wallace,C,33,CHI,50,1627,101,271,0,4,101,267,53,125,255
2008,Ben Wallace,PF,33,CLE,22,578,37,81,0,0,37,81,19,44,93
2008,Gerald Wallace,PF,25,CHA,62,2376,408,908,71,221,337,687,313,428,1200
2008,Rasheed Wallace,C,33,DET,77,2346,376,870,112,315,264,555,115,150,979
2008,Luke Walton,SF,27,LAL,74,1729,215,478,28,84,187,394,77,109,535
2008,Hakim Warrick,PF,25,MEM,75,1754,328,653,13,48,315,605,183,260,852
2008,Darius Washington,SG,22,SAS,18,146,21,48,4,12,17,36,7,13,53
2008,Darryl Watkins,C,23,SAC,9,71,5,15,0,0,5,15,2,5,12
2008,C.J. Watson,PG,23,GSW,32,368,43,101,9,26,34,75,23,29,118
2008,Earl Watson,PG,28,SEA,78,2269,339,747,49,132,290,615,111,145,838
2008,Chris Webber,PF,34,GSW,9,126,15,31,0,0,15,31,5,12,35
2008,Martell Webster,SF,21,POR,75,2132,277,656,123,317,154,339,122,166,799
2008,Bonzi Wells,SG,31,TOT,73,1562,252,569,12,50,240,519,146,227,662
2008,Bonzi Wells,SG,31,HOU,51,1124,175,412,8,38,167,374,111,174,469
2008,Bonzi Wells,SG,31,NOH,22,438,77,157,4,12,73,145,35,53,193
2008,David West,PF,27,NOH,76,2870,629,1305,6,25,623,1280,300,353,1564
2008,Delonte West,PG,24,TOT,61,1533,196,475,48,135,148,340,67,91,507
2008,Delonte West,PG,24,SEA,35,727,97,250,19,56,78,194,26,39,239
2008,Delonte West,PG,24,CLE,26,806,99,225,29,79,70,146,41,52,268
2008,Mario West,SG,23,ATL,64,269,21,49,0,4,21,45,17,26,59
2008,Chris Wilcox,PF,25,SEA,62,1739,334,638,0,3,334,635,160,248,828
2008,Damien Wilkins,SF,28,SEA,76,1843,271,673,50,155,221,518,106,144,698
2008,Mike Wilks,PG,28,TOT,15,188,17,36,3,8,14,28,4,4,41
2008,Mike Wilks,PG,28,DEN,8,122,10,23,2,5,8,18,2,2,24
2008,Mike Wilks,PG,28,WAS,4,44,2,4,1,2,1,2,0,0,5
2008,Mike Wilks,PG,28,SEA,3,22,5,9,0,1,5,8,2,2,12
2008,Aaron Williams,C,36,LAC,30,297,27,55,0,0,27,55,14,18,68
2008,Deron Williams,PG,23,UTA,82,3059,566,1117,83,210,483,907,330,411,1545
2008,Jason Williams,PG,32,MIA,67,1886,211,550,97,275,114,275,69,80,588
2008,Justin Williams,C,23,TOT,23,123,13,29,0,0,13,29,8,26,34
2008,Justin Williams,C,23,SAC,22,117,12,26,0,0,12,26,7,22,31
2008,Justin Williams,C,23,HOU,1,6,1,3,0,0,1,3,1,4,3
2008,Lou Williams,PG,21,PHI,80,1862,319,752,55,153,264,599,227,290,920
2008,Marcus Williams,PG,22,NJN,53,854,111,293,54,142,57,151,37,47,313
2008,Marcus Williams,PF-SF,21,TOT,11,36,5,20,0,0,5,20,0,0,10
2008,Marcus Williams,SF,21,SAS,1,2,0,1,0,0,0,1,0,0,0
2008,Marcus Williams,PF,21,LAC,10,34,5,19,0,0,5,19,0,0,10
2008,Marvin Williams,SF,21,ATL,80,2765,424,918,1,10,423,908,336,409,1185
2008,Mo Williams,PG,25,MIL,66,2410,441,919,89,231,352,688,166,194,1137
2008,Sean Williams,C,21,NJN,73,1278,164,305,0,0,164,305,81,133,409
2008,Shawne Williams,SF,21,IND,65,967,159,372,43,137,116,235,76,106,437
2008,Shelden Williams,PF,24,TOT,64,776,92,212,0,2,92,210,71,105,255
2008,Shelden Williams,PF,24,ATL,36,414,37,100,0,1,37,99,35,51,109
2008,Shelden Williams,PF,24,SAC,28,362,55,112,0,1,55,111,36,54,146
2008,Loren Woods,C,29,HOU,7,17,3,5,0,0,3,5,0,0,6
2008,Metta World,SF,28,SAC,57,2172,436,962,84,221,352,741,212,295,1168
2008,Antoine Wright,SG,23,TOT,56,1232,136,329,32,110,104,219,46,67,350
2008,Antoine Wright,SG,23,NJN,41,1056,115,287,27,101,88,186,41,58,298
2008,Antoine Wright,SG,23,DAL,15,176,21,42,5,9,16,33,5,9,52
2008,Brandan Wright,PF,20,GSW,38,376,62,112,0,0,62,112,27,40,151
2008,Dorell Wright,SF,22,MIA,44,1104,143,293,4,11,139,282,57,69,347
2008,Julian Wright,SF,20,NOH,57,640,90,169,10,24,80,145,33,52,223
2008,Lorenzen Wright,C,32,TOT,18,161,6,21,0,0,6,21,3,6,15
2008,Lorenzen Wright,C,32,ATL,13,148,5,17,0,0,5,17,3,6,13
2008,Lorenzen Wright,C,32,SAC,5,13,1,4,0,0,1,4,0,0,2
2008,Nick Young,SG,22,WAS,75,1158,210,478,40,100,170,378,101,124,561
2008,Thaddeus Young,PF,19,PHI,74,1554,264,490,6,19,258,471,76,103,610
,,,,,,,,,,,,,,,
2009,Alex Acker,SG,26,TOT,25,199,30,76,7,20,23,56,5,10,72
2009,Alex Acker,SG,26,DET,7,20,4,11,0,4,4,7,1,2,9
2009,Alex Acker,SG,26,LAC,18,179,26,65,7,16,19,49,4,8,63
2009,Hassan Adams,SG,24,TOR,12,52,4,13,0,0,4,13,3,6,11
2009,Arron Afflalo,SG,23,DET,74,1234,131,300,43,107,88,193,58,71,363
2009,Maurice Ager,SG,24,NJN,20,97,15,43,0,6,15,37,4,8,34
2009,Blake Ahearn,PG,24,SAS,3,19,2,6,2,4,0,2,2,2,8
2009,Alexis Ajinca,PF,20,CHA,31,182,25,69,0,2,25,67,20,28,70
2009,LaMarcus Aldridge,PF,23,POR,81,3004,601,1243,7,28,594,1215,261,334,1470
2009,Joe Alexander,SF,22,MIL,59,716,102,245,16,46,86,199,58,83,278
2009,Malik Allen,PF,30,MIL,49,579,73,170,0,1,73,169,10,21,156
2009,Ray Allen,SG,33,BOS,79,2876,499,1040,199,486,300,554,237,249,1434
2009,Tony Allen,SG,27,BOS,46,887,137,284,6,27,131,257,79,109,359
2009,Morris Almond,SG,23,UTA,25,255,33,81,5,17,28,64,21,26,92
2009,Rafer Alston,PG,32,TOT,77,2447,316,820,112,331,204,489,156,208,900
2009,Rafer Alston,PG,32,HOU,48,1591,193,522,80,230,113,292,86,109,552
2009,Rafer Alston,PG,32,ORL,29,856,123,298,32,101,91,197,70,99,348
2009,Lou Amundson,PF,26,PHO,76,1044,134,250,0,1,134,249,53,120,321
2009,Chris Andersen,C,30,DEN,71,1460,160,292,2,10,158,282,130,181,452
2009,Ryan Anderson,PF,20,NJN,66,1312,160,407,69,189,91,218,98,116,487
2009,Carmelo Anthony,SF,24,DEN,66,2277,535,1207,63,170,472,1037,371,468,1504
2009,Joel Anthony,C,26,MIA,65,1048,57,118,0,0,57,118,30,46,144
2009,Gilbert Arenas,PG,27,WAS,2,63,6,23,2,7,4,16,12,16,26
2009,Trevor Ariza,SF,23,LAL,82,1999,274,596,61,191,213,405,120,169,729
2009,Hilton Armstrong,C,24,NOH,70,1092,138,246,0,2,138,244,62,98,338
2009,Darrell Arthur,PF,20,MEM,76,1464,191,436,0,2,191,434,40,60,422
2009,Chucky Atkins,PG,34,TOT,33,412,34,113,15,57,19,56,15,16,98
2009,Chucky Atkins,PG,34,DEN,14,115,9,27,5,17,4,10,4,4,27
2009,Chucky Atkins,PG,34,OKC,19,297,25,86,10,40,15,46,11,12,71
2009,D.J. Augustin,PG,21,CHA,72,1908,267,621,108,246,159,375,208,233,850
2009,Kelenna Azubuike,SF,25,GSW,74,2375,392,845,94,210,298,635,185,229,1063
2009,Renaldo Balkman,PF,24,DEN,53,780,110,197,2,7,108,190,42,65,264
2009,Marcus Banks,PG,27,TOT,22,206,21,57,3,19,18,38,11,18,56
2009,Marcus Banks,PG,27,MIA,16,166,15,39,2,14,13,25,10,15,42
2009,Marcus Banks,PG,27,TOR,6,40,6,18,1,5,5,13,1,3,14
2009,Leandro Barbosa,SG,26,PHO,70,1705,366,759,90,240,276,519,171,194,993
2009,J.J. Barea,SG,24,DAL,79,1600,246,557,55,154,191,403,70,93,617
2009,Andrea Bargnani,PF,23,TOR,78,2453,431,958,119,291,312,667,221,266,1202
2009,Matt Barnes,PF,28,PHO,77,2082,285,674,117,341,168,333,101,136,788
2009,Brent Barry,SG,37,HOU,56,857,70,172,49,131,21,41,19,20,208
2009,Brandon Bass,C,23,DAL,81,1574,252,508,0,6,252,502,182,210,686
2009,Maceo Baston,PF,33,IND,27,217,25,46,0,1,25,45,17,27,67
2009,Tony Battie,PF,32,ORL,77,1202,158,323,2,9,156,314,54,82,372
2009,Shane Battier,SG,30,HOU,60,2031,145,354,91,237,54,117,55,67,436
2009,Nicolas Batum,SF,20,POR,79,1454,161,361,62,168,99,193,42,52,426
2009,Jerryd Bayless,PG,20,POR,53,655,69,189,7,27,62,162,83,103,228
2009,Michael Beasley,PF,20,MIA,81,2009,452,957,33,81,419,876,186,241,1123
2009,Marco Belinelli,SG,22,GSW,42,882,140,317,52,131,88,186,40,52,372
2009,Charlie Bell,SG,29,MIL,70,1783,217,524,87,240,130,284,66,80,587
2009,Raja Bell,SG,32,TOT,67,2315,299,684,114,271,185,413,87,102,799
2009,Raja Bell,SG,32,PHO,22,712,76,177,44,94,32,83,16,21,212
2009,Raja Bell,SG,32,CHA,45,1603,223,507,70,177,153,330,71,81,587
2009,Mike Bibby,PG,30,ATL,79,2740,437,1005,167,428,270,577,135,171,1176
2009,Andris Biedrins,C,22,GSW,62,1863,308,533,0,1,308,532,119,216,735
2009,Chauncey Billups,PG,32,TOT,79,2789,410,980,162,397,248,583,418,458,1400
2009,Chauncey Billups,PG,32,DET,2,70,7,21,2,7,5,14,9,10,25
2009,Chauncey Billups,PG,32,DEN,77,2719,403,959,160,390,243,569,409,448,1375
2009,Steve Blake,PG,28,POR,69,2188,277,647,140,328,137,319,63,75,757
2009,Andray Blatche,C,22,WAS,71,1703,297,630,5,21,292,609,114,162,713
2009,Mark Blount,C,33,MIA,20,207,30,78,11,27,19,51,8,13,79
2009,Keith Bogans,SG,28,TOT,65,1272,119,324,74,218,45,106,52,57,364
2009,Keith Bogans,SG,28,ORL,36,787,63,175,42,126,21,49,21,24,189
2009,Keith Bogans,SG,28,MIL,29,485,56,149,32,92,24,57,31,33,175
2009,Andrew Bogut,C,24,MIL,36,1124,183,317,0,0,183,317,56,98,422
2009,Matt Bonner,PF,28,SAS,81,1928,266,536,118,268,148,268,17,23,667
2009,Josh Boone,C,24,NJN,62,995,113,214,0,0,113,214,32,85,258
2009,Calvin Booth,C,32,TOT,8,56,5,10,0,0,5,10,6,8,16
2009,Calvin Booth,C,32,MIN,1,1,0,0,0,0,0,0,0,0,0
2009,Calvin Booth,C,32,SAC,7,55,5,10,0,0,5,10,6,8,16
2009,Carlos Boozer,PF,27,UTA,37,1197,251,512,0,0,251,512,97,139,599
2009,Chris Bosh,C,24,TOR,77,2928,615,1263,12,49,603,1214,504,617,1746
2009,Bruce Bowen,SF,37,SAS,80,1506,79,187,42,98,37,89,14,26,214
2009,Ryan Bowen,SF,33,NOH,21,219,22,38,0,0,22,38,3,5,47
2009,Elton Brand,PF,29,PHI,29,920,163,365,0,0,163,365,73,108,399
2009,Corey Brewer,SF,22,MIN,15,307,37,90,5,12,32,78,14,19,93
2009,Ronnie Brewer,SF,23,UTA,81,2605,421,828,22,85,399,743,247,352,1111
2009,Aaron Brooks,PG,24,HOU,80,1998,316,783,113,309,203,474,149,172,894
2009,Andre Brown,PF,27,CHA,4,41,1,7,0,0,1,7,2,2,4
2009,Bobby Brown,SG-PG,24,TOT,68,931,141,360,45,130,96,230,34,43,361
2009,Bobby Brown,SG,24,SAC,47,675,94,247,31,94,63,153,26,34,245
2009,Bobby Brown,PG,24,MIN,21,256,47,113,14,36,33,77,8,9,116
2009,Dee Brown,PG,24,TOT,19,261,18,49,7,24,11,25,3,5,46
2009,Dee Brown,PG,24,WAS,17,233,17,44,6,20,11,24,1,3,41
2009,Dee Brown,PG,24,PHO,2,28,1,5,1,4,0,1,2,2,5
2009,Devin Brown,SG,30,NOH,63,869,111,313,28,97,83,216,78,100,328
2009,Kwame Brown,C,26,DET,58,999,90,169,0,0,90,169,63,122,243
2009,Shannon Brown,SG,23,TOT,48,477,78,165,14,37,64,128,32,39,202
2009,Shannon Brown,SG,23,CHA,30,341,56,123,8,28,48,95,24,30,144
2009,Shannon Brown,SG,23,LAL,18,136,22,42,6,9,16,33,8,9,58
2009,Kobe Bryant,SG,30,LAL,82,2960,800,1712,118,336,682,1376,483,564,2201
2009,Greg Buckner,SF,32,MEM,63,878,61,159,13,51,48,108,20,25,155
2009,Caron Butler,SG,28,WAS,67,2585,491,1085,65,210,426,875,345,402,1392
2009,Rasual Butler,SF,29,NOH,82,2614,348,803,140,359,208,444,86,110,922
2009,Andrew Bynum,C,21,LAL,50,1446,281,502,0,0,281,502,152,215,714
2009,Will Bynum,PG,26,DET,57,803,156,342,3,19,153,323,95,119,410
2009,Jose Calderon,PG,27,TOR,68,2333,320,644,82,202,238,442,151,154,873
2009,Marcus Camby,C,34,LAC,62,1925,254,496,1,4,253,492,132,182,641
2009,Brian Cardinal,PF,31,MIN,64,909,65,169,30,92,35,77,30,35,190
2009,Rodney Carney,SG,24,MIN,67,1199,176,423,79,226,97,197,50,66,481
2009,Matt Carroll,SG,28,TOT,55,616,65,171,13,53,52,118,21,25,164
2009,Matt Carroll,SG,28,CHA,34,475,56,138,12,45,44,93,15,19,139
2009,Matt Carroll,SG,28,DAL,21,141,9,33,1,8,8,25,6,6,25
2009,Anthony Carter,PG,33,DEN,78,1787,167,386,21,88,146,298,57,78,412
2009,Vince Carter,SG,32,NJN,80,2946,588,1345,151,392,437,953,335,410,1662
2009,Mario Chalmers,PG,22,MIA,82,2626,278,662,114,311,164,351,148,193,818
2009,Tyson Chandler,C,26,NOH,45,1445,160,283,0,0,160,283,77,133,397
2009,Wilson Chandler,SF,21,NYK,82,2735,455,1054,103,314,352,740,171,215,1184
2009,Speedy Claxton,PG,30,ATL,2,15,2,7,0,0,2,7,1,2,5
2009,Jarron Collins,C,30,UTA,26,201,16,35,0,0,16,35,8,11,40
2009,Jason Collins,C,30,MIN,31,422,22,70,0,0,22,70,13,28,57
2009,Mardy Collins,PG-SG,24,TOT,48,890,105,247,13,31,92,216,28,46,251
2009,Mardy Collins,SG,24,NYK,9,75,8,23,0,3,8,20,4,9,20
2009,Mardy Collins,PG,24,LAC,39,815,97,224,13,28,84,196,24,37,231
2009,Nick Collison,C,28,OKC,71,1831,243,428,0,2,243,426,98,136,584
2009,Mike Conley,PG,21,MEM,82,2508,323,730,88,217,235,513,161,197,895
2009,Brian Cook,PF,28,TOT,30,171,28,76,13,30,15,46,5,6,74
2009,Brian Cook,PF,28,ORL,21,146,23,60,11,25,12,35,5,6,62
2009,Brian Cook,PF,28,HOU,9,25,5,16,2,5,3,11,0,0,12
2009,Daequan Cook,SF,21,MIA,75,1833,242,645,153,395,89,250,49,56,686
2009,Jamal Crawford,PG-SG,28,TOT,65,2479,419,1022,142,394,277,628,300,344,1280
2009,Jamal Crawford,SG,28,NYK,11,392,73,169,35,77,38,92,35,46,216
2009,Jamal Crawford,PG,28,GSW,54,2087,346,853,107,317,239,536,265,298,1064
2009,Joe Crawford,SF,22,NYK,2,23,3,10,1,4,2,6,2,2,9
2009,Javaris Crittenton,PG-SG,21,TOT,63,1174,131,285,2,15,129,270,53,92,317
2009,Javaris Crittenton,SG,21,MEM,7,44,7,15,0,1,7,14,5,11,19
2009,Javaris Crittenton,PG,21,WAS,56,1130,124,270,2,14,122,256,48,81,298
2009,Austin Croshere,PF,33,TOT,14,100,14,39,5,15,9,24,7,12,40
2009,Austin Croshere,PF,33,MIL,11,77,12,30,5,11,7,19,7,11,36
2009,Austin Croshere,PF,33,SAS,3,23,2,9,0,4,2,5,0,1,4
2009,Eddy Curry,C,26,NYK,3,12,2,2,0,0,2,2,1,3,5
2009,Samuel Dalembert,C,27,PHI,82,2036,216,434,0,2,216,432,91,124,523
2009,Erick Dampier,C,33,DAL,80,1836,182,280,0,0,182,280,90,141,454
2009,Antonio Daniels,PG,33,TOT,74,1021,99,236,22,60,77,176,80,100,300
2009,Antonio Daniels,PG,33,WAS,13,288,18,45,5,11,13,34,25,33,66
2009,Antonio Daniels,PG,33,NOH,61,733,81,191,17,49,64,142,55,67,234
2009,Marquis Daniels,SF,28,IND,54,1700,311,689,18,90,293,599,93,129,733
2009,Jermareo Davidson,SF,24,GSW,14,111,17,35,0,0,17,35,8,17,42
2009,Baron Davis,PG,29,LAC,65,2248,355,959,99,328,256,631,159,210,968
2009,Glen Davis,C,23,BOS,76,1637,199,450,2,5,197,445,130,178,530
2009,Paul Davis,PF,24,LAC,27,320,40,98,0,1,40,97,27,34,107
2009,Ricky Davis,SG,29,LAC,36,785,83,245,35,111,48,134,31,36,232
2009,Luol Deng,SF,23,CHI,49,1665,265,591,8,20,257,571,152,191,690
2009,Boris Diaw,PF,26,TOT,81,2754,448,884,75,181,373,703,101,147,1072
2009,Boris Diaw,PF,26,PHO,22,538,80,141,5,14,75,127,18,26,183
2009,Boris Diaw,PF,26,CHA,59,2216,368,743,70,167,298,576,83,121,889
2009,Yakhouba Diawara,SF,26,MIA,63,851,76,217,51,163,25,54,10,19,213
2009,Travis Diener,PG,26,IND,55,719,74,179,46,118,28,61,12,15,206
2009,Ike Diogu,PF,25,TOT,29,215,39,74,1,2,38,72,40,53,119
2009,Ike Diogu,PF,25,POR,19,73,6,19,0,0,6,19,15,20,27
2009,Ike Diogu,PF,25,SAC,10,142,33,55,1,2,32,53,25,33,92
2009,DeSagana Diop,C,27,TOT,75,1036,74,171,0,0,74,171,22,66,170
2009,DeSagana Diop,C,27,DAL,34,452,22,58,0,0,22,58,12,29,56
2009,DeSagana Diop,C,27,CHA,41,584,52,113,0,0,52,113,10,37,114
2009,Juan Dixon,PG,30,WAS,50,816,101,256,25,75,76,181,34,39,261
2009,Keyon Dooling,PG,28,NJN,77,2074,261,598,99,235,162,363,127,154,748
2009,Joey Dorsey,PF,25,HOU,3,6,1,2,0,0,1,2,0,0,2
2009,Quincy Douby,PG,24,TOT,27,300,42,110,14,46,28,64,17,19,115
2009,Quincy Douby,PG,24,SAC,20,227,30,88,10,37,20,51,14,15,84
2009,Quincy Douby,PG,24,TOR,7,73,12,22,4,9,8,13,3,4,31
2009,Chris Douglas-Roberts,SG,22,NJN,44,585,81,176,3,12,78,164,51,62,216
2009,Goran Dragic,PG,22,PHO,55,728,88,224,20,54,68,170,50,65,246
2009,Jared Dudley,SF,23,TOT,68,1155,136,285,29,74,107,211,71,105,372
2009,Jared Dudley,SF,23,CHA,20,427,45,96,3,8,42,88,15,24,108
2009,Jared Dudley,SF,23,PHO,48,728,91,189,26,66,65,123,56,81,264
2009,Chris Duhon,PG,26,NYK,79,2906,287,681,127,325,160,356,179,209,880
2009,Tim Duncan,C,32,SAS,75,2524,558,1107,0,2,558,1105,334,483,1450
2009,Mike Dunleavy,SG,28,IND,18,495,93,232,32,90,61,142,53,65,271
2009,Kevin Durant,SF,20,OKC,74,2885,661,1390,97,230,564,1160,452,524,1871
2009,Monta Ellis,SG,23,GSW,25,892,194,430,8,26,186,404,78,94,474
2009,Francisco Elson,C,32,MIL,59,977,83,169,1,4,82,165,33,39,200
2009,Melvin Ely,C,30,NOH,31,373,37,95,0,0,37,95,23,36,97
2009,Maurice Evans,SF,30,ATL,80,1840,208,482,98,248,110,234,60,73,574
2009,Reggie Evans,PF,28,PHI,79,1137,79,178,0,1,79,177,104,175,262
2009,Jordan Farmar,PG,22,LAL,65,1192,161,412,49,146,112,266,45,77,416
2009,Desmon Farmer,SG,27,SAS,3,54,4,14,3,12,1,2,2,2,13
2009,Raymond Felton,PG,24,CHA,82,3086,442,1083,59,207,383,876,219,272,1162
2009,Rudy Fernandez,SG,23,POR,78,1993,268,630,159,398,109,232,120,143,815
2009,Kyrylo Fesenko,C,22,UTA,21,156,21,36,0,0,21,36,7,21,49
2009,Michael Finley,SF,35,SAS,81,2336,301,689,131,319,170,370,51,62,784
2009,Derek Fisher,PG,34,LAL,82,2441,292,688,120,302,172,386,110,130,814
2009,T.J. Ford,PG,25,IND,74,2258,413,913,35,104,378,809,245,281,1106
2009,Jeff Foster,C,32,IND,74,1828,177,353,2,7,175,346,96,146,452
2009,Randy Foye,SG,25,MIN,70,2494,399,981,111,308,288,673,230,272,1139
2009,Adonal Foyle,C,33,TOT,10,62,7,11,0,0,7,11,3,6,17
2009,Adonal Foyle,C,33,ORL,9,59,7,11,0,0,7,11,3,6,17
2009,Adonal Foyle,C,33,MEM,1,3,0,0,0,0,0,0,0,0,0
2009,Channing Frye,PF,25,POR,63,746,113,267,11,33,102,234,26,36,263
2009,Dan Gadzuric,C,30,MIL,67,941,117,244,0,2,117,242,37,68,271
2009,Danilo Gallinari,SG,20,NYK,28,412,56,125,32,72,24,53,26,27,170
2009,Francisco Garcia,SF,27,SAC,65,1975,295,665,88,221,207,444,146,178,824
2009,Thomas Gardner,SG,23,ATL,16,98,9,36,4,23,5,13,2,4,24
2009,Kevin Garnett,PF,32,BOS,57,1772,393,740,2,8,391,732,111,132,899
2009,Marc Gasol,C,24,MEM,82,2521,350,661,0,1,350,660,275,375,975
2009,Pau Gasol,C,28,LAL,81,2999,592,1045,1,2,591,1043,343,439,1528
2009,Rudy Gay,SF,22,MEM,79,2945,572,1262,85,242,487,1020,264,344,1493
2009,Devean George,SF,31,DAL,43,708,54,142,22,76,32,66,17,22,147
2009,Daniel Gibson,PG,22,CLE,75,1795,206,527,108,283,98,244,66,86,586
2009,J.R. Giddens,SF,23,BOS,6,8,2,3,0,0,2,3,0,0,4
2009,Eddie Gill,PG,30,MIL,6,43,6,9,2,3,4,6,0,0,14
2009,Manu Ginobili,SG,31,SAS,44,1181,223,491,69,209,154,282,168,190,683
2009,Ryan Gomes,SF,26,MIN,82,2614,420,974,106,285,314,689,146,181,1092
2009,Drew Gooden,PF,27,TOT,51,1264,237,506,0,4,237,502,131,156,605
2009,Drew Gooden,PF,27,CHI,31,918,161,352,0,3,161,349,84,97,406
2009,Drew Gooden,PF,27,SAC,1,26,5,9,0,0,5,9,2,2,12
2009,Drew Gooden,PF,27,SAS,19,320,71,145,0,1,71,144,45,57,187
2009,Ben Gordon,SG,25,CHI,82,2999,598,1315,173,422,425,893,330,382,1699
2009,Eric Gordon,SG,20,LAC,78,2677,411,901,131,337,280,564,299,350,1252
2009,Marcin Gortat,PF,24,ORL,63,794,106,187,1,1,105,186,26,45,239
2009,Joey Graham,SF,26,TOR,78,1541,231,480,3,16,228,464,132,160,597
2009,Stephen Graham,SG,26,IND,52,684,106,256,20,66,86,190,50,62,282
2009,Danny Granger,SF,25,IND,67,2424,571,1277,182,450,389,827,404,460,1728
2009,Aaron Gray,C,24,CHI,56,715,81,167,0,1,81,166,34,59,196
2009,Gerald Green,SG,23,DAL,38,376,79,180,14,46,65,134,27,32,199
2009,Jeff Green,PF,22,OKC,78,2873,476,1068,96,247,380,821,242,307,1290
2009,Willie Green,SG,27,PHI,81,1828,286,658,51,161,235,497,62,85,685
2009,Donte Greene,SF,20,SAC,55,725,77,236,26,100,51,136,29,34,209
2009,Hamed Haddadi,C,23,MEM,19,120,15,31,0,0,15,31,18,30,48
2009,Malik Hairston,SG,21,SAS,15,155,24,49,0,1,24,48,2,7,50
2009,Richard Hamilton,SG,30,DET,67,2279,466,1043,70,190,396,853,223,263,1225
2009,Matt Harpring,SG,32,UTA,63,693,111,241,0,2,111,239,55,72,277
2009,Al Harrington,PF,28,TOT,73,2546,532,1212,171,470,361,742,234,295,1469
2009,Al Harrington,PF,28,GSW,5,166,23,70,11,28,12,42,5,10,62
2009,Al Harrington,PF,28,NYK,68,2380,509,1142,160,442,349,700,229,285,1407
2009,Devin Harris,PG,25,NJN,69,2494,455,1039,64,220,391,819,496,605,1470
2009,Jason Hart,PG,30,TOT,39,348,30,94,0,6,30,88,18,23,78
2009,Jason Hart,PG,30,LAC,28,312,25,84,0,4,25,80,15,19,65
2009,Jason Hart,PG,30,DEN,11,36,5,10,0,2,5,8,3,4,13
2009,Udonis Haslem,PF,28,MIA,75,2560,333,643,0,0,333,643,128,170,794
2009,Trenton Hassell,SF,29,NJN,53,1094,86,191,2,8,84,183,20,25,194
2009,Spencer Hawes,C,20,SAC,77,2259,373,800,40,115,333,685,90,136,876
2009,Chuck Hayes,C,25,HOU,71,858,42,113,0,4,42,109,7,19,91
2009,Jarvis Hayes,SF,27,NJN,74,1832,257,577,94,244,163,333,36,52,644
2009,Brendan Haywood,C,29,WAS,6,175,24,50,0,0,24,50,10,21,58
2009,Luther Head,PG-SG,26,TOT,32,498,55,144,20,54,35,90,19,24,149
2009,Luther Head,PG,26,HOU,22,322,39,101,14,38,25,63,14,16,106
2009,Luther Head,SG,26,MIA,10,176,16,43,6,16,10,27,5,8,43
2009,Walter Herrmann,SF,29,DET,59,630,82,207,41,120,41,87,19,25,224
2009,Roy Hibbert,C,22,IND,70,1009,198,420,0,0,198,420,98,147,494
2009,J.J. Hickson,C,20,CLE,62,705,100,194,0,0,100,194,45,67,245
2009,Nene Hilario,C,26,DEN,77,2510,428,709,1,5,427,704,266,368,1123
2009,George Hill,PG,22,SAS,77,1270,150,372,24,73,126,299,114,146,438
2009,Grant Hill,SF,36,PHO,82,2445,390,745,24,76,366,669,181,224,985
2009,Steven Hill,PF,23,OKC,1,2,1,1,0,0,1,1,0,0,2
2009,Kirk Hinrich,SG,28,CHI,51,1339,183,419,69,169,114,250,68,86,503
2009,Ryan Hollins,C,24,TOT,45,444,50,94,0,0,50,94,43,72,143
2009,Ryan Hollins,C,24,CHA,18,184,19,35,0,0,19,35,26,39,64
2009,Ryan Hollins,C,24,DAL,27,260,31,59,0,0,31,59,17,33,79
2009,Al Horford,C,22,ATL,67,2242,312,594,0,1,312,593,149,205,773
2009,Eddie House,PG,30,BOS,81,1479,249,560,151,340,98,220,42,53,691
2009,Dwight Howard,C,23,ORL,79,2821,560,979,0,2,560,977,504,849,1624
2009,Josh Howard,SF,28,DAL,52,1663,353,783,58,168,295,615,172,220,936
2009,Juwan Howard,SF-PF,35,TOT,42,472,75,147,0,0,75,147,23,34,173
2009,Juwan Howard,PF,35,DEN,3,22,1,2,0,0,1,2,0,0,2
2009,Juwan Howard,SF,35,CHA,39,450,74,145,0,0,74,145,23,34,171
2009,Larry Hughes,SF-SG,30,TOT,55,1479,224,557,75,193,149,364,117,145,640
2009,Larry Hughes,SF,30,CHI,30,792,127,308,40,102,87,206,67,82,361
2009,Larry Hughes,SG,30,NYK,25,687,97,249,35,91,62,158,50,63,279
2009,Kris Humphries,SF,23,TOR,29,265,38,90,0,0,38,90,38,48,114
2009,Lindsey Hunter,PG,38,CHI,28,266,27,82,16,48,11,34,3,5,73
2009,Othello Hunter,PF,22,ATL,16,92,11,20,0,0,11,20,0,5,22
2009,Andre Iguodala,SF,25,PHI,82,3269,542,1147,80,261,462,886,377,521,1541
2009,Zydrunas Ilgauskas,C,33,CLE,65,1765,342,724,15,39,327,685,139,174,838
2009,Didier Ilunga-Mbenga,C,28,LAL,23,181,27,57,0,1,27,56,7,8,61
2009,Allen Iverson*,PG-SG,33,TOT,57,2093,348,834,28,99,320,735,271,347,995
2009,Allen Iverson*,SG,33,DEN,3,123,18,40,2,8,16,32,18,25,56
2009,Allen Iverson*,PG,33,DET,54,1970,330,794,26,91,304,703,253,322,939
2009,Royal Ivey,SG,27,PHI,71,861,69,208,39,114,30,94,34,43,211
2009,Jarrett Jack,SG,25,IND,82,2716,386,853,78,221,308,632,224,263,1074
2009,Bobby Jackson,PG,35,SAC,71,1484,193,485,60,197,133,288,86,101,532
2009,Darnell Jackson,PF,23,CLE,51,430,37,86,0,2,37,84,24,35,98
2009,Stephen Jackson,SF,30,GSW,59,2339,413,997,103,305,310,692,294,356,1223
2009,Jerome James,C,33,NYK,2,10,3,8,0,0,3,8,0,0,6
2009,LeBron James,SF,24,CLE,81,3054,789,1613,132,384,657,1229,594,762,2304
2009,Mike James,PG,33,TOT,61,1649,197,514,69,184,128,330,68,82,531
2009,Mike James,PG,33,NOH,8,74,8,25,3,4,5,21,1,2,20
2009,Mike James,PG,33,WAS,53,1575,189,489,66,180,123,309,67,80,511
2009,Antawn Jamison,PF,32,WAS,81,3096,674,1441,112,319,562,1122,341,452,1801
2009,Marko Jaric,SG,30,MEM,53,605,48,145,11,28,37,117,29,41,136
2009,Nathan Jawai,PF,22,TOR,6,19,1,4,0,0,1,4,0,0,2
2009,Al Jefferson,C,24,MIN,50,1836,485,975,0,4,485,971,186,252,1156
2009,Dontell Jefferson,SG,25,CHA,6,84,11,22,1,2,10,20,6,9,29
2009,Richard Jefferson,SF,28,MIL,82,2939,537,1222,116,292,421,930,417,518,1607
2009,Jared Jeffries,SF,27,NYK,56,1310,120,273,1,12,119,261,55,90,296
2009,Yi Jianlian,PF,21,NJN,61,1421,191,500,48,140,143,360,95,123,525
2009,Amir Johnson,PF,21,DET,62,911,97,163,0,0,97,163,23,35,217
2009,Anthony Johnson,PG,34,ORL,80,1481,154,381,52,133,102,248,61,81,421
2009,Joe Johnson,SG,27,ATL,79,3124,620,1420,149,414,471,1006,299,362,1688
2009,Linton Johnson,PF,28,TOT,10,55,4,11,1,2,3,9,0,0,9
2009,Linton Johnson,PF,28,CHA,2,13,0,0,0,0,0,0,0,0,0
2009,Linton Johnson,PF,28,CHI,8,42,4,11,1,2,3,9,0,0,9
2009,Trey Johnson,SG,24,CLE,4,14,0,5,0,0,0,5,4,4,4
2009,Dahntay Jones,SG,28,DEN,79,1426,154,336,11,17,143,319,110,151,429
2009,Damon Jones,PG,32,MIL,18,108,11,34,11,28,0,6,0,0,33
2009,Dwayne Jones,PF,25,CHA,6,52,4,7,0,0,4,7,4,6,12
2009,Fred Jones,SF,29,LAC,52,1495,129,317,54,147,75,170,66,81,378
2009,James Jones,SF,28,MIA,40,630,55,149,33,96,22,53,26,31,169
2009,Solomon Jones,C,24,ATL,63,675,67,111,1,2,66,109,53,74,188
2009,DeAndre Jordan,C,20,LAC,53,771,93,147,0,0,93,147,42,109,228
2009,Chris Kaman,C,26,LAC,31,921,161,305,0,0,161,305,51,75,373
2009,Jason Kapono,SG,27,TOR,80,1831,261,604,98,229,163,375,34,42,654
2009,Jason Kidd,PG,35,DAL,81,2886,257,618,131,323,126,295,86,105,731
2009,Tarence Kinsey,SG,24,CLE,50,277,31,69,7,18,24,51,33,38,102
2009,Andrei Kirilenko,PF,27,UTA,67,1831,256,570,20,73,236,497,244,311,776
2009,Linas Kleiza,SF,24,DEN,82,1824,289,646,87,267,202,379,148,204,813
2009,Brevin Knight,PG,33,UTA,74,938,66,189,0,6,66,183,48,64,180
2009,Kyle Korver,SF,27,UTA,78,1874,245,560,103,267,142,293,112,127,705
2009,Kosta Koufos,C,19,UTA,48,565,94,185,0,0,94,185,36,51,224
2009,Nenad Krstic,C,25,OKC,46,1141,191,407,0,0,191,407,63,79,445
2009,Rob Kurz,SF,23,GSW,40,442,51,131,15,38,36,93,40,50,157
2009,Carl Landry,PF,25,HOU,69,1467,240,418,1,3,239,415,157,193,638
2009,Acie Law,PG,24,ATL,55,560,52,139,9,29,43,110,49,60,162
2009,Courtney Lee,SG,23,ORL,77,1939,243,540,82,203,161,337,78,94,646
2009,David Lee,C,25,NYK,81,2824,522,951,0,3,522,948,249,330,1293
2009,Rashard Lewis,PF,29,ORL,79,2859,478,1089,220,554,258,535,225,269,1401
2009,Shaun Livingston,PG,23,TOT,12,231,31,60,0,0,31,60,9,10,71
2009,Shaun Livingston,PG,23,MIA,4,41,3,8,0,0,3,8,3,4,9
2009,Shaun Livingston,PG,23,OKC,8,190,28,52,0,0,28,52,6,6,62
2009,Brook Lopez,C,20,NJN,82,2501,448,844,0,2,448,842,172,217,1068
2009,Robin Lopez,C,20,PHO,60,614,71,137,0,1,71,136,47,68,189
2009,Kevin Love,C,20,MIN,81,2048,316,688,2,19,314,669,265,336,899
2009,Kyle Lowry,PG,22,TOT,77,1679,189,434,25,98,164,336,181,226,584
2009,Kyle Lowry,PG,22,MEM,49,1071,112,272,17,69,95,203,129,161,370
2009,Kyle Lowry,PG,22,HOU,28,608,77,162,8,29,69,133,52,65,214
2009,Tyronn Lue,PG,31,TOT,44,521,71,162,27,62,44,100,14,19,183
2009,Tyronn Lue,PG,31,MIL,30,392,54,119,21,45,33,74,12,16,141
2009,Tyronn Lue,PG,31,ORL,14,129,17,43,6,17,11,26,2,3,42
2009,Mark Madsen,C,33,MIN,19,116,3,14,0,0,3,14,0,4,6
2009,Corey Maggette,PF,29,GSW,51,1588,292,634,24,95,268,539,342,415,950
2009,Jamaal Magloire,C,30,MIA,55,709,65,131,0,0,65,131,29,60,159
2009,Stephon Marbury,PG,31,BOS,23,414,38,111,6,25,32,86,6,13,88
2009,Shawn Marion,SF,30,TOT,69,2470,382,788,10,53,372,735,117,147,891
2009,Shawn Marion,SF,30,MIA,42,1516,215,446,8,40,207,406,67,85,505
2009,Shawn Marion,SF,30,TOR,27,954,167,342,2,13,165,329,50,62,386
2009,Sean Marks,C,33,NOH,60,838,80,165,2,10,78,155,30,44,192
2009,Donyell Marshall,PF,35,PHI,25,189,33,73,25,55,8,18,3,6,94
2009,Cartier Martin,SF,24,CHA,33,266,28,77,10,33,18,44,20,25,86
2009,Kenyon Martin,PF,31,DEN,66,2111,318,648,14,38,304,610,119,197,769
2009,Kevin Martin,SG,25,SAC,51,1947,341,811,115,277,226,534,457,527,1254
2009,Desmond Mason,SG,31,OKC,39,1064,124,285,0,3,124,282,46,85,294
2009,Roger Mason,SG,28,SAS,82,2496,349,822,166,394,183,428,105,118,969
2009,Jason Maxiell,C,25,DET,78,1408,184,320,0,1,184,319,84,158,452
2009,Sean May,PF,24,CHA,24,301,39,98,1,1,38,97,14,20,93
2009,O.J. Mayo,SG,21,MEM,82,3120,562,1283,145,378,417,905,247,281,1516
2009,Luc Mbah,PF,22,MIL,82,2114,227,491,0,4,227,487,140,192,594
2009,Rashad McCants,SG,24,TOT,58,1101,192,488,63,189,129,299,107,141,554
2009,Rashad McCants,SG,24,MIN,34,636,105,292,38,119,67,173,60,81,308
2009,Rashad McCants,SG,24,SAC,24,465,87,196,25,70,62,126,47,60,246
2009,Antonio McDyess,PF,34,DET,62,1866,268,525,0,0,268,525,60,86,596
2009,JaVale McGee,C,21,WAS,75,1143,191,387,0,0,191,387,107,162,489
2009,Tracy McGrady,SG,29,HOU,35,1181,188,485,44,117,144,368,125,156,545
2009,Dominic McGuire,SF,23,WAS,79,2072,140,324,2,4,138,320,74,102,356
2009,Josh McRoberts,PF,21,IND,33,279,35,83,0,10,35,73,10,13,80
2009,Pops Mensah-Bonsu,PF,25,TOT,22,283,39,103,0,2,39,101,33,48,111
2009,Pops Mensah-Bonsu,PF,25,SAS,3,20,5,7,0,0,5,7,5,7,15
2009,Pops Mensah-Bonsu,PF,25,TOR,19,263,34,96,0,2,34,94,28,41,96
2009,Chris Mihm,C,29,LAL,18,105,15,40,0,0,15,40,6,7,36
2009,C.J. Miles,SG,21,UTA,72,1623,258,562,63,179,195,383,78,89,657
2009,Darius Miles,SF,27,MEM,34,298,48,99,1,6,47,93,23,31,120
2009,Darko Milicic,C,23,MEM,61,1034,137,266,0,0,137,266,59,105,333
2009,Andre Miller,PG,32,PHI,82,2976,492,1041,15,53,477,988,338,409,1337
2009,Brad Miller,C,32,TOT,70,2100,292,614,23,56,269,558,224,272,831
2009,Brad Miller,C,32,SAC,43,1354,184,388,20,43,164,345,125,156,513
2009,Brad Miller,C,32,CHI,27,746,108,226,3,13,105,213,99,116,318
2009,Mike Miller,SF,28,MIN,73,2356,264,548,85,225,179,323,109,149,722
2009,Paul Millsap,PF,23,UTA,76,2290,400,749,0,4,400,745,228,326,1028
2009,Yao Ming*,C,28,HOU,77,2589,566,1032,1,1,565,1031,381,440,1514
2009,Cuttino Mobley,SG,33,LAC,11,365,63,146,12,35,51,111,13,18,151
2009,Nazr Mohammed,C,31,CHA,39,341,41,101,0,0,41,101,22,40,104
2009,Jamario Moon,SF,28,TOT,80,2068,222,474,65,183,157,291,68,80,577
2009,Jamario Moon,SF,28,TOR,54,1379,150,317,38,110,112,207,55,65,393
2009,Jamario Moon,SF,28,MIA,26,689,72,157,27,73,45,84,13,15,184
2009,Mikki Moore,PF-C,33,TOT,70,1202,114,206,0,0,114,206,48,61,276
2009,Mikki Moore,PF,33,SAC,46,746,63,121,0,0,63,121,34,42,160
2009,Mikki Moore,C,33,BOS,24,456,51,85,0,0,51,85,14,19,116
2009,Randolph Morris,C,23,ATL,23,89,7,17,0,0,7,17,4,4,18
2009,Adam Morrison,SF,24,TOT,52,711,80,223,32,96,48,127,17,23,209
2009,Adam Morrison,SF,24,CHA,44,667,76,211,31,92,45,119,16,21,199
2009,Adam Morrison,SF,24,LAL,8,44,4,12,1,4,3,8,1,2,10
2009,Anthony Morrow,SG,23,GSW,67,1515,255,534,86,184,169,350,80,92,676
2009,Troy Murphy,PF,28,IND,73,2482,364,767,161,358,203,409,152,184,1041
2009,Ronald Murray,SG,29,ATL,80,1975,355,795,87,242,268,553,177,233,974
2009,Dikembe Mutombo*,C,42,HOU,9,96,5,13,0,0,5,13,6,9,16
2009,Eduardo Najera,PF,32,NJN,27,319,33,74,5,25,28,49,8,22,79
2009,Steve Nash,PG,34,PHO,74,2484,428,851,108,246,320,605,196,210,1160
2009,DeMarcus Nelson,PG,23,GSW,13,171,24,54,0,3,24,51,5,14,53
2009,Jameer Nelson,PG,26,ORL,42,1309,267,531,82,181,185,350,86,97,702
2009,Rasho Nesterovic,C,32,IND,70,1214,224,437,0,1,224,436,25,32,473
2009,Demetris Nichols,SF,24,TOT,4,14,3,9,0,2,3,7,1,2,7
2009,Demetris Nichols,SF,24,CHI,2,5,1,4,0,1,1,3,0,0,2
2009,Demetris Nichols,SF,24,NYK,2,9,2,5,0,1,2,4,1,2,5
2009,Joakim Noah,C,23,CHI,80,1938,207,372,0,1,207,371,123,182,537
2009,Andres Nocioni,PF-SF,29,TOT,76,1991,299,701,124,311,175,390,145,183,867
2009,Andres Nocioni,PF,29,CHI,53,1278,186,449,79,209,107,240,100,124,551
2009,Andres Nocioni,SF,29,SAC,23,713,113,252,45,102,68,150,45,59,316
2009,Steve Novak,PF,25,LAC,71,1161,176,396,119,286,57,110,21,23,492
2009,Dirk Nowitzki,PF,30,DAL,81,3050,774,1616,61,170,713,1446,485,545,2094
2009,Patrick O'Bryant,C,22,TOT,39,255,45,84,0,2,45,82,11,20,101
2009,Patrick O'Bryant,C,22,BOS,26,108,16,31,0,0,16,31,8,12,40
2009,Patrick O'Bryant,C,22,TOR,13,147,29,53,0,2,29,51,3,8,61
2009,Jermaine O'Neal,C,30,TOT,68,2027,365,770,0,1,365,769,175,222,905
2009,Jermaine O'Neal,C,30,TOR,41,1216,220,465,0,1,220,464,115,142,555
2009,Jermaine O'Neal,C,30,MIA,27,811,145,305,0,0,145,305,60,80,350
2009,Shaquille O'Neal*,C,36,PHO,75,2252,512,841,0,1,512,840,309,519,1333
2009,Fabricio Oberto,C,33,SAS,54,677,61,104,0,1,61,103,20,35,142
2009,Greg Oden,C,21,POR,61,1314,198,351,0,0,198,351,144,226,540
2009,Lamar Odom,PF,29,LAL,78,2316,346,703,33,103,313,600,160,257,885
2009,Emeka Okafor,C,26,CHA,82,2691,433,772,0,0,433,772,219,369,1085
2009,Mehmet Okur,C,29,UTA,72,2409,431,888,90,202,341,686,273,334,1225
2009,Kevin Ollie,PG,36,MIN,50,850,61,150,0,1,61,149,80,96,202
2009,Travis Outlaw,SF,24,POR,81,2246,385,850,89,236,296,614,175,242,1034
2009,Zaza Pachulia,C,24,ATL,77,1473,159,320,0,3,159,317,163,230,481
2009,Anthony Parker,SG,33,TOR,80,2637,321,754,94,241,227,513,121,145,857
2009,Tony Parker,PG,26,SAS,72,2456,639,1263,19,65,620,1198,284,363,1581
2009,Chris Paul,PG,23,NOH,78,3002,631,1255,64,176,567,1079,455,524,1781
2009,Sasha Pavlovic,SF,25,CLE,66,1053,116,275,48,117,68,158,25,54,305
2009,Oleksiy Pecherov,C,23,WAS,32,277,39,101,14,43,25,58,24,29,116
2009,Kendrick Perkins,C,24,BOS,76,2253,276,478,0,2,276,476,96,160,648
2009,Morris Peterson,SG,31,NOH,43,515,73,183,33,85,40,98,12,19,191
2009,Johan Petro,C,23,TOT,49,559,73,176,0,2,73,174,16,29,162
2009,Johan Petro,C,23,OKC,22,342,46,113,0,1,46,112,10,15,102
2009,Johan Petro,C,23,DEN,27,217,27,63,0,1,27,62,6,14,60
2009,Paul Pierce,SF,31,BOS,81,3035,540,1181,119,304,421,877,459,553,1658
2009,Mickael Pietrus,SG,26,ORL,54,1329,176,426,80,223,96,203,78,110,510
2009,James Posey,SG,32,NOH,75,2140,216,524,116,314,100,210,120,146,668
2009,Leon Powe,PF,25,BOS,70,1227,177,338,0,0,177,338,184,267,538
2009,Josh Powell,PF,26,LAL,60,703,106,239,0,0,106,239,38,50,250
2009,Ronnie Price,PG,25,UTA,52,738,77,203,19,61,58,142,34,45,207
2009,Tayshaun Prince,SF,28,DET,82,3057,459,1020,56,141,403,879,189,243,1163
2009,Gabe Pruitt,SG,22,BOS,47,366,31,101,14,48,17,53,17,21,93
2009,Joel Przybilla,C,29,POR,82,1952,168,269,0,1,168,268,112,169,448
2009,Chris Quinn,PG,25,MIA,66,962,118,289,56,137,62,152,47,58,339
2009,Vladimir Radmanovic,SF,28,TOT,78,1445,196,466,105,262,91,204,43,58,540
2009,Vladimir Radmanovic,SF,28,LAL,46,771,95,214,60,136,35,78,23,27,273
2009,Vladimir Radmanovic,SF,28,CHA,32,674,101,252,45,126,56,126,20,31,267
2009,Anthony Randolph,PF,19,GSW,63,1129,199,431,0,4,199,427,101,141,499
2009,Shavlik Randolph,PF,25,POR,10,37,8,13,1,1,7,12,1,4,18
2009,Zach Randolph,PF-C,27,TOT,50,1757,415,873,32,97,383,776,179,244,1041
2009,Zach Randolph,C,27,NYK,11,388,82,189,7,24,75,165,55,67,226
2009,Zach Randolph,PF,27,LAC,39,1369,333,684,25,73,308,611,124,177,815
2009,Theo Ratliff,C,35,PHI,46,579,34,64,0,0,34,64,21,35,89
2009,Michael Redd,SG,29,MIL,33,1203,249,547,70,191,179,356,131,161,699
2009,J.J. Redick,SG,24,ORL,64,1111,117,299,67,179,50,120,81,93,382
2009,Jason Richardson,SG,28,TOT,72,2410,465,974,129,325,336,649,153,199,1212
2009,Jason Richardson,SG,28,CHA,14,491,97,220,27,59,70,161,41,55,262
2009,Jason Richardson,SG,28,PHO,58,1919,368,754,102,266,266,488,112,144,950
2009,Jeremy Richardson,SF,24,ORL,12,93,14,49,6,17,8,32,3,6,37
2009,Quentin Richardson,SG,28,NYK,72,1894,262,667,120,329,142,338,89,117,733
2009,Luke Ridnour,PG,27,MIL,72,2033,250,621,55,157,195,464,133,153,688
2009,Anthony Roberson,PG,25,TOT,29,276,44,120,26,81,18,39,5,5,119
2009,Anthony Roberson,PG,25,NYK,23,253,39,103,24,71,15,32,5,5,107
2009,Anthony Roberson,PG,25,CHI,6,23,5,17,2,10,3,7,0,0,12
2009,Nate Robinson,PG,24,NYK,74,2209,449,1028,125,385,324,643,249,296,1272
2009,Sergio Rodriguez,PG,22,POR,80,1225,129,329,37,114,92,215,61,77,356
2009,Rajon Rondo,PG,22,BOS,80,2642,383,759,15,48,368,711,172,268,953
2009,Derrick Rose,PG,20,CHI,81,3000,574,1208,16,72,558,1136,197,250,1361
2009,Malik Rose,SF-PF,34,TOT,38,470,45,131,0,7,45,124,40,51,130
2009,Malik Rose,PF,34,NYK,18,160,11,41,0,4,11,37,8,11,30
2009,Malik Rose,SF,34,OKC,20,310,34,90,0,3,34,87,32,40,100
2009,Quinton Ross,SF,27,MEM,68,1164,99,259,33,88,66,171,34,42,265
2009,Brandon Roy,SG,24,POR,78,2903,633,1318,83,220,550,1098,416,505,1765
2009,Michael Ruffin,PF,32,POR,11,35,2,7,0,0,2,7,2,2,6
2009,Brandon Rush,SG,23,IND,75,1803,243,575,78,209,165,366,46,66,610
2009,Kareem Rush,SG,28,PHI,25,199,20,58,10,33,10,25,4,4,54
2009,John Salmons,SF,29,TOT,79,2959,516,1093,126,302,390,791,288,347,1446
2009,John Salmons,SF,29,SAC,53,1980,351,744,77,184,274,560,191,232,970
2009,John Salmons,SF,29,CHI,26,979,165,349,49,118,116,231,97,115,476
2009,Cheikh Samb,C,24,TOT,18,83,6,32,0,3,6,29,3,7,15
2009,Cheikh Samb,C,24,DEN,6,24,2,13,0,1,2,12,0,0,4
2009,Cheikh Samb,C,24,LAC,10,51,4,16,0,2,4,14,3,5,11
2009,Cheikh Samb,C,24,NYK,2,8,0,3,0,0,0,3,0,2,0
2009,Brian Scalabrine,C,30,BOS,39,504,48,114,24,61,24,53,16,18,136
2009,Luis Scola,PF,28,HOU,82,2488,424,799,0,3,424,796,196,258,1044
2009,Thabo Sefolosha,SF-SG,24,TOT,66,1453,152,357,24,87,128,270,61,73,389
2009,Thabo Sefolosha,SF,24,CHI,43,735,79,182,15,50,64,132,21,25,194
2009,Thabo Sefolosha,SG,24,OKC,23,718,73,175,9,37,64,138,40,48,195
2009,Mouhamed Sene,C,22,TOT,6,29,6,9,0,0,6,9,8,10,20
2009,Mouhamed Sene,C,22,OKC,5,23,5,7,0,0,5,7,7,9,17
2009,Mouhamed Sene,C,22,NYK,1,6,1,2,0,0,1,2,1,1,3
2009,Ramon Sessions,PG,22,MIL,79,2173,345,775,6,34,339,741,281,354,977
2009,Walter Sharpe,PF,22,DET,8,20,4,11,0,2,4,9,0,2,8
2009,Bobby Simmons,SF,28,NJN,71,1729,198,441,117,262,81,179,43,58,556
2009,Cedric Simmons,PF,23,TOT,18,84,11,25,0,0,11,25,7,16,29
2009,Cedric Simmons,PF,23,CHI,11,61,11,21,0,0,11,21,6,14,28
2009,Cedric Simmons,PF,23,SAC,7,23,0,4,0,0,0,4,1,2,1
2009,Courtney Sims,C,25,TOT,2,13,3,6,0,0,3,6,0,0,6
2009,Courtney Sims,C,25,PHO,1,2,0,0,0,0,0,0,0,0,0
2009,Courtney Sims,C,25,NYK,1,11,3,6,0,0,3,6,0,0,6
2009,Sean Singletary,PG,23,TOT,37,303,31,85,10,25,21,60,18,21,90
2009,Sean Singletary,PG,23,PHO,13,122,12,37,4,10,8,27,6,6,34
2009,Sean Singletary,PG,23,CHA,24,181,19,48,6,15,13,33,12,15,56
2009,James Singleton,PF,27,DAL,62,884,117,221,13,40,104,181,67,78,314
2009,Brian Skinner,PF,32,LAC,51,843,92,205,0,2,92,203,30,47,214
2009,Craig Smith,PF,25,MIN,74,1460,289,514,0,1,289,513,168,248,746
2009,J.R. Smith,SG,23,DEN,81,2245,424,950,180,453,244,497,205,272,1233
2009,Joe Smith,C,33,TOT,57,1102,156,333,3,7,153,326,59,82,374
2009,Joe Smith,C,33,OKC,36,691,99,218,2,4,97,214,38,54,238
2009,Joe Smith,C,33,CLE,21,411,57,115,1,3,56,112,21,28,136
2009,Josh Smith,PF,23,ATL,69,2421,418,849,26,87,392,762,211,359,1073
2009,Will Solomon,PG,30,TOT,53,712,105,245,28,86,77,159,25,34,263
2009,Will Solomon,PG,30,TOR,39,544,79,181,15,57,64,124,20,24,193
2009,Will Solomon,PG,30,SAC,14,168,26,64,13,29,13,35,5,10,70
2009,Darius Songaila,C,30,WAS,77,1521,243,457,0,1,243,456,80,90,566
2009,Marreese Speights,C,21,PHI,79,1263,252,502,2,8,250,494,102,132,608
2009,Jerry Stackhouse,SG,34,DAL,10,162,16,60,3,19,13,41,7,7,42
2009,DeShawn Stevenson,SG,27,WAS,32,886,72,231,35,129,37,102,32,60,211
2009,Peja Stojakovic,SF,31,NOH,61,2089,287,719,145,384,142,335,93,104,812
2009,Amar'e Stoudemire,PF,26,PHO,53,1948,404,749,3,7,401,742,323,387,1134
2009,Rodney Stuckey,PG,22,DET,79,2517,401,913,23,78,378,835,233,290,1058
2009,Robert Swift,C,23,OKC,26,343,37,71,0,0,37,71,12,16,86
2009,Stromile Swift,PF,29,TOT,19,185,24,56,1,1,23,55,13,26,62
2009,Stromile Swift,PF,29,NJN,6,64,9,15,0,0,9,15,5,11,23
2009,Stromile Swift,PF,29,PHO,13,121,15,41,1,1,14,40,8,15,39
2009,Wally Szczerbiak,SF,31,CLE,74,1527,179,398,69,168,110,230,90,106,517
2009,Mike Taylor,PG,23,LAC,51,771,110,267,13,40,97,227,56,81,289
2009,Sebastian Telfair,PG,23,MIN,75,2095,267,697,73,211,194,486,131,160,738
2009,Jason Terry,SG,31,DAL,74,2491,541,1168,167,456,374,712,198,225,1447
2009,Etan Thomas,C,30,WAS,26,306,32,66,0,0,32,66,16,23,80
2009,Kenny Thomas,PF,31,SAC,8,62,3,8,0,0,3,8,0,0,6
2009,Kurt Thomas,PF,36,SAS,79,1404,153,304,0,2,153,302,37,45,343
2009,Tim Thomas,PF,31,TOT,64,1247,189,438,78,189,111,249,89,121,545
2009,Tim Thomas,PF,31,LAC,10,220,34,90,6,20,28,70,21,34,95
2009,Tim Thomas,PF,31,NYK,36,773,119,258,53,126,66,132,54,67,345
2009,Tim Thomas,PF,31,CHI,18,254,36,90,19,43,17,47,14,20,105
2009,Tyrus Thomas,PF,22,CHI,79,2175,308,683,3,9,305,674,238,304,857
2009,Jason Thompson,PF,22,SAC,82,2303,356,717,0,8,356,709,198,286,910
2009,Al Thornton,SF,25,LAC,71,2654,469,1051,20,79,449,972,236,313,1194
2009,Anthony Tolliver,PF,23,SAS,19,208,19,65,9,41,10,24,5,10,52
2009,Alando Tucker,SG,24,PHO,30,282,52,121,8,23,44,98,26,33,138
2009,Ronny Turiaf,C,26,GSW,79,1696,186,366,0,3,186,363,98,124,470
2009,Hedo Turkoglu,SF,29,ORL,77,2815,423,1025,134,376,289,649,314,389,1294
2009,Ime Udoka,SF,31,SAS,67,1035,110,287,41,125,69,162,28,46,289
2009,Beno Udrih,PG,26,SAC,73,2270,321,696,35,113,286,583,123,150,800
2009,Roko Ukic,PG,24,TOR,72,890,123,324,11,62,112,262,44,60,301
2009,Anderson Varejao,PF,26,CLE,81,2306,270,504,0,2,270,502,154,250,694
2009,Jacque Vaughn,PG,33,SAS,30,292,24,75,1,1,23,74,16,18,65
2009,Charlie Villanueva,PF,24,MIL,78,2095,487,1089,89,258,398,831,201,240,1264
2009,Jake Voskuhl,C,31,TOR,38,240,12,45,0,0,12,45,11,14,35
2009,Sasha Vujacic,SG,24,LAL,80,1293,155,401,81,223,74,178,70,76,461
2009,Dwyane Wade,SG,27,MIA,79,3048,854,1739,88,278,766,1461,590,771,2386
2009,Von Wafer,SG,23,HOU,63,1225,229,512,64,164,165,348,88,117,610
2009,Henry Walker,SF,21,BOS,29,216,36,58,0,1,36,57,16,23,88
2009,Ben Wallace,PF,34,CLE,56,1314,69,155,0,0,69,155,27,64,165
2009,Gerald Wallace,SF,26,CHA,71,2669,389,811,39,131,350,680,365,454,1182
2009,Rasheed Wallace,C,34,DET,66,2123,302,720,113,319,189,401,78,101,795
2009,Luke Walton,SF,28,LAL,65,1166,134,307,17,57,117,250,41,57,326
2009,Hakim Warrick,PF,26,MEM,82,2029,340,693,5,23,335,670,266,374,951
2009,C.J. Watson,PG,24,GSW,77,1883,257,562,48,120,209,442,168,193,730
2009,Earl Watson,PG,29,OKC,68,1776,174,453,20,85,154,368,80,106,448
2009,Kyle Weaver,SG,22,OKC,56,1166,113,246,32,93,81,153,41,58,299
2009,Martell Webster,SF,22,POR,1,5,0,1,0,1,0,0,0,0,0
2009,Sonny Weems,SG,22,DEN,12,55,8,25,0,3,8,22,3,8,19
2009,David West,PF,28,NOH,76,2982,610,1292,6,25,604,1267,367,415,1593
2009,Delonte West,SG,25,CLE,64,2152,285,624,91,228,194,396,90,108,751
2009,Mario West,SG,24,ATL,53,269,14,34,1,1,13,33,14,30,43
2009,Russell Westbrook,PG,20,OKC,82,2668,436,1095,35,129,401,966,349,428,1256
2009,D.J. White,PF,22,OKC,7,130,26,50,0,0,26,50,10,13,62
2009,James White,SF,26,HOU,4,11,3,5,1,2,2,3,0,0,7
2009,Chris Wilcox,C,26,TOT,62,1049,184,370,0,4,184,366,79,140,447
2009,Chris Wilcox,C,26,OKC,37,719,130,268,0,3,130,265,52,87,312
2009,Chris Wilcox,C,26,NYK,25,330,54,102,0,1,54,101,27,53,135
2009,Damien Wilkins,SG,29,OKC,41,636,77,213,27,72,50,141,37,46,218
2009,Deron Williams,PG,24,UTA,68,2505,463,984,70,226,393,758,326,384,1322
2009,Jawad Williams,SF,25,CLE,10,20,5,12,2,6,3,6,0,0,12
2009,Lou Williams,SG,22,PHI,81,1919,336,844,63,220,273,624,304,385,1039
2009,Marcus Williams,PG,23,GSW,9,54,4,17,2,6,2,11,2,6,12
2009,Marcus Williams,PF,22,SAS,2,3,2,2,0,0,2,2,0,0,4
2009,Marvin Williams,SF,22,ATL,61,2093,285,622,55,155,230,467,220,273,845
2009,Mo Williams,PG,26,CLE,81,2834,526,1126,183,420,343,706,208,228,1443
2009,Sean Williams,PF,22,NJN,33,366,30,72,0,0,30,72,20,32,80
2009,Shawne Williams,SF,22,DAL,15,170,16,56,1,17,15,39,9,11,42
2009,Shelden Williams,PF,25,TOT,45,512,70,157,0,2,70,155,46,63,186
2009,Shelden Williams,PF,25,SAC,30,305,40,89,0,2,40,87,32,42,112
2009,Shelden Williams,PF,25,MIN,15,207,30,68,0,0,30,68,14,21,74
2009,Metta World,SF,29,HOU,69,2452,416,1037,153,383,263,654,196,262,1181
2009,Antoine Wright,SF,24,DAL,65,1552,179,431,45,149,134,282,71,95,474
2009,Brandan Wright,PF,21,GSW,39,688,130,246,0,4,130,242,63,85,323
2009,Dorell Wright,SF,23,MIA,6,73,8,20,0,0,8,20,2,6,18
2009,Julian Wright,SF,21,NOH,54,772,109,234,2,21,107,213,17,30,237
2009,Lorenzen Wright,C,33,CLE,17,125,10,27,0,0,10,27,3,8,23
2009,Nick Young,SG,23,WAS,82,1837,336,756,56,164,280,592,164,193,892
2009,Thaddeus Young,PF,20,PHI,75,2580,475,960,56,164,419,796,139,189,1145
2009,Sun Yue,SG,23,LAL,10,28,3,11,0,6,3,5,0,0,6
,,,,,,,,,,,,,,,
2010,Arron Afflalo,SG,24,DEN,82,2221,272,585,108,249,164,336,72,98,724
2010,Alexis Ajinca,C,21,CHA,6,30,5,10,0,0,5,10,0,1,10
2010,LaMarcus Aldridge,PF,24,POR,78,2922,579,1169,5,16,574,1153,230,304,1393
2010,Joe Alexander,SF,23,CHI,8,29,1,6,0,1,1,5,2,3,4
2010,Malik Allen,PF,31,DEN,51,456,46,116,1,6,45,110,12,13,105
2010,Ray Allen,SG,34,BOS,80,2819,464,973,145,399,319,574,231,253,1304
2010,Tony Allen,SG,28,BOS,54,889,129,253,0,5,129,248,72,119,330
2010,Rafer Alston,PG,33,TOT,52,1421,155,446,58,168,97,278,59,81,427
2010,Rafer Alston,PG,33,NJN,27,766,95,277,28,87,67,190,44,54,262
2010,Rafer Alston,PG,33,MIA,25,655,60,169,30,81,30,88,15,27,165
2010,Lou Amundson,PF,27,PHO,79,1168,152,276,0,1,152,275,67,123,371
2010,Chris Andersen,PF,31,DEN,76,1695,142,251,0,3,142,248,164,236,448
2010,David Andersen,C,29,HOU,63,891,147,340,27,78,120,262,46,67,367
2010,Antonio Anderson,SF,24,OKC,1,15,1,3,0,0,1,3,0,0,2
2010,Ryan Anderson,PF,21,ORL,63,911,169,388,78,211,91,177,71,82,487
2010,Carmelo Anthony,SF,25,DEN,69,2634,688,1502,59,187,629,1315,508,612,1943
2010,Joel Anthony,C,27,MIA,80,1322,76,159,0,0,76,159,66,92,218
2010,Gilbert Arenas,PG,28,WAS,32,1169,253,616,63,181,190,435,153,207,722
2010,Trevor Ariza,SF,24,HOU,72,2629,394,999,136,407,258,592,148,228,1072
2010,Hilton Armstrong,PF-C,25,TOT,33,335,28,79,0,1,28,78,15,32,71
2010,Hilton Armstrong,PF,25,NOH,18,239,19,50,0,0,19,50,13,28,51
2010,Hilton Armstrong,C,25,SAC,6,56,4,12,0,0,4,12,2,2,10
2010,Hilton Armstrong,C,25,HOU,9,40,5,17,0,1,5,16,0,2,10
2010,Carlos Arroyo,PG,30,MIA,72,1585,178,375,7,25,171,350,76,90,439
2010,Darrell Arthur,PF,21,MEM,32,457,63,146,0,1,63,145,17,30,143
2010,Chucky Atkins,PG,35,DET,40,644,57,157,22,73,35,84,25,27,161
2010,D.J. Augustin,PG,22,CHA,80,1472,168,435,70,178,98,257,102,131,508
2010,Jeff Ayres,C,22,POR,39,405,43,65,0,0,43,65,18,20,104
2010,Kelenna Azubuike,SF,26,GSW,9,231,48,88,10,27,38,61,19,28,125
2010,Renaldo Balkman,SF,25,DEN,13,91,6,18,0,7,6,11,2,6,14
2010,Marcus Banks,PG,28,TOR,22,244,39,73,7,24,32,49,24,29,109
2010,Leandro Barbosa,PG,27,PHO,44,786,155,365,44,136,111,229,64,73,418
2010,J.J. Barea,PG,25,DAL,78,1546,232,527,56,157,176,370,76,90,596
2010,Andrea Bargnani,PF,24,TOR,80,2799,537,1143,121,325,416,818,181,234,1376
2010,Matt Barnes,SF,29,ORL,81,2097,271,557,66,207,205,350,108,146,716
2010,Earl Barron,C,28,NYK,7,232,30,68,0,0,30,68,22,29,82
2010,Brandon Bass,PF,24,ORL,50,648,119,233,0,0,119,233,52,63,290
2010,Tony Battie,C,33,NJN,15,134,14,40,1,4,13,36,7,10,36
2010,Shane Battier,SG,31,HOU,67,2168,178,447,101,279,77,168,77,106,534
2010,Nicolas Batum,SF,21,POR,37,918,139,268,54,132,85,136,43,51,375
2010,Jerryd Bayless,SG,21,POR,74,1304,200,483,29,92,171,391,201,242,630
2010,Michael Beasley,PF,21,MIA,78,2328,468,1040,28,102,440,938,192,240,1156
2010,Rodrigue Beaubois,PG,21,DAL,56,700,155,299,45,110,110,189,42,52,397
2010,Marco Belinelli,SG,23,TOR,66,1121,154,379,60,158,94,221,101,121,469
2010,Charlie Bell,SG,30,MIL,71,1611,169,443,73,200,96,243,48,67,459
2010,Raja Bell,SG,33,TOT,6,180,28,61,12,27,16,34,3,3,71
2010,Raja Bell,SG,33,CHA,5,157,24,55,9,24,15,31,3,3,60
2010,Raja Bell,SG,33,GSW,1,23,4,6,3,3,1,3,0,0,11
2010,Jonathan Bender,SF,29,NYK,25,292,40,100,14,39,26,61,24,26,118
2010,Mike Bibby,PG,31,ATL,80,2195,268,644,126,324,142,320,68,79,730
2010,Andris Biedrins,C,23,GSW,33,763,81,137,0,0,81,137,4,25,166
2010,Chauncey Billups,PG,33,DEN,73,2490,402,962,157,407,245,555,466,512,1427
2010,DeJuan Blair,PF,20,SAS,82,1494,275,495,0,2,275,493,88,161,638
2010,Steve Blake,PG,29,TOT,80,2159,217,522,116,294,101,228,36,48,586
2010,Steve Blake,PG,29,POR,51,1397,143,355,78,207,65,148,24,32,388
2010,Steve Blake,PG,29,LAC,29,762,74,167,38,87,36,80,12,16,198
2010,Andray Blatche,PF,23,WAS,81,2256,478,999,13,44,465,955,174,234,1143
2010,Keith Bogans,SF,29,SAS,79,1559,120,298,70,196,50,102,37,50,347
2010,Andrew Bogut,C,25,MIL,69,2229,473,910,0,2,473,908,149,237,1095
2010,Matt Bonner,PF,29,SAS,65,1161,166,372,90,231,76,141,35,48,457
2010,Josh Boone,PF,25,NJN,63,1045,117,223,0,0,117,223,19,58,253
2010,Carlos Boozer,PF,28,UTA,78,2673,617,1098,0,0,617,1098,285,384,1519
2010,Chris Bosh,C,25,TOR,70,2526,600,1158,8,22,592,1136,470,590,1678
2010,Ryan Bowen,SF,34,OKC,1,8,1,1,0,0,1,1,2,2,4
2010,Earl Boykins,PG,33,WAS,67,1117,172,403,19,60,153,343,77,89,440
2010,Elton Brand,PF,30,PHI,76,2297,412,858,0,1,412,857,172,233,996
2010,Corey Brewer,SG,23,MIN,82,2482,409,949,82,237,327,712,166,256,1066
2010,Ronnie Brewer,SG,24,TOT,58,1742,209,429,8,31,201,398,85,133,511
2010,Ronnie Brewer,SG,24,UTA,53,1662,206,416,8,31,198,385,81,128,501
2010,Ronnie Brewer,SG,24,MEM,5,80,3,13,0,0,3,13,4,5,10
2010,Primoz Brezec,C,30,TOT,21,95,9,26,0,0,9,26,1,6,19
2010,Primoz Brezec,C,30,PHI,7,36,2,13,0,0,2,13,1,2,5
2010,Primoz Brezec,C,30,MIL,14,59,7,13,0,0,7,13,0,4,14
2010,Jon Brockman,PF,22,SAC,52,654,55,103,0,0,55,103,37,62,147
2010,Aaron Brooks,PG,25,HOU,82,2919,575,1331,209,525,366,806,245,298,1604
2010,Bobby Brown,PG,25,TOT,45,519,88,237,26,98,62,139,13,15,215
2010,Bobby Brown,PG,25,NOH,22,328,60,152,17,66,43,86,8,8,145
2010,Bobby Brown,PG,25,LAC,23,191,28,85,9,32,19,53,5,7,70
2010,Derrick Brown,SF,22,CHA,57,535,68,147,2,7,66,140,48,72,186
2010,Devin Brown,SG,31,TOT,50,1060,136,361,58,164,78,197,69,86,399
2010,Devin Brown,SG,31,NOH,39,967,128,325,54,147,74,178,69,86,379
2010,Devin Brown,SG,31,CHI,11,93,8,36,4,17,4,19,0,0,20
2010,Kwame Brown,C,27,DET,48,660,62,124,0,1,62,123,33,98,157
2010,Shannon Brown,SG,24,LAL,82,1700,253,592,62,189,191,403,99,121,667
2010,Kobe Bryant,SG,31,LAL,73,2835,716,1569,99,301,617,1268,439,541,1970
2010,Chase Budinger,SF,21,HOU,74,1488,249,565,92,249,157,316,67,87,657
2010,Caron Butler,SF-SG,29,TOT,74,2783,450,1051,42,145,408,906,264,315,1206
2010,Caron Butler,SF,29,WAS,47,1853,293,694,25,95,268,599,185,211,796
2010,Caron Butler,SG,29,DAL,27,930,157,357,17,50,140,307,79,104,410
2010,Rasual Butler,SF,30,LAC,82,2702,356,870,145,432,211,438,122,145,979
2010,Andrew Bynum,C,22,LAL,65,1977,392,688,0,1,392,687,193,261,977
2010,Will Bynum,PG,27,DET,63,1667,237,534,12,55,225,479,142,178,628
2010,Jose Calderon,PG,28,TOR,68,1817,274,568,68,171,206,397,83,104,699
2010,Marcus Camby,PF-C,35,TOT,74,2314,238,501,2,7,236,494,78,122,556
2010,Marcus Camby,PF,35,LAC,51,1596,166,356,2,6,164,350,60,91,394
2010,Marcus Camby,C,35,POR,23,718,72,145,0,1,72,144,18,31,162
2010,Brian Cardinal,PF,32,MIN,29,267,14,36,3,9,11,27,17,18,48
2010,Rodney Carney,SG,25,PHI,68,857,113,282,41,135,72,147,52,63,319
2010,DeMarre Carroll,SF,23,MEM,71,795,88,222,0,6,88,216,33,53,209
2010,Matt Carroll,SG,29,DAL,25,121,18,50,4,19,14,31,6,6,46
2010,Anthony Carter,PG,34,DEN,54,859,76,181,17,63,59,118,11,13,180
2010,Vince Carter,SG,33,ORL,75,2310,434,1015,119,324,315,691,257,306,1244
2010,Omri Casspi,SF,21,SAC,77,1931,300,672,75,203,225,469,117,174,792
2010,Mario Chalmers,PG,23,MIA,73,1807,182,454,75,236,107,218,82,110,521
2010,Tyson Chandler,C,27,CHA,51,1163,109,190,0,0,109,190,115,157,333
2010,Wilson Chandler,SG,22,NYK,65,2320,412,860,40,150,372,710,129,160,993
2010,Earl Clark,PF,22,PHO,51,383,56,151,2,5,54,146,26,36,140
2010,Jarron Collins,C,31,PHO,34,261,12,31,0,0,12,31,10,25,34
2010,Jason Collins,C,31,ATL,24,115,8,23,0,1,8,22,0,2,16
2010,Mardy Collins,SG,25,LAC,43,470,47,128,4,17,43,111,13,21,111
2010,Darren Collison,PG,22,NOH,76,2109,376,789,46,115,330,674,148,174,946
2010,Nick Collison,C,29,OKC,75,1557,182,309,1,4,181,305,74,107,439
2010,Mike Conley,PG,22,MEM,80,2569,369,830,82,212,287,618,139,187,959
2010,Will Conroy,PG,27,HOU,5,36,3,10,0,3,3,7,0,2,6
2010,Brian Cook,PF,29,HOU,15,44,7,23,2,9,5,14,5,7,21
2010,Daequan Cook,SG,22,MIA,45,691,81,253,40,126,41,127,21,25,223
2010,Jamal Crawford,SG,29,ATL,79,2460,496,1105,163,427,333,678,270,315,1425
2010,Dante Cunningham,PF,22,POR,63,707,106,214,0,2,106,212,31,48,243
2010,Eddy Curry,C,27,NYK,7,62,8,21,0,0,8,21,10,17,26
2010,JamesOn Curry,PG,24,LAC,1,0,0,0,0,0,0,0,0,0,0
2010,Stephen Curry,PG,21,GSW,80,2896,528,1143,166,380,362,763,177,200,1399
2010,Samuel Dalembert,C,28,PHI,82,2124,285,523,0,0,285,523,97,133,667
2010,Erick Dampier,C,34,DAL,55,1280,133,213,1,3,132,210,61,101,328
2010,Marquis Daniels,SF,29,BOS,51,937,124,249,6,28,118,221,34,56,288
2010,Baron Davis,PG,30,LAC,75,2523,412,1015,82,296,330,719,239,291,1145
2010,Glen Davis,PF,24,BOS,54,933,122,279,0,4,122,275,96,138,340
2010,Paul Davis,PF,25,WAS,2,8,2,4,0,0,2,4,1,2,5
2010,Ricky Davis,SF,30,LAC,36,499,62,143,16,42,46,101,18,31,158
2010,Austin Daye,SF,21,DET,69,915,137,295,29,95,108,200,46,56,349
2010,Carlos Delfino,SF,27,MIL,75,2279,299,732,134,365,165,367,93,119,825
2010,Luol Deng,SF,24,CHI,70,2651,473,1014,32,83,441,931,252,330,1230
2010,DeMar DeRozan,SG,20,TOR,77,1664,255,512,4,16,251,496,148,194,662
2010,Boris Diaw,PF,27,CHA,82,2906,373,773,66,206,307,567,113,147,925
2010,Yakhouba Diawara,SG,27,MIA,6,44,2,10,1,6,1,4,0,0,5
2010,Travis Diener,PG,27,TOT,9,51,2,10,1,7,1,3,1,4,6
2010,Travis Diener,PG,27,IND,4,25,1,6,1,5,0,1,0,2,3
2010,Travis Diener,PG,27,POR,5,26,1,4,0,2,1,2,1,2,3
2010,DeSagana Diop,C,28,CHA,27,262,15,29,0,0,15,29,2,9,32
2010,Keyon Dooling,PG,29,NJN,53,971,129,324,59,157,70,167,47,61,364
2010,Joey Dorsey,PF,26,TOT,15,106,9,20,0,0,9,20,5,12,23
2010,Joey Dorsey,PF,26,HOU,7,54,5,11,0,0,5,11,1,2,11
2010,Joey Dorsey,PF,26,SAC,8,52,4,9,0,0,4,9,4,10,12
2010,Toney Douglas,PG,23,NYK,56,1087,179,391,68,175,111,216,55,68,481
2010,Chris Douglas-Roberts,SF,23,NJN,67,1730,255,573,14,54,241,519,133,157,657
2010,Goran Dragic,PG,23,PHO,80,1442,222,491,74,188,148,303,117,159,635
2010,Jared Dudley,SF,24,PHO,82,1991,225,490,120,262,105,228,104,138,674
2010,Chris Duhon,PG,27,NYK,67,2072,168,451,90,258,78,193,68,95,494
2010,Tim Duncan,C,33,SAS,78,2438,561,1082,2,11,559,1071,271,374,1395
2010,Mike Dunleavy,SF,29,IND,67,1486,229,558,75,236,154,322,133,158,666
2010,Kevin Durant,SF,21,OKC,82,3239,794,1668,128,351,666,1317,756,840,2472
2010,Wayne Ellington,SG,22,MIN,76,1384,190,448,64,162,126,286,61,70,505
2010,Monta Ellis,SG,24,GSW,64,2647,631,1406,77,228,554,1178,292,388,1631
2010,Francisco Elson,C,33,TOT,12,66,5,15,0,0,5,15,2,5,12
2010,Francisco Elson,C,33,MIL,11,62,4,13,0,0,4,13,2,2,10
2010,Francisco Elson,C,33,PHI,1,4,1,2,0,0,1,2,0,3,2
2010,Maurice Evans,SF,31,ATL,79,1317,175,393,57,169,118,224,46,61,453
2010,Reggie Evans,PF,29,TOR,28,311,34,69,0,0,34,69,27,60,95
2010,Tyreke Evans,SG,20,SAC,72,2677,533,1165,36,141,497,1024,348,465,1450
2010,Jordan Farmar,PG,23,LAL,82,1474,224,515,86,229,138,286,57,85,591
2010,Raymond Felton,PG,25,CHA,80,2643,388,846,60,156,328,690,132,173,968
2010,Rudy Fernandez,SG,24,POR,62,1441,160,423,98,266,62,157,85,98,503
2010,Kyrylo Fesenko,C,23,UTA,49,408,52,95,0,1,52,94,24,57,128
2010,Michael Finley,SF,36,TOT,46,709,81,184,32,82,49,102,8,15,202
2010,Michael Finley,SF,36,SAS,25,395,37,97,13,41,24,56,6,9,93
2010,Michael Finley,SF,36,BOS,21,314,44,87,19,41,25,46,2,6,109
2010,Derek Fisher,PG,35,LAL,82,2227,212,558,78,224,134,334,113,132,615
2010,Jonny Flynn,PG,20,MIN,81,2339,397,952,77,215,320,737,223,270,1094
2010,T.J. Ford,PG,26,IND,47,1189,186,418,8,50,178,368,104,135,484
2010,Jeff Foster,C,33,IND,16,255,22,46,0,1,22,45,5,9,49
2010,Randy Foye,PG,26,WAS,70,1667,256,619,63,182,193,437,129,145,704
2010,Channing Frye,C,26,PHO,81,2190,317,703,172,392,145,311,98,121,904
2010,Dan Gadzuric,C,31,MIL,32,314,39,89,0,0,39,89,10,25,88
2010,Sundiata Gaines,PG,23,UTA,32,217,38,82,7,26,31,56,23,46,106
2010,Danilo Gallinari,SF,21,NYK,81,2747,392,927,186,488,206,439,251,307,1221
2010,Francisco Garcia,SG,28,SAC,25,575,82,176,23,59,59,117,15,17,202
2010,Kevin Garnett,PF,33,BOS,69,2060,402,772,1,5,401,767,185,221,990
2010,Marc Gasol,C,25,MEM,69,2469,378,651,0,1,378,650,252,376,1008
2010,Pau Gasol,C,29,LAL,65,2403,452,844,0,5,452,839,286,362,1190
2010,Rudy Gay,SF,23,MEM,80,3175,600,1288,66,202,534,1086,301,400,1567
2010,Alonzo Gee,SG,22,WAS,11,182,28,59,7,9,21,50,18,29,81
2010,Devean George,SF,32,GSW,45,761,89,206,48,123,41,83,16,23,242
2010,Daniel Gibson,PG,23,CLE,56,1068,125,268,71,149,54,119,34,49,355
2010,Taj Gibson,PF,24,CHI,82,2204,311,629,0,0,311,629,113,175,735
2010,J.R. Giddens,SF,24,TOT,32,239,28,60,0,10,28,50,13,23,69
2010,J.R. Giddens,SF,24,BOS,21,99,9,21,0,2,9,19,6,12,24
2010,J.R. Giddens,SF,24,NYK,11,140,19,39,0,8,19,31,7,11,45
2010,Trey Gilder,SF,25,MEM,2,5,1,1,0,0,1,1,0,0,2
2010,Manu Ginobili,SG,32,SAS,75,2150,398,903,132,350,266,553,309,355,1237
2010,Ryan Gomes,SF,27,MIN,76,2210,327,732,74,199,253,533,104,126,832
2010,Drew Gooden,C-PF,28,TOT,70,1755,288,602,1,8,287,594,186,216,763
2010,Drew Gooden,C,28,DAL,46,1030,157,336,1,6,156,330,93,115,408
2010,Drew Gooden,PF,28,LAC,24,725,131,266,0,2,131,264,93,101,355
2010,Ben Gordon,SG,26,DET,62,1730,291,699,75,234,216,465,198,230,855
2010,Eric Gordon,SG,21,LAC,62,2229,352,784,119,321,233,463,222,299,1045
2010,Marcin Gortat,C,25,ORL,81,1088,121,227,0,3,121,224,51,75,293
2010,Joey Graham,SF,27,DEN,63,759,105,202,2,13,103,189,54,73,266
2010,Stephen Graham,SG,27,CHA,70,804,119,240,16,50,103,190,42,65,296
2010,Danny Granger,SF,26,IND,62,2278,488,1139,158,438,330,701,363,428,1497
2010,Aaron Gray,C,25,TOT,32,311,42,82,0,0,42,82,20,28,104
2010,Aaron Gray,C,25,CHI,8,50,8,21,0,0,8,21,2,7,18
2010,Aaron Gray,C,25,NOH,24,261,34,61,0,0,34,61,18,21,86
2010,Danny Green,SG,22,CLE,20,115,15,39,6,22,9,17,4,6,40
2010,Jeff Green,PF,23,OKC,82,3043,485,1070,104,312,381,758,165,223,1239
2010,Willie Green,SG,28,PHI,73,1553,248,543,47,136,201,407,95,114,638
2010,Donte Greene,SF,21,SAC,76,1630,244,553,69,183,175,370,90,140,647
2010,Taylor Griffin,SF,23,PHO,8,32,4,10,0,2,4,8,2,4,10
2010,Hamed Haddadi,C,24,MEM,36,240,24,62,0,3,24,59,14,19,62
2010,Malik Hairston,SG,22,SAS,47,317,40,76,2,11,38,65,17,30,99
2010,Marcus Haislip,SF,29,SAS,10,44,10,21,3,5,7,16,2,5,25
2010,Richard Hamilton,SG,31,DET,46,1552,293,717,41,138,252,579,204,241,831
2010,Tyler Hansbrough,PF,24,IND,29,511,81,225,0,4,81,221,84,113,246
2010,James Harden,SG,20,OKC,76,1738,233,578,93,248,140,330,194,240,753
2010,Al Harrington,PF,29,NYK,72,2195,448,1030,140,409,308,621,240,317,1276
2010,Devin Harris,PG,26,NJN,64,2221,356,884,60,217,296,667,308,386,1080
2010,Mike Harris,PF,26,TOT,13,96,11,30,0,1,11,29,7,11,29
2010,Mike Harris,PF,26,HOU,8,82,10,27,0,1,10,26,5,9,25
2010,Mike Harris,PF,26,WAS,5,14,1,3,0,0,1,3,2,2,4
2010,Jason Hart,PG,31,TOT,5,22,1,2,0,0,1,2,0,0,2
2010,Jason Hart,PG,31,MIN,1,5,0,1,0,0,0,1,0,0,0
2010,Jason Hart,PG,31,NOH,4,17,1,1,0,0,1,1,0,0,2
2010,Udonis Haslem,PF,29,MIA,78,2177,312,632,0,0,312,632,147,193,771
2010,Trenton Hassell,SF,30,NJN,52,1106,90,219,0,5,90,214,52,69,232
2010,Spencer Hawes,C,21,SAC,72,1904,312,666,26,87,286,579,73,106,723
2010,Chuck Hayes,C,26,HOU,82,1773,161,329,0,0,161,329,36,66,358
2010,Jarvis Hayes,SF,28,NJN,45,1033,138,328,60,179,78,149,14,18,350
2010,Brendan Haywood,C,30,TOT,77,2355,276,491,0,1,276,490,152,245,704
2010,Brendan Haywood,C,30,WAS,49,1614,188,335,0,0,188,335,102,158,478
2010,Brendan Haywood,C,30,DAL,28,741,88,156,0,1,88,155,50,87,226
2010,Luther Head,SG,27,IND,47,813,136,311,37,105,99,206,48,58,357
2010,Gerald Henderson,SG,22,CHA,43,355,37,104,4,19,33,85,35,47,113
2010,Roy Hibbert,C,23,IND,81,2035,387,782,3,6,384,776,169,224,946
2010,J.J. Hickson,PF,21,CLE,81,1691,289,522,0,1,289,521,111,163,689
2010,Nene Hilario,C,27,DEN,82,2755,421,717,0,2,421,715,293,416,1135
2010,George Hill,PG,23,SAS,78,2276,353,738,75,188,278,550,183,237,964
2010,Grant Hill,SF,37,PHO,81,2430,336,703,35,80,301,623,205,251,912
2010,Jordan Hill,PF,22,TOT,47,624,99,201,0,2,99,199,46,68,244
2010,Jordan Hill,PF,22,NYK,24,252,41,92,0,2,41,90,15,21,97
2010,Jordan Hill,PF,22,HOU,23,372,58,109,0,0,58,109,31,47,147
2010,Kirk Hinrich,SG,29,CHI,74,2481,308,753,104,280,204,473,85,113,805
2010,Jrue Holiday,PG,19,PHI,73,1767,230,520,62,159,168,361,65,86,587
2010,Ryan Hollins,C,25,MIN,73,1223,169,303,0,1,169,302,109,158,447
2010,Al Horford,C,23,ATL,81,2845,467,847,1,1,466,846,213,270,1148
2010,Eddie House,PG-SG,31,TOT,68,1217,173,455,79,227,94,228,48,52,473
2010,Eddie House,PG,31,BOS,50,846,129,322,64,167,65,155,36,40,358
2010,Eddie House,SG,31,NYK,18,371,44,133,15,60,29,73,12,12,115
2010,Dwight Howard,C,24,ORL,82,2843,510,834,0,7,510,827,483,816,1503
2010,Josh Howard,SF,29,TOT,35,918,157,388,23,86,134,302,109,139,446
2010,Josh Howard,SF,29,DAL,31,827,137,342,20,75,117,267,94,119,388
2010,Josh Howard,SF,29,WAS,4,91,20,46,3,11,17,35,15,20,58
2010,Juwan Howard,C,36,POR,73,1632,191,375,0,1,191,374,55,70,437
2010,Lester Hudson,PG,25,TOT,25,131,21,53,5,16,16,37,11,13,58
2010,Lester Hudson,PG,25,BOS,16,70,7,18,3,5,4,13,5,6,22
2010,Lester Hudson,PG,25,MEM,9,61,14,35,2,11,12,24,6,7,36
2010,Larry Hughes,SG,31,TOT,45,1115,137,386,43,139,94,247,94,113,411
2010,Larry Hughes,SG,31,NYK,31,820,102,279,28,97,74,182,65,79,297
2010,Larry Hughes,SG,31,CHA,14,295,35,107,15,42,20,65,29,34,114
2010,Kris Humphries,PF,24,TOT,69,1221,180,408,0,1,180,407,127,190,487
2010,Kris Humphries,PF,24,DAL,25,315,53,115,0,0,53,115,25,44,131
2010,Kris Humphries,PF,24,NJN,44,906,127,293,0,1,127,292,102,146,356
2010,Chris Hunter,C,25,GSW,60,783,109,217,0,4,109,213,52,69,270
2010,Lindsey Hunter,PG,39,CHI,13,122,5,30,1,13,4,17,2,2,13
2010,Othello Hunter,SF,23,ATL,7,33,4,12,0,0,4,12,3,4,11
2010,Steven Hunter,C,28,MEM,21,158,17,43,0,0,17,43,19,36,53
2010,Serge Ibaka,PF,20,OKC,73,1323,201,370,1,2,200,368,58,92,461
2010,Andre Iguodala,SF,26,PHI,82,3193,496,1120,94,303,402,817,315,430,1401
2010,Zydrunas Ilgauskas,C,34,CLE,64,1339,194,438,11,23,183,415,75,101,474
2010,Didier Ilunga-Mbenga,C,29,LAL,49,355,48,103,0,0,48,103,9,19,105
2010,Ersan Ilyasova,PF,22,MIL,81,1898,323,729,81,241,242,488,113,158,840
2010,Allen Iverson*,SG-PG,34,TOT,28,865,136,316,9,25,127,291,104,131,385
2010,Allen Iverson*,PG,34,MEM,3,67,15,26,1,1,14,25,6,12,37
2010,Allen Iverson*,SG,34,PHI,25,798,121,290,8,24,113,266,98,119,348
2010,Royal Ivey,SG,28,TOT,44,326,35,83,14,35,21,48,9,12,93
2010,Royal Ivey,SG,28,PHI,26,236,26,55,12,24,14,31,6,7,70
2010,Royal Ivey,SG,28,MIL,18,90,9,28,2,11,7,17,3,5,23
2010,Jarrett Jack,PG,26,TOR,82,2243,323,671,82,199,241,472,203,241,931
2010,Cedric Jackson,PG,23,TOT,12,74,6,20,1,6,5,14,7,12,20
2010,Cedric Jackson,PG,23,CLE,5,10,0,2,0,1,0,1,1,4,1
2010,Cedric Jackson,PG,23,SAS,3,25,2,7,0,2,2,5,3,4,7
2010,Cedric Jackson,PG,23,WAS,4,39,4,11,1,3,3,8,3,4,12
2010,Darnell Jackson,PF,24,TOT,28,123,9,30,1,4,8,26,4,6,23
2010,Darnell Jackson,PF,24,CLE,27,114,8,25,1,3,7,22,4,6,21
2010,Darnell Jackson,PF,24,MIL,1,9,1,5,0,1,1,4,0,0,2
2010,Stephen Jackson,SG-PF,31,TOT,81,3129,600,1418,129,393,471,1025,338,434,1667
2010,Stephen Jackson,PF,31,GSW,9,300,56,133,11,40,45,93,26,37,149
2010,Stephen Jackson,SG,31,CHA,72,2829,544,1285,118,353,426,932,312,397,1518
2010,LeBron James,SF,25,CLE,76,2966,768,1528,129,387,639,1141,593,773,2258
2010,Mike James,PG,34,WAS,4,46,6,20,2,6,4,14,4,8,18
2010,Antawn Jamison,PF,33,TOT,66,2406,478,1036,85,247,393,789,194,300,1235
2010,Antawn Jamison,PF,33,WAS,41,1595,315,700,58,168,257,532,152,217,840
2010,Antawn Jamison,PF,33,CLE,25,811,163,336,27,79,136,257,42,83,395
2010,Nathan Jawai,C,23,MIN,39,412,49,111,0,1,49,110,26,38,124
2010,Othyus Jeffers,SG,24,UTA,14,73,12,29,0,0,12,29,13,19,37
2010,Al Jefferson,C,25,MIN,76,2463,560,1125,0,4,560,1121,181,266,1301
2010,Richard Jefferson,SF,29,SAS,81,2520,362,775,59,187,303,588,211,287,994
2010,Jared Jeffries,PF-SF,28,TOT,70,1794,138,314,21,71,117,243,75,120,372
2010,Jared Jeffries,PF,28,NYK,52,1462,102,230,20,62,82,168,60,93,284
2010,Jared Jeffries,SF,28,HOU,18,332,36,84,1,9,35,75,15,27,88
2010,Brandon Jennings,PG,20,MIL,82,2671,451,1216,145,388,306,828,223,273,1270
2010,Jonas Jerebko,PF,22,DET,80,2232,290,603,36,115,254,488,125,176,741
2010,Yi Jianlian,PF,22,NJN,52,1655,227,563,15,41,212,522,154,193,623
2010,Amir Johnson,PF,22,TOR,82,1453,208,334,0,4,208,330,95,149,511
2010,Anthony Johnson,PG,35,ORL,31,406,49,111,13,39,36,72,19,20,130
2010,James Johnson,PF,22,CHI,65,757,95,210,15,46,80,164,51,70,256
2010,Joe Johnson,SG,28,ATL,76,2886,635,1386,129,350,506,1036,220,269,1619
2010,Dahntay Jones,SF,29,IND,76,1892,287,623,4,32,283,591,198,257,776
2010,Dwayne Jones,PF,26,PHO,2,7,0,0,0,0,0,0,0,0,0
2010,James Jones,SF,29,MIA,36,503,43,119,37,90,6,29,23,28,146
2010,Solomon Jones,C,25,IND,52,675,78,176,0,3,78,173,51,71,207
2010,DeAndre Jordan,C,21,LAC,70,1137,144,238,0,2,144,236,48,128,336
2010,Chris Kaman,C,27,LAC,76,2608,589,1202,0,6,589,1196,230,307,1408
2010,Jason Kapono,SF,28,PHI,57,976,126,301,63,171,63,130,9,15,324
2010,Coby Karl,SF-SG,26,TOT,7,113,11,32,2,11,9,21,4,6,28
2010,Coby Karl,SG,26,CLE,3,5,0,0,0,0,0,0,0,0,0
2010,Coby Karl,SF,26,GSW,4,108,11,32,2,11,9,21,4,6,28
2010,Jason Kidd,PG,36,DAL,80,2881,284,671,176,414,108,257,80,99,824
2010,Andrei Kirilenko,SF,28,UTA,58,1681,244,482,26,89,218,393,174,234,688
2010,Kyle Korver,SG,28,UTA,52,952,138,280,59,110,79,170,39,49,374
2010,Kosta Koufos,C,20,UTA,36,172,22,47,0,0,22,47,9,15,53
2010,Nenad Krstic,C,26,OKC,76,1741,281,560,1,5,280,555,76,106,639
2010,Oliver Lafayette,SG,25,BOS,1,22,3,6,1,2,2,4,0,0,7
2010,Carl Landry,PF,26,TOT,80,2469,499,931,1,3,498,928,344,427,1343
2010,Carl Landry,PF,26,HOU,52,1415,302,552,0,0,302,552,235,280,839
2010,Carl Landry,PF,26,SAC,28,1054,197,379,1,3,196,376,109,147,504
2010,Marcus Landry,SF,24,TOT,18,111,16,43,9,28,7,15,3,5,44
2010,Marcus Landry,SF,24,NYK,17,108,16,41,9,26,7,15,3,5,44
2010,Marcus Landry,SF,24,BOS,1,3,0,2,0,2,0,0,0,0,0
2010,Acie Law,PG,25,TOT,26,234,35,75,5,16,30,59,38,49,113
2010,Acie Law,PG,25,GSW,5,66,9,14,1,3,8,11,12,15,31
2010,Acie Law,PG,25,CHA,9,33,5,16,0,1,5,15,6,7,16
2010,Acie Law,PG,25,CHI,12,135,21,45,4,12,17,33,20,27,66
2010,Ty Lawson,PG,22,DEN,65,1318,201,390,34,83,167,307,106,140,542
2010,Courtney Lee,SG,24,NJN,71,2375,338,775,76,225,262,550,133,153,885
2010,David Lee,C,26,NYK,81,3019,686,1258,0,8,686,1250,268,330,1640
2010,Rashard Lewis,PF,30,ORL,72,2369,350,805,168,423,182,382,145,180,1013
2010,Shaun Livingston,PG,24,TOT,36,796,104,201,0,6,104,195,42,48,250
2010,Shaun Livingston,PG,24,OKC,10,130,5,16,0,2,5,14,0,0,10
2010,Shaun Livingston,PG,24,WAS,26,666,99,185,0,4,99,181,42,48,240
2010,Brook Lopez,C,21,NJN,82,3027,563,1129,0,2,563,1127,416,509,1542
2010,Robin Lopez,C,21,PHO,51,986,171,291,0,0,171,291,88,125,430
2010,Kevin Love,PF,21,MIN,60,1714,291,646,35,106,256,540,225,276,842
2010,Kyle Lowry,PG,23,HOU,68,1651,184,464,37,136,147,328,215,260,620
2010,Corey Maggette,PF,30,GSW,70,2081,457,886,13,50,444,836,460,551,1387
2010,Jamaal Magloire,C,31,MIA,36,359,28,56,0,0,28,56,21,59,77
2010,Ian Mahinmi,C,23,SAS,26,165,35,55,0,0,35,55,31,47,101
2010,Shawn Marion,SF,31,DAL,75,2385,395,778,3,19,392,759,105,139,898
2010,Sean Marks,C,34,NOH,14,75,4,8,0,0,4,8,2,5,10
2010,Cartier Martin,SF,25,TOT,18,390,50,136,17,49,33,87,24,30,141
2010,Cartier Martin,SF,25,GSW,10,276,32,88,10,31,22,57,16,21,90
2010,Cartier Martin,SF,25,WAS,8,114,18,48,7,18,11,30,8,9,51
2010,Kenyon Martin,PF,32,DEN,58,1986,283,620,8,29,275,591,93,167,667
2010,Kevin Martin,SG,26,TOT,46,1633,289,693,70,210,219,483,298,340,946
2010,Kevin Martin,SG,26,SAC,22,774,135,339,39,110,96,229,127,155,436
2010,Kevin Martin,SG,26,HOU,24,859,154,354,31,100,123,254,171,185,510
2010,Desmond Mason,SF,32,SAC,5,66,5,12,0,0,5,12,3,4,13
2010,Roger Mason,SG,29,SAS,79,1515,193,496,88,264,105,232,27,34,501
2010,Wesley Matthews,SG,23,UTA,82,2025,273,565,63,165,210,400,160,193,769
2010,Jason Maxiell,C,26,DET,76,1550,212,415,0,1,212,414,89,155,513
2010,Sean May,C,25,SAC,37,331,51,111,0,4,51,107,21,32,123
2010,Eric Maynor,PG,22,TOT,81,1269,154,368,22,71,132,297,52,72,382
2010,Eric Maynor,PG,22,UTA,26,363,52,133,5,24,47,109,25,33,134
2010,Eric Maynor,PG,22,OKC,55,906,102,235,17,47,85,188,27,39,248
2010,O.J. Mayo,SG,22,MEM,82,3113,542,1183,136,355,406,828,212,262,1432
2010,Luc Mbah,PF,23,MIL,73,1866,177,369,6,17,171,352,93,133,453
2010,Antonio McDyess,PF,35,SAS,77,1617,205,428,0,2,205,426,36,57,446
2010,JaVale McGee,C,22,WAS,60,968,156,307,0,1,156,306,74,116,386
2010,Tracy McGrady,SG,30,TOT,30,673,91,235,16,64,75,171,47,63,245
2010,Tracy McGrady,SG,30,HOU,6,46,7,19,1,2,6,17,4,6,19
2010,Tracy McGrady,SG,30,NYK,24,627,84,216,15,62,69,154,43,57,226
2010,Dominic McGuire,SF,24,TOT,51,307,19,52,0,0,19,52,0,7,38
2010,Dominic McGuire,SF,24,WAS,41,240,15,40,0,0,15,40,0,5,30
2010,Dominic McGuire,SF,24,SAC,10,67,4,12,0,0,4,12,0,2,8
2010,Josh McRoberts,C,22,IND,42,524,76,146,8,23,68,123,19,38,179
2010,Jodie Meeks,SG,22,TOT,60,719,104,268,42,132,62,136,31,39,281
2010,Jodie Meeks,SG,22,MIL,41,486,64,177,23,82,41,95,18,21,169
2010,Jodie Meeks,SG,22,PHI,19,233,40,91,19,50,21,41,13,18,112
2010,Pops Mensah-Bonsu,PF,26,TOT,20,120,13,33,0,0,13,33,13,24,39
2010,Pops Mensah-Bonsu,PF,26,HOU,4,13,1,4,0,0,1,4,3,6,5
2010,Pops Mensah-Bonsu,PF,26,TOR,16,107,12,29,0,0,12,29,10,18,34
2010,C.J. Miles,SF,22,UTA,63,1497,241,562,74,217,167,345,66,95,622
2010,Darko Milicic,C,24,TOT,32,685,100,204,0,1,100,203,15,28,215
2010,Darko Milicic,C,24,NYK,8,71,8,17,0,0,8,17,0,0,16
2010,Darko Milicic,C,24,MIN,24,614,92,187,0,1,92,186,15,28,199
2010,Andre Miller,PG,33,POR,82,2500,404,908,16,80,388,828,322,392,1146
2010,Brad Miller,C,33,CHI,82,1950,250,581,37,132,213,449,182,220,719
2010,Mike Miller,SG,29,WAS,54,1805,217,433,82,171,135,262,70,85,586
2010,Patty Mills,PG,21,POR,10,38,10,24,2,4,8,20,4,7,26
2010,Paul Millsap,PF,24,UTA,82,2277,385,716,1,9,384,707,183,264,954
2010,Nazr Mohammed,C,32,CHA,58,984,189,342,0,0,189,342,81,125,459
2010,Jamario Moon,SF,29,CLE,61,1052,114,247,32,100,82,147,36,45,296
2010,Mikki Moore,C,34,GSW,23,406,54,90,0,0,54,90,7,11,115
2010,Randolph Morris,PF,24,ATL,28,124,23,41,0,0,23,41,16,27,62
2010,Adam Morrison,SF,25,LAL,31,241,32,85,5,21,27,64,5,8,74
2010,Anthony Morrow,SG,24,GSW,69,2018,329,703,140,307,189,396,101,114,899
2010,Byron Mullens,PF,20,OKC,13,54,7,19,0,0,7,19,0,0,14
2010,Troy Murphy,PF,29,IND,72,2344,384,813,128,333,256,480,154,193,1050
2010,Ronald Murray,SG,30,TOT,75,1673,268,683,69,221,199,462,141,194,746
2010,Ronald Murray,SG,30,CHA,46,993,160,411,41,131,119,280,93,131,454
2010,Ronald Murray,SG,30,CHI,29,680,108,272,28,90,80,182,48,63,292
2010,Eduardo Najera,PF,33,TOT,46,685,62,146,19,64,43,82,14,24,157
2010,Eduardo Najera,PF,33,NJN,13,204,20,53,3,17,17,36,6,12,49
2010,Eduardo Najera,PF,33,DAL,33,481,42,93,16,47,26,46,8,12,108
2010,Steve Nash,PG,35,PHO,81,2660,499,985,124,291,375,694,211,225,1333
2010,Jameer Nelson,PG,27,ORL,65,1860,317,706,86,226,231,480,98,116,818
2010,Rasho Nesterovic,C,33,TOR,42,413,81,149,0,0,81,149,1,5,163
2010,Joakim Noah,C,24,CHI,64,1925,262,520,0,0,262,520,163,219,687
2010,Andres Nocioni,SF,30,SAC,75,1477,234,587,96,249,138,338,71,99,635
2010,Steve Novak,SF,26,LAC,54,362,42,108,22,71,20,37,7,9,113
2010,Dirk Nowitzki,PF,31,DAL,81,3039,720,1496,51,121,669,1375,536,586,2027
2010,Patrick O'Bryant,C,23,TOR,11,51,8,15,0,1,8,14,3,6,19
2010,Jermaine O'Neal,C,31,MIA,70,1991,394,745,0,2,394,743,162,225,950
2010,Shaquille O'Neal*,C,37,CLE,53,1240,262,463,0,1,262,462,112,226,636
2010,Fabricio Oberto,C,34,WAS,57,650,35,56,0,0,35,56,13,17,83
2010,Greg Oden,C,22,POR,21,502,92,152,0,0,92,152,49,64,233
2010,Lamar Odom,PF,30,LAL,82,2585,342,739,58,182,284,557,140,202,882
2010,Emeka Okafor,C,27,NOH,82,2370,348,656,0,0,348,656,154,274,850
2010,Mehmet Okur,C,30,UTA,73,2149,355,775,82,213,273,562,196,239,988
2010,Kevin Ollie,PG,37,OKC,25,263,18,45,0,1,18,44,8,8,44
2010,Travis Outlaw,SF,25,TOT,34,730,110,281,40,105,70,176,49,59,309
2010,Travis Outlaw,SF,25,POR,11,231,38,101,12,31,26,70,21,24,109
2010,Travis Outlaw,SF,25,LAC,23,499,72,180,28,74,44,106,28,35,200
2010,Zaza Pachulia,C,25,ATL,78,1089,120,246,0,4,120,242,93,143,333
2010,Jannero Pargo,PG,30,CHI,63,829,132,381,38,138,94,243,42,45,344
2010,Anthony Parker,SG,34,CLE,81,2289,206,475,108,261,98,214,75,95,595
2010,Tony Parker,PG,27,SAS,56,1728,349,716,10,34,339,682,186,246,894
2010,Chris Paul,PG,24,NOH,45,1712,314,637,52,127,262,510,161,190,841
2010,Sasha Pavlovic,SF,26,MIN,71,877,109,300,35,118,74,182,10,26,263
2010,Oleksiy Pecherov,C,24,MIN,44,447,77,188,14,52,63,136,29,32,197
2010,Kendrick Perkins,C,25,BOS,78,2154,314,522,0,3,314,519,163,280,791
2010,Morris Peterson,SG,32,NOH,46,973,116,301,62,171,54,130,33,54,327
2010,Johan Petro,C,24,DEN,36,436,54,101,0,1,54,100,14,21,122
2010,Paul Pierce,SF,32,BOS,71,2411,409,867,109,263,300,604,369,433,1296
2010,Mickael Pietrus,SF,27,ORL,75,1687,233,539,116,306,117,233,69,109,651
2010,James Posey,SF,33,NOH,77,1731,126,345,81,242,45,103,66,80,399
2010,Leon Powe,SF,26,CLE,20,236,21,49,0,0,21,49,37,63,79
2010,Josh Powell,PF,27,LAL,63,581,71,194,7,16,64,178,20,31,169
2010,A.J. Price,PG,23,IND,56,865,145,354,60,174,85,180,60,75,410
2010,Ronnie Price,PG,26,UTA,60,806,98,242,18,63,80,179,41,59,255
2010,Tayshaun Prince,SF,29,DET,49,1664,282,580,27,73,255,507,70,98,661
2010,Joel Przybilla,C,30,POR,30,681,45,86,0,0,45,86,33,51,123
2010,Chris Quinn,PG,26,NJN,25,223,20,56,10,32,10,24,6,6,56
2010,Vladimir Radmanovic,PF,29,TOT,41,891,103,273,30,108,73,165,20,27,256
2010,Vladimir Radmanovic,PF,29,CHA,8,133,14,42,7,22,7,20,4,6,39
2010,Vladimir Radmanovic,PF,29,GSW,33,758,89,231,23,86,66,145,16,21,217
2010,Anthony Randolph,C,20,GSW,33,749,137,309,1,5,136,304,109,136,384
2010,Shavlik Randolph,PF,26,TOT,6,53,6,18,0,0,6,18,2,2,14
2010,Shavlik Randolph,PF,26,MIA,3,47,5,15,0,0,5,15,0,0,10
2010,Shavlik Randolph,PF,26,POR,3,6,1,3,0,0,1,3,2,2,4
2010,Zach Randolph,PF,28,MEM,81,3051,652,1336,15,52,637,1284,362,465,1681
2010,Theo Ratliff,C,36,TOT,49,807,70,152,0,0,70,152,38,50,178
2010,Theo Ratliff,C,36,SAS,21,183,16,36,0,0,16,36,2,4,34
2010,Theo Ratliff,C,36,CHA,28,624,54,116,0,0,54,116,36,46,144
2010,Michael Redd,SG,30,MIL,18,492,75,213,18,60,57,153,47,66,215
2010,J.J. Redick,SG,25,ORL,82,1808,243,553,111,274,132,279,191,222,788
2010,Chris Richard,PF,25,CHI,18,224,15,29,0,0,15,29,7,11,37
2010,Jason Richardson,SG,29,PHO,79,2485,473,998,157,400,316,598,136,184,1239
2010,Quentin Richardson,SF,29,MIA,76,2082,242,561,142,358,100,203,52,71,678
2010,Luke Ridnour,PG,28,MIL,82,1759,328,686,69,181,259,505,127,140,852
2010,Nate Robinson,PG,25,TOT,56,1115,215,493,87,223,128,270,50,67,567
2010,Nate Robinson,PG,25,NYK,30,733,152,336,51,136,101,200,42,54,397
2010,Nate Robinson,PG,25,BOS,26,382,63,157,36,87,27,70,8,13,170
2010,Sergio Rodriguez,PG,23,TOT,66,1048,167,351,32,91,135,260,68,93,434
2010,Sergio Rodriguez,PG,23,SAC,39,517,88,190,15,42,73,148,43,62,234
2010,Sergio Rodriguez,PG,23,NYK,27,531,79,161,17,49,62,112,25,31,200
2010,Rajon Rondo,PG,23,BOS,81,2963,459,904,17,80,442,824,175,282,1110
2010,Derrick Rose,PG,21,CHI,78,2871,672,1373,16,60,656,1313,259,338,1619
2010,Quinton Ross,SF-SG,28,TOT,52,562,40,111,4,21,36,90,8,14,92
2010,Quinton Ross,SF,28,DAL,27,301,23,56,3,13,20,43,5,8,54
2010,Quinton Ross,SG,28,WAS,25,261,17,55,1,8,16,47,3,6,38
2010,Brandon Roy,SG,25,POR,65,2419,491,1038,73,221,418,817,343,440,1398
2010,Brandon Rush,SG,24,IND,82,2491,297,702,124,302,173,400,56,89,774
2010,Kareem Rush,SG,29,LAC,7,58,4,11,1,3,3,8,0,0,9
2010,John Salmons,SG,30,TOT,81,2824,437,991,118,309,319,682,253,305,1245
2010,John Salmons,SG,30,CHI,51,1695,230,548,73,192,157,356,116,147,649
2010,John Salmons,SG,30,MIL,30,1129,207,443,45,117,162,326,137,158,596
2010,Brian Scalabrine,PF,31,BOS,52,472,29,85,16,49,13,36,4,6,78
2010,Luis Scola,PF,29,HOU,82,2671,560,1090,1,5,559,1085,208,267,1329
2010,Thabo Sefolosha,SG,25,OKC,82,2348,194,441,41,131,153,310,60,89,489
2010,Ramon Sessions,PG,23,MIN,82,1732,253,555,1,15,252,540,167,233,674
2010,Bobby Simmons,PF,29,NJN,23,395,42,117,20,63,22,54,18,20,122
2010,James Singleton,PF-SF,28,TOT,57,977,97,254,7,37,90,217,53,62,254
2010,James Singleton,SF,28,DAL,25,211,24,64,5,22,19,42,6,6,59
2010,James Singleton,PF,28,WAS,32,766,73,190,2,15,71,175,47,56,195
2010,Brian Skinner,PF,33,LAC,16,123,10,25,0,0,10,25,6,8,26
2010,Craig Smith,PF,26,LAC,75,1232,226,397,1,5,225,392,132,208,585
2010,J.R. Smith,SG,24,DEN,75,2082,428,1033,158,467,270,566,142,201,1156
2010,Jason Smith,PF,23,PHI,56,658,75,174,10,29,65,145,29,42,189
2010,Joe Smith,PF,34,ATL,64,592,77,193,1,7,76,186,39,48,194
2010,Josh Smith,PF,24,ATL,81,2871,504,999,0,7,504,992,261,422,1269
2010,Darius Songaila,C,31,NOH,75,1410,241,488,1,6,240,482,60,74,543
2010,Marreese Speights,C,22,PHI,62,1016,212,444,0,5,212,439,108,145,532
2010,Jerry Stackhouse,SG,35,MIL,42,855,129,316,45,130,84,186,55,69,358
2010,DeShawn Stevenson,SG,28,TOT,64,883,46,163,19,87,27,76,25,35,136
2010,DeShawn Stevenson,SG,28,WAS,40,616,29,103,11,62,18,41,18,25,87
2010,DeShawn Stevenson,SG,28,DAL,24,267,17,60,8,25,9,35,7,10,49
2010,Peja Stojakovic,SF,32,NOH,62,1947,278,688,132,352,146,336,96,107,784
2010,Amar'e Stoudemire,PF,27,PHO,82,2838,704,1264,1,6,703,1258,487,632,1896
2010,Rodney Stuckey,PG,23,DET,73,2499,449,1109,18,79,431,1030,299,359,1215
2010,DaJuan Summers,SF,22,DET,44,405,46,130,15,42,31,88,27,38,134
2010,Jermaine Taylor,SG,23,HOU,31,303,45,119,5,22,40,97,33,46,128
2010,Jeff Teague,PG,21,ATL,71,719,90,227,7,32,83,195,41,49,228
2010,Sebastian Telfair,PG,24,TOT,43,659,83,201,13,56,70,145,29,37,208
2010,Sebastian Telfair,PG,24,LAC,39,582,67,166,11,47,56,119,24,31,169
2010,Sebastian Telfair,PG,24,CLE,4,77,16,35,2,9,14,26,5,6,39
2010,Garrett Temple,SG,23,TOT,27,334,44,101,13,37,31,64,35,50,136
2010,Garrett Temple,SG,23,HOU,9,118,13,29,3,12,10,17,16,24,45
2010,Garrett Temple,SG,23,SAC,5,23,3,8,0,2,3,6,5,5,11
2010,Garrett Temple,SG,23,SAS,13,193,28,64,10,23,18,41,14,21,80
2010,Jason Terry,SG,32,DAL,77,2540,456,1041,136,373,320,668,232,268,1280
2010,Hasheem Thabeet,C,22,MEM,68,883,77,131,0,0,77,131,54,93,208
2010,Etan Thomas,C,31,OKC,23,321,31,68,0,0,31,68,13,22,75
2010,Kenny Thomas,PF,32,SAC,26,313,17,35,0,0,17,35,7,12,41
2010,Kurt Thomas,C,37,MIL,70,1049,99,208,0,0,99,208,12,15,210
2010,Tim Thomas,SF,32,DAL,18,285,49,106,16,43,33,63,21,24,135
2010,Tyrus Thomas,PF-C,23,TOT,54,1220,194,420,0,3,194,417,120,175,508
2010,Tyrus Thomas,PF,23,CHI,29,678,99,205,0,1,99,204,58,90,256
2010,Tyrus Thomas,C,23,CHA,25,542,95,215,0,2,95,213,62,85,252
2010,Jason Thompson,C,23,SAC,75,2357,370,784,1,10,369,774,198,277,939
2010,Al Thornton,SF,26,TOT,75,2079,320,676,11,31,309,645,153,211,804
2010,Al Thornton,SF,26,LAC,51,1405,220,460,5,14,215,446,103,139,548
2010,Al Thornton,SF,26,WAS,24,674,100,216,6,17,94,199,50,72,256
2010,Marcus Thornton,SG,22,NOH,73,1872,398,883,117,313,281,570,144,177,1057
2010,Jamaal Tinsley,PG,31,MEM,38,589,52,140,7,39,45,101,22,27,133
2010,Anthony Tolliver,PF,24,TOT,46,1427,193,449,50,152,143,297,103,134,539
2010,Anthony Tolliver,PF,24,POR,2,4,0,1,0,1,0,0,0,0,0
2010,Anthony Tolliver,PF,24,GSW,44,1423,193,448,50,151,143,297,103,134,539
2010,Alando Tucker,SF,25,TOT,15,96,17,39,1,7,16,32,16,21,51
2010,Alando Tucker,SF,25,PHO,11,71,13,30,1,7,12,23,16,21,43
2010,Alando Tucker,SF,25,MIN,4,25,4,9,0,0,4,9,0,0,8
2010,Ronny Turiaf,C,27,GSW,42,872,85,146,0,1,85,145,37,78,207
2010,Hedo Turkoglu,SF,30,TOR,74,2272,276,674,108,289,168,385,175,226,835
2010,Ime Udoka,SG,32,SAC,69,944,91,241,26,91,65,150,42,57,250
2010,Beno Udrih,PG,27,SAC,79,2477,415,841,75,199,340,642,118,141,1023
2010,Roko Ukic,PG,25,MIL,13,97,14,30,3,12,11,18,9,11,40
2010,Anderson Varejao,PF,27,CLE,76,2166,267,467,1,5,266,462,116,175,651
2010,Charlie Villanueva,PF,25,DET,78,1848,363,827,99,282,264,545,106,130,931
2010,Sasha Vujacic,SG,25,LAL,67,575,66,164,25,81,41,83,28,33,185
2010,Dwyane Wade,SG,28,MIA,77,2792,719,1511,73,243,646,1268,534,702,2045
2010,Henry Walker,SG-SF,22,TOT,35,768,120,232,50,116,70,116,39,49,329
2010,Henry Walker,SF,22,BOS,8,29,3,6,0,0,3,6,2,2,8
2010,Henry Walker,SG,22,NYK,27,739,117,226,50,116,67,110,37,47,321
2010,Ben Wallace,C,35,DET,69,1975,158,292,0,2,158,290,65,160,381
2010,Gerald Wallace,SF,27,CHA,76,3119,456,943,52,140,404,803,422,544,1386
2010,Rasheed Wallace,C,35,BOS,79,1780,266,650,82,290,184,360,96,125,710
2010,Luke Walton,SF,29,LAL,29,272,30,84,7,17,23,67,2,4,69
2010,Hakim Warrick,PF,27,TOT,76,1557,265,550,1,7,264,543,202,274,733
2010,Hakim Warrick,PF,27,MIL,48,1024,182,378,1,6,181,372,125,172,490
2010,Hakim Warrick,PF,27,CHI,28,533,83,172,0,1,83,171,77,102,243
2010,C.J. Watson,PG,25,GSW,65,1788,247,528,45,145,202,383,128,166,667
2010,Earl Watson,PG,30,IND,79,2322,223,524,53,184,170,340,120,169,619
2010,Kyle Weaver,SG,23,OKC,12,144,12,33,7,19,5,14,5,6,36
2010,Martell Webster,SF,23,POR,82,2005,259,639,124,332,135,307,126,155,768
2010,Sonny Weems,SG,23,TOR,69,1368,236,458,2,15,234,443,44,64,518
2010,David West,PF,29,NOH,81,2949,619,1226,7,27,612,1199,296,342,1541
2010,Delonte West,SG,26,CLE,60,1500,194,436,25,77,169,359,115,142,528
2010,Mario West,SG,25,ATL,39,142,12,21,0,1,12,20,6,10,30
2010,Russell Westbrook,PG,21,OKC,82,2813,485,1160,23,104,462,1056,329,422,1322
2010,D.J. White,PF,23,OKC,12,102,25,41,0,0,25,41,9,10,59
2010,Chris Wilcox,PF,27,DET,34,441,63,120,0,0,63,120,26,52,152
2010,Damien Wilkins,SF,30,MIN,80,1585,165,381,18,61,147,320,103,129,451
2010,Mike Wilks,PG,30,OKC,4,59,6,12,2,3,4,9,2,4,16
2010,Deron Williams,PG,25,UTA,76,2802,494,1053,96,259,398,794,335,418,1419
2010,Jason Williams,PG,34,ORL,82,1703,189,426,84,221,105,205,31,41,493
2010,Jawad Williams,PG,26,CLE,54,742,81,206,30,93,51,113,32,45,224
2010,Lou Williams,PG,23,PHI,64,1912,318,677,70,206,248,471,192,233,898
2010,Marcus Williams,PG,24,MEM,62,872,104,271,24,81,80,190,37,55,269
2010,Marvin Williams,SF,23,ATL,81,2468,302,664,40,132,262,532,176,215,820
2010,Mo Williams,PG,27,CLE,69,2359,378,855,159,371,219,484,177,198,1092
2010,Reggie Williams,SF,23,GSW,24,782,140,283,33,92,107,191,52,62,365
2010,Sean Williams,PF,23,NJN,20,227,21,49,0,1,21,48,10,19,52
2010,Shelden Williams,PF,26,BOS,54,597,63,121,0,1,63,120,75,98,201
2010,Terrence Williams,SF,22,NJN,78,1764,261,651,31,100,230,551,103,144,656
2010,Metta World,SF,30,LAL,77,2605,306,740,105,296,201,444,128,186,845
2010,Antoine Wright,SF,25,TOR,67,1392,162,399,58,173,104,226,53,77,435
2010,Dorell Wright,SF,24,MIA,72,1496,194,419,61,157,133,262,61,69,510
2010,Julian Wright,SF,22,NOH,68,871,116,232,2,6,114,226,25,41,259
2010,Nick Young,SG,24,WAS,74,1421,233,558,69,170,164,388,104,130,639
2010,Sam Young,SF,24,MEM,80,1321,224,497,11,56,213,441,136,175,595
2010,Thaddeus Young,PF,21,PHI,67,2145,382,813,48,138,334,675,114,165,926
,,,,,,,,,,,,,,,
2011,Jeff Adrien,PF,24,GSW,23,196,23,54,0,0,23,54,11,19,57
2011,Arron Afflalo,SG,25,DEN,69,2324,312,627,105,248,207,379,138,163,867
2011,Maurice Ager,SG,26,MIN,4,29,6,11,3,4,3,7,0,0,15
2011,Alexis Ajinca,C,22,TOT,34,340,59,133,12,34,47,99,13,18,143
2011,Alexis Ajinca,C,22,DAL,10,75,12,32,3,7,9,25,2,3,29
2011,Alexis Ajinca,C,22,TOR,24,265,47,101,9,27,38,74,11,15,114
2011,Solomon Alabi,C,22,TOR,12,59,3,15,0,0,3,15,0,2,6
2011,Cole Aldrich,C,22,OKC,18,142,8,15,0,0,8,15,2,4,18
2011,LaMarcus Aldridge,PF,25,POR,81,3211,707,1415,4,23,703,1392,351,444,1769
2011,Malik Allen,PF,32,ORL,18,178,11,31,0,0,11,31,1,2,23
2011,Ray Allen,SG,35,BOS,80,2890,480,978,168,378,312,600,193,219,1321
2011,Tony Allen,SG,29,MEM,72,1494,251,492,4,23,247,469,137,182,643
2011,Al-Farouq Aminu,SF,20,LAC,81,1452,160,406,45,143,115,263,92,119,457
2011,Lou Amundson,PF,28,GSW,46,691,83,183,0,0,83,183,34,87,200
2011,Chris Andersen,C,32,DEN,45,732,82,137,0,1,82,136,86,135,250
2011,David Andersen,PF,30,TOT,40,373,56,121,8,23,48,98,14,22,134
2011,David Andersen,PF,30,TOR,11,150,23,47,3,10,20,37,7,7,56
2011,David Andersen,PF,30,NOH,29,223,33,74,5,13,28,61,7,15,78
2011,James Anderson,SF,21,SAS,26,286,31,81,18,46,13,35,14,18,94
2011,Ryan Anderson,PF,22,ORL,64,1424,226,525,134,341,92,184,95,117,681
2011,Carmelo Anthony,SF,26,TOT,77,2751,684,1503,95,251,589,1252,507,605,1970
2011,Carmelo Anthony,SF,26,DEN,50,1774,437,967,42,126,395,841,343,417,1259
2011,Carmelo Anthony,SF,26,NYK,27,977,247,536,53,125,194,411,164,188,711
2011,Joel Anthony,C,28,MIA,75,1463,53,99,0,0,53,99,47,73,153
2011,Gilbert Arenas,PG,29,TOT,70,1796,269,734,97,327,172,407,120,153,755
2011,Gilbert Arenas,PG,29,WAS,21,726,130,330,47,145,83,185,56,67,363
2011,Gilbert Arenas,PG,29,ORL,49,1070,139,404,50,182,89,222,64,86,392
2011,Trevor Ariza,SF,25,NOH,75,2600,303,762,82,271,221,491,138,197,826
2011,Hilton Armstrong,C,26,TOT,53,488,37,76,2,4,35,72,16,33,92
2011,Hilton Armstrong,C,26,WAS,41,412,31,64,1,3,30,61,14,23,77
2011,Hilton Armstrong,C,26,ATL,12,76,6,12,1,1,5,11,2,10,15
2011,Carlos Arroyo,PG,31,TOT,64,1185,120,273,31,69,89,204,39,47,310
2011,Carlos Arroyo,PG,31,MIA,49,995,109,238,28,64,81,174,28,35,274
2011,Carlos Arroyo,PG,31,BOS,15,190,11,35,3,5,8,30,11,12,36
2011,Darrell Arthur,PF,22,MEM,80,1609,310,624,0,6,310,618,109,134,729
2011,Omer Asik,C,24,CHI,82,989,78,141,0,0,78,141,73,145,229
2011,D.J. Augustin,PG,23,CHA,82,2757,399,958,111,333,288,625,269,297,1178
2011,Luke Babbitt,SF,21,POR,24,137,15,55,3,16,12,39,3,9,36
2011,Renaldo Balkman,SF,26,TOT,8,62,6,13,1,2,5,11,3,4,16
2011,Renaldo Balkman,SF,26,DEN,5,44,5,9,0,0,5,9,3,4,13
2011,Renaldo Balkman,SF,26,NYK,3,18,1,4,1,2,0,2,0,0,3
2011,Marcus Banks,PG,29,TOR,3,22,0,2,0,0,0,2,6,8,6
2011,Leandro Barbosa,SG,28,TOR,58,1395,294,653,72,213,222,440,109,137,769
2011,J.J. Barea,PG,26,DAL,81,1669,285,649,66,189,219,460,133,157,769
2011,Andrea Bargnani,C,25,TOR,66,2353,525,1173,77,223,448,950,287,350,1414
2011,Matt Barnes,SF,30,LAL,53,1020,131,279,34,107,97,172,60,77,356
2011,Earl Barron,C,29,TOT,21,305,32,99,0,0,32,99,15,24,79
2011,Earl Barron,C,29,PHO,12,183,12,51,0,0,12,51,12,20,36
2011,Earl Barron,C,29,MIL,7,85,17,37,0,0,17,37,2,2,36
2011,Earl Barron,C,29,POR,2,37,3,11,0,0,3,11,1,2,7
2011,Brandon Bass,PF,25,ORL,76,1980,332,645,0,2,332,643,190,233,854
2011,Tony Battie,C,34,PHI,38,377,45,96,2,3,43,93,8,14,100
2011,Shane Battier,SF,32,TOT,82,2375,229,509,102,267,127,242,64,93,624
2011,Shane Battier,SF,32,HOU,59,1818,186,408,88,225,98,183,49,76,509
2011,Shane Battier,SF,32,MEM,23,557,43,101,14,42,29,59,15,17,115
2011,Nicolas Batum,SF,22,POR,80,2522,367,807,118,342,249,465,138,164,990
2011,Jerryd Bayless,PG,22,TOT,71,1496,218,517,49,146,169,371,166,206,651
2011,Jerryd Bayless,PG,22,NOH,11,149,17,49,3,14,14,35,13,17,50
2011,Jerryd Bayless,PG,22,TOR,60,1347,201,468,46,132,155,336,153,189,601
2011,Michael Beasley,SF,22,MIN,73,2361,561,1246,60,164,501,1082,219,291,1401
2011,Rodrigue Beaubois,PG,22,DAL,28,496,94,223,25,83,69,140,23,30,236
2011,Marco Belinelli,SG,24,NOH,80,1957,302,691,134,324,168,367,98,125,836
2011,Charlie Bell,SG,31,GSW,19,171,12,43,6,21,6,22,2,4,32
2011,Raja Bell,SG,34,UTA,68,2097,191,467,68,193,123,274,91,102,541
2011,Mike Bibby,PG,32,TOT,80,2285,248,576,153,348,95,228,39,62,688
2011,Mike Bibby,PG,32,ATL,56,1674,192,441,113,256,79,185,29,46,526
2011,Mike Bibby,PG,32,WAS,2,29,1,9,0,4,1,5,0,0,2
2011,Mike Bibby,PG,32,MIA,22,582,55,126,40,88,15,38,10,16,160
2011,Andris Biedrins,C,24,GSW,59,1397,142,266,0,0,142,266,10,31,294
2011,Chauncey Billups,PG,34,TOT,72,2310,339,794,146,363,193,431,384,419,1208
2011,Chauncey Billups,PG,34,DEN,51,1646,235,536,105,238,130,298,265,287,840
2011,Chauncey Billups,PG,34,NYK,21,664,104,258,41,125,63,133,119,132,368
2011,DeJuan Blair,PF,21,SAS,81,1734,292,583,0,2,292,581,90,137,674
2011,Steve Blake,PG,30,LAL,79,1581,110,306,73,193,37,113,26,30,319
2011,Andray Blatche,PF,24,WAS,64,2172,426,957,4,18,422,939,220,283,1076
2011,Eric Bledsoe,PG,21,LAC,81,1841,206,486,32,116,174,370,99,133,543
2011,Keith Bogans,SG,30,CHI,82,1461,124,307,90,237,34,70,21,32,359
2011,Andrew Bogut,C,26,MIL,65,2297,367,742,0,4,367,738,96,217,830
2011,Matt Bonner,PF,30,SAS,66,1432,172,371,105,230,67,141,32,43,481
2011,Trevor Booker,PF,23,WAS,65,1063,139,253,0,1,139,252,68,101,346
2011,Carlos Boozer,C,29,CHI,59,1882,431,845,0,0,431,845,171,244,1033
2011,Chris Bosh,PF,26,MIA,77,2795,524,1056,6,25,518,1031,384,471,1438
2011,Earl Boykins,PG,34,MIL,57,862,156,352,27,71,129,281,69,82,408
2011,Craig Brackins,PF,23,PHI,3,33,4,16,0,5,4,11,0,0,8
2011,Avery Bradley,PG,20,BOS,31,162,23,67,0,5,23,62,6,12,52
2011,Elton Brand,PF,31,PHI,81,2809,502,981,0,1,502,980,213,273,1217
2011,Corey Brewer,SF-SG,24,TOT,69,1510,193,488,30,112,163,376,136,192,552
2011,Corey Brewer,SF,24,MIN,56,1362,168,437,26,99,142,338,121,171,483
2011,Corey Brewer,SG,24,DAL,13,148,25,51,4,13,21,38,15,21,69
2011,Ronnie Brewer,SG,25,CHI,81,1781,205,427,6,27,199,400,87,133,503
2011,Jon Brockman,C,23,MIL,63,677,48,94,0,0,48,94,40,59,136
2011,Aaron Brooks,PG,26,TOT,59,1284,220,587,70,236,150,351,124,140,634
2011,Aaron Brooks,PG,26,HOU,34,811,134,387,48,169,86,218,78,83,394
2011,Aaron Brooks,PG,26,PHO,25,473,86,200,22,67,64,133,46,57,240
2011,Derrick Brown,SF,23,TOT,49,576,74,131,5,10,69,121,32,60,185
2011,Derrick Brown,SF,23,CHA,41,488,62,113,2,6,60,107,25,47,151
2011,Derrick Brown,SF,23,NYK,8,88,12,18,3,4,9,14,7,13,34
2011,Kwame Brown,C,28,CHA,66,1714,194,375,0,0,194,375,136,231,524
2011,Shannon Brown,SG,25,LAL,82,1568,273,643,74,212,199,431,92,101,712
2011,Kobe Bryant,SG,32,LAL,82,2779,740,1639,115,356,625,1283,483,583,2078
2011,Chase Budinger,SF,22,HOU,78,1738,279,656,89,274,190,382,118,138,765
2011,Caron Butler,SF,30,DAL,29,867,170,378,28,65,142,313,68,88,436
2011,Rasual Butler,SG,31,TOT,47,770,79,237,46,136,33,101,18,27,222
2011,Rasual Butler,SG,31,LAC,41,744,73,226,42,129,31,97,18,27,206
2011,Rasual Butler,SG,31,CHI,6,26,6,11,4,7,2,4,0,0,16
2011,Andrew Bynum,C,23,LAL,54,1500,237,413,0,0,237,413,138,209,612
2011,Will Bynum,PG,28,DET,61,1125,182,406,16,50,166,356,102,122,482
2011,Jose Calderon,PG,29,TOR,68,2102,262,596,57,156,205,440,88,103,669
2011,Marcus Camby,C,36,POR,59,1540,117,294,0,1,117,293,43,70,277
2011,Derrick Caracter,C,22,LAL,41,215,32,66,0,0,32,66,17,23,81
2011,Brian Cardinal,SF,33,DAL,56,618,43,100,42,87,1,13,17,18,145
2011,Rodney Carney,SF,26,TOT,27,336,46,110,17,38,29,72,18,27,127
2011,Rodney Carney,SF,26,GSW,25,331,45,107,17,37,28,70,18,27,125
2011,Rodney Carney,SF,26,MEM,2,5,1,3,0,1,1,2,0,0,2
2011,DeMarre Carroll,PF,24,TOT,12,50,4,12,0,0,4,12,2,2,10
2011,DeMarre Carroll,PF,24,MEM,7,39,4,9,0,0,4,9,2,2,10
2011,DeMarre Carroll,PF,24,HOU,5,11,0,3,0,0,0,3,0,0,0
2011,Matt Carroll,SG,30,CHA,54,582,89,199,17,46,72,153,40,52,235
2011,Anthony Carter,PG,35,TOT,33,463,45,106,12,40,33,66,8,8,110
2011,Anthony Carter,PG,35,DEN,14,153,10,30,4,12,6,18,2,2,26
2011,Anthony Carter,PG,35,NYK,19,310,35,76,8,28,27,48,6,6,84
2011,Vince Carter,SG,34,TOT,73,2051,389,891,116,321,273,570,128,173,1022
2011,Vince Carter,SG,34,ORL,22,664,125,266,27,78,98,188,56,75,333
2011,Vince Carter,SG,34,PHO,51,1387,264,625,89,243,175,382,72,98,689
2011,Omri Casspi,SF,22,SAC,71,1702,225,546,92,247,133,299,68,101,610
2011,Mario Chalmers,PG,24,MIA,70,1579,155,388,83,231,72,157,54,62,447
2011,Tyson Chandler,C,28,DAL,74,2059,266,407,0,0,266,407,216,295,748
2011,Wilson Chandler,SF,23,TOT,72,2401,429,953,112,320,317,633,130,161,1100
2011,Wilson Chandler,SF,23,NYK,51,1759,328,712,86,245,242,467,96,119,838
2011,Wilson Chandler,SF,23,DEN,21,642,101,241,26,75,75,166,34,42,262
2011,Josh Childress,SG,27,PHO,54,894,121,214,1,16,120,198,29,59,272
2011,Earl Clark,SF,23,TOT,42,464,68,158,0,5,68,153,27,47,163
2011,Earl Clark,SF,23,PHO,9,72,12,31,0,0,12,31,5,10,29
2011,Earl Clark,SF,23,ORL,33,392,56,127,0,5,56,122,22,37,134
2011,Jarron Collins,C,32,TOT,28,181,6,21,0,0,6,21,7,10,19
2011,Jarron Collins,C,32,LAC,23,157,5,15,0,0,5,15,7,10,17
2011,Jarron Collins,C,32,POR,5,24,1,6,0,0,1,6,0,0,2
2011,Jason Collins,C,32,ATL,49,593,34,71,1,1,33,70,27,41,96
2011,Sherron Collins,PG,23,CHA,20,66,7,25,2,10,5,15,1,1,17
2011,Darren Collison,PG,23,IND,79,2360,398,870,41,124,357,746,202,232,1039
2011,Nick Collison,C,30,OKC,71,1524,137,242,0,0,137,242,55,73,329
2011,Mike Conley,PG,23,MEM,81,2872,423,953,80,217,343,736,181,247,1107
2011,Brian Cook,PF,30,LAC,40,447,72,170,34,79,38,91,15,24,193
2011,Daequan Cook,SG,23,OKC,43,598,79,181,65,154,14,27,16,20,239
2011,Marcus Cousin,C,24,UTA,4,18,2,3,0,0,2,3,0,0,4
2011,DeMarcus Cousins,C,20,SAC,81,2309,432,1004,3,18,429,986,276,402,1143
2011,Jamal Crawford,SG,30,ATL,76,2297,368,874,119,349,249,525,222,260,1077
2011,Jordan Crawford,SG,22,TOT,42,1027,192,500,33,128,159,372,73,84,490
2011,Jordan Crawford,SG,22,ATL,16,160,27,77,9,27,18,50,4,6,67
2011,Jordan Crawford,SG,22,WAS,26,867,165,423,24,101,141,322,69,78,423
2011,Dante Cunningham,PF,23,TOT,78,1637,218,472,1,13,217,459,45,62,482
2011,Dante Cunningham,PF,23,POR,56,1108,126,291,0,4,126,287,32,45,284
2011,Dante Cunningham,PF,23,CHA,22,529,92,181,1,9,91,172,13,17,198
2011,Stephen Curry,PG,22,GSW,74,2489,505,1053,151,342,354,711,212,227,1373
2011,Samuel Dalembert,C,29,SAC,80,1938,268,567,0,2,268,565,108,148,644
2011,Erick Dampier,C,35,MIA,51,815,52,89,0,1,52,88,24,44,128
2011,Antonio Daniels,PG,35,PHI,4,35,2,5,0,2,2,3,2,2,6
2011,Marquis Daniels,SF,30,BOS,49,938,114,232,4,21,110,211,39,57,271
2011,Baron Davis,PG,31,TOT,58,1649,289,693,81,239,208,454,101,131,760
2011,Baron Davis,PG,31,LAC,43,1269,214,515,45,152,169,363,79,104,552
2011,Baron Davis,PG,31,CLE,15,380,75,178,36,87,39,91,22,27,208
2011,Ed Davis,PF,21,TOR,65,1602,215,373,0,0,215,373,71,128,501
2011,Glen Davis,C,25,BOS,78,2298,359,801,2,15,357,786,195,265,915
2011,Austin Daye,SF,22,DET,72,1446,193,471,69,172,124,299,82,108,537
2011,Carlos Delfino,SF,28,MIL,49,1590,200,513,105,284,95,229,60,75,565
2011,Luol Deng,SF,25,CHI,82,3208,531,1155,115,333,416,822,253,336,1430
2011,DeMar DeRozan,SG,21,TOR,82,2851,539,1154,5,52,534,1102,327,402,1410
2011,Boris Diaw,PF,28,CHA,82,2778,381,774,78,226,303,548,84,123,924
2011,Ike Diogu,PF,27,LAC,36,470,83,148,0,0,83,148,41,62,207
2011,DeSagana Diop,C,29,CHA,16,181,8,24,0,0,8,24,4,11,20
2011,Keyon Dooling,PG,30,MIL,80,1757,206,519,81,234,125,285,78,94,571
2011,Joey Dorsey,C,27,TOR,43,522,52,99,0,0,52,99,31,65,135
2011,Toney Douglas,SG,24,NYK,81,1971,314,755,143,383,171,372,85,107,856
2011,Chris Douglas-Roberts,SF,24,MIL,44,884,117,273,15,46,102,227,74,89,323
2011,Zabian Dowdell,PG,26,PHO,24,292,51,125,3,10,48,115,16,17,121
2011,Goran Dragic,PG,24,TOT,70,1234,192,441,56,155,136,286,83,133,523
2011,Goran Dragic,PG,24,PHO,48,856,133,316,28,101,105,215,59,97,353
2011,Goran Dragic,PG,24,HOU,22,378,59,125,28,54,31,71,24,36,170
2011,Jared Dudley,SF,25,PHO,82,2140,300,629,105,253,195,376,162,218,867
2011,Chris Duhon,PG,28,ORL,51,774,49,129,13,52,36,77,14,25,125
2011,Tim Duncan,C,34,SAS,76,2156,419,838,0,4,419,834,184,257,1022
2011,Mike Dunleavy,SG,30,IND,61,1683,240,520,102,254,138,266,100,125,682
2011,Ronald Dupree,SF,30,TOR,3,13,1,4,0,1,1,3,0,0,2
2011,Kevin Durant,SF,22,OKC,78,3038,711,1538,145,414,566,1124,594,675,2161
2011,Devin Ebanks,SG,21,LAL,20,118,21,51,2,5,19,46,18,23,62
2011,Wayne Ellington,SG,23,MIN,62,1181,160,397,48,121,112,276,42,53,410
2011,Monta Ellis,SG,25,GSW,80,3227,726,1611,137,379,589,1232,340,431,1929
2011,Francisco Elson,C,34,UTA,62,610,54,113,0,0,54,113,26,31,134
2011,Melvin Ely,C,32,DEN,30,366,28,51,0,0,28,51,13,21,69
2011,Semih Erden,C,24,TOT,41,595,62,111,0,0,62,111,39,60,163
2011,Semih Erden,C,24,BOS,37,531,58,97,0,0,58,97,34,54,150
2011,Semih Erden,C,24,CLE,4,64,4,14,0,0,4,14,5,6,13
2011,Jeremy Evans,SF,23,UTA,49,463,76,115,0,1,76,114,26,37,178
2011,Maurice Evans,SF,32,TOT,73,1549,177,424,55,167,122,257,52,58,461
2011,Maurice Evans,SF,32,ATL,47,837,79,201,28,89,51,112,24,28,210
2011,Maurice Evans,SF,32,WAS,26,712,98,223,27,78,71,145,28,30,251
2011,Reggie Evans,PF,30,TOR,30,798,42,103,0,1,42,102,48,88,132
2011,Tyreke Evans,SG,21,SAC,57,2107,382,933,43,148,339,785,205,266,1012
2011,Patrick Ewing,SF,26,NOH,7,19,0,5,0,2,0,3,3,4,3
2011,Christian Eyenga,SF,21,CLE,44,947,130,306,25,91,105,215,18,28,303
2011,Jordan Farmar,PG,24,NJN,73,1796,255,651,109,304,146,347,82,100,701
2011,Derrick Favors,PF,19,TOT,78,1535,215,416,0,0,215,416,103,173,533
2011,Derrick Favors,PF,19,NJN,56,1091,141,276,0,0,141,276,71,116,353
2011,Derrick Favors,PF,19,UTA,22,444,74,140,0,0,74,140,32,57,180
2011,Raymond Felton,PG-SG,26,TOT,75,2737,427,1005,116,329,311,676,194,241,1164
2011,Raymond Felton,PG,26,NYK,54,2074,339,801,88,268,251,533,157,181,923
2011,Raymond Felton,SG,26,DEN,21,663,88,204,28,61,60,143,37,60,241
2011,Rudy Fernandez,SG,25,POR,78,1821,213,575,116,361,97,214,126,146,668
2011,Kyrylo Fesenko,C,24,UTA,53,456,44,100,0,1,44,99,18,46,106
2011,Landry Fields,SG,22,NYK,82,2541,299,602,86,219,213,383,113,147,797
2011,Derek Fisher,PG,36,LAL,82,2297,206,529,63,159,143,370,83,103,558
2011,Jonny Flynn,PG,21,MIN,53,983,108,296,31,100,77,196,32,42,279
2011,Gary Forbes,SF,25,DEN,63,791,124,273,19,58,105,215,59,87,326
2011,T.J. Ford,PG,27,IND,41,773,91,236,6,32,85,204,35,48,223
2011,Jeff Foster,C,34,IND,56,940,80,167,0,3,80,164,27,48,187
2011,Randy Foye,SG,27,LAC,63,1551,206,531,71,217,135,314,133,149,616
2011,Channing Frye,PF,27,PHO,77,2541,358,829,171,439,187,390,89,107,976
2011,Dan Gadzuric,C-PF,32,TOT,42,463,54,129,0,1,54,128,10,27,118
2011,Dan Gadzuric,C,32,GSW,28,297,37,88,0,1,37,87,5,14,79
2011,Dan Gadzuric,PF,32,NJN,14,166,17,41,0,0,17,41,5,13,39
2011,Sundiata Gaines,PG,24,TOT,24,301,42,105,9,38,33,67,18,36,111
2011,Sundiata Gaines,PG,24,MIN,8,65,7,22,2,6,5,16,5,10,21
2011,Sundiata Gaines,PG,24,TOR,6,90,15,35,3,15,12,20,2,6,35
2011,Sundiata Gaines,PG,24,NJN,10,146,20,48,4,17,16,31,11,20,55
2011,Danilo Gallinari,PF-SF,22,TOT,62,2104,265,640,103,293,162,347,337,391,970
2011,Danilo Gallinari,PF,22,NYK,48,1671,211,509,83,239,128,270,259,290,764
2011,Danilo Gallinari,SF,22,DEN,14,433,54,131,20,54,34,77,78,101,206
2011,Francisco Garcia,SF,29,SAC,58,1386,207,475,81,224,126,251,65,76,560
2011,Kevin Garnett,PF,34,BOS,71,2220,434,822,1,5,433,817,187,217,1056
2011,Marc Gasol,C,26,MEM,81,2586,364,691,3,7,361,684,220,294,951
2011,Pau Gasol,C,30,LAL,82,3037,593,1120,1,3,592,1117,354,430,1541
2011,Rudy Gay,SF,24,MEM,54,2152,409,869,57,144,352,725,194,241,1069
2011,Alonzo Gee,SG,23,TOT,56,1118,121,264,17,51,104,213,72,92,331
2011,Alonzo Gee,SG,23,SAS,5,18,1,3,0,0,1,3,0,0,2
2011,Alonzo Gee,SG,23,WAS,11,127,12,27,0,2,12,25,8,12,32
2011,Alonzo Gee,SG,23,CLE,40,973,108,234,17,49,91,185,64,80,297
2011,Paul George,SG,20,IND,61,1265,179,395,41,138,138,257,77,101,476
2011,Daniel Gibson,SG,24,CLE,67,1865,264,660,118,293,146,367,134,163,780
2011,Taj Gibson,PF,25,CHI,80,1742,234,502,1,8,233,494,100,148,569
2011,Manu Ginobili,SG,33,SAS,80,2426,441,1018,154,441,287,577,357,410,1393
2011,Ryan Gomes,SF,28,LAC,76,2095,207,505,72,211,135,294,61,85,547
2011,Drew Gooden,PF,29,MIL,35,860,156,362,3,20,153,342,81,102,396
2011,Ben Gordon,SG,27,DET,82,2131,339,770,107,266,232,504,136,160,921
2011,Eric Gordon,SG,22,LAC,56,2112,427,949,106,291,321,658,287,348,1247
2011,Marcin Gortat,C,26,TOT,80,2032,338,603,1,4,337,599,140,193,817
2011,Marcin Gortat,C,26,ORL,25,396,44,81,0,0,44,81,12,18,100
2011,Marcin Gortat,C,26,PHO,55,1636,294,522,1,4,293,518,128,175,717
2011,Joey Graham,SF,28,CLE,39,586,82,179,9,30,73,149,29,36,202
2011,Stephen Graham,SG,28,NJN,59,959,81,200,5,21,76,179,31,38,198
2011,Danny Granger,SF,27,IND,79,2763,535,1260,157,407,378,853,395,466,1622
2011,Aaron Gray,C,26,NOH,41,531,56,99,0,0,56,99,17,34,129
2011,Danny Green,SG,23,SAS,8,92,17,35,7,19,10,16,0,0,41
2011,Jeff Green,PF-SF,24,TOT,75,2427,368,820,64,211,304,609,198,244,998
2011,Jeff Green,PF,24,OKC,49,1815,270,618,56,184,214,434,148,181,744
2011,Jeff Green,SF,24,BOS,26,612,98,202,8,27,90,175,50,63,254
2011,Willie Green,SG,29,NOH,77,1674,270,609,54,155,216,454,78,100,672
2011,Donte Greene,SF,22,SAC,69,1127,156,386,45,154,111,232,43,65,400
2011,Orien Greene,SG,28,NJN,3,5,1,2,0,0,1,2,1,2,3
2011,Blake Griffin,PF,21,LAC,82,3112,696,1376,7,24,689,1352,446,695,1845
2011,Hamed Haddadi,C,25,MEM,31,168,30,58,0,1,30,57,15,23,75
2011,Richard Hamilton,SG,32,DET,55,1498,288,671,55,144,233,527,146,172,777
2011,Tyler Hansbrough,PF,25,IND,70,1535,285,613,0,2,285,611,197,253,767
2011,Luke Harangody,PF,23,TOT,49,640,79,206,16,66,63,140,19,26,193
2011,Luke Harangody,PF,23,BOS,28,241,28,71,2,10,26,61,5,8,63
2011,Luke Harangody,PF,23,CLE,21,399,51,135,14,56,37,79,14,18,130
2011,James Harden,SG,21,OKC,82,2189,298,684,113,324,185,360,289,343,998
2011,Al Harrington,PF,30,DEN,73,1665,281,675,117,328,164,347,86,117,765
2011,Devin Harris,PG,27,TOT,71,2254,343,813,58,180,285,633,335,402,1079
2011,Devin Harris,PG,27,NJN,54,1724,260,612,33,110,227,502,258,307,811
2011,Devin Harris,PG,27,UTA,17,530,83,201,25,70,58,131,77,95,268
2011,Manny Harris,SG,21,CLE,54,933,108,289,34,92,74,197,71,93,321
2011,Mike Harris,PF,27,HOU,4,16,3,6,0,0,3,6,2,4,8
2011,Udonis Haslem,PF,30,MIA,13,345,44,86,0,0,44,86,16,20,104
2011,Spencer Hawes,C,22,PHI,81,1718,264,568,9,37,255,531,47,88,584
2011,Chuck Hayes,C,27,HOU,74,2079,244,463,0,2,244,461,94,142,582
2011,Gordon Hayward,SF,20,UTA,72,1218,142,293,35,74,107,219,69,97,388
2011,Lazar Hayward,SF,24,MIN,42,419,55,154,17,60,38,94,33,42,160
2011,Brendan Haywood,C,31,DAL,72,1331,128,223,0,1,128,222,64,177,320
2011,Luther Head,PG,28,SAC,36,586,68,164,25,64,43,100,39,50,200
2011,Gerald Henderson,SG,23,CHA,68,1661,259,570,7,36,252,534,128,163,653
2011,Xavier Henry,SG,19,MEM,38,527,65,160,2,17,63,143,33,52,165
2011,Roy Hibbert,C,24,IND,81,2244,410,890,0,4,410,886,205,275,1025
2011,J.J. Hickson,C,22,CLE,80,2256,429,936,0,5,429,931,247,367,1105
2011,Nene Hilario,C,28,DEN,75,2291,402,654,1,5,401,649,286,402,1091
2011,George Hill,PG,24,SAS,76,2148,287,633,77,204,210,429,233,270,884
2011,Grant Hill,SF,38,PHO,80,2409,399,825,45,114,354,711,213,257,1056
2011,Jordan Hill,C,23,HOU,72,1125,173,352,0,2,173,350,60,85,406
2011,Kirk Hinrich,SG-PG,30,TOT,72,2157,278,623,75,188,203,435,106,126,737
2011,Kirk Hinrich,SG,30,WAS,48,1471,198,438,43,112,155,326,92,105,531
2011,Kirk Hinrich,PG,30,ATL,24,686,80,185,32,76,48,109,14,21,206
2011,Jrue Holiday,PG,20,PHI,82,2901,446,999,81,222,365,777,172,209,1145
2011,Ryan Hollins,C,26,CLE,70,1182,131,219,0,0,131,219,111,163,373
2011,Al Horford,C,24,ATL,77,2704,513,921,2,4,511,917,150,188,1178
2011,Eddie House,SG,32,MIA,56,978,128,321,68,175,60,146,38,40,362
2011,Dwight Howard,C,25,ORL,78,2935,619,1044,0,7,619,1037,546,916,1784
2011,Josh Howard,SF,30,WAS,18,409,58,162,7,29,51,133,29,47,152
2011,Juwan Howard,PF,37,MIA,57,592,55,125,0,0,55,125,29,35,139
2011,Lester Hudson,PG,26,WAS,11,73,6,24,4,15,2,9,2,4,18
2011,Kris Humphries,PF,25,NJN,74,2061,307,583,0,1,307,582,127,191,741
2011,Serge Ibaka,PF,21,OKC,82,2216,335,617,0,1,335,616,138,184,808
2011,Andre Iguodala,SF,27,PHI,67,2469,338,759,61,181,277,578,208,300,945
2011,Zydrunas Ilgauskas,C,35,MIA,72,1145,162,319,0,1,162,318,36,46,360
2011,Didier Ilunga-Mbenga,C,30,NOH,41,330,23,49,0,0,23,49,13,18,59
2011,Ersan Ilyasova,PF,23,MIL,60,1505,221,507,36,121,185,386,93,104,571
2011,Royal Ivey,SG,29,OKC,25,155,16,38,7,16,9,22,2,2,41
2011,Jarrett Jack,SG-PG,27,TOT,83,1722,260,637,33,108,227,529,182,214,735
2011,Jarrett Jack,PG,27,TOR,13,347,48,122,4,24,44,98,40,46,140
2011,Jarrett Jack,SG,27,NOH,70,1375,212,515,29,84,183,431,142,168,595
2011,Darnell Jackson,PF,25,SAC,59,486,77,158,3,11,74,147,30,49,187
2011,Stephen Jackson,SG,32,CHA,67,2405,435,1059,121,359,314,700,249,305,1240
2011,Damion James,SF,23,NJN,25,403,46,103,0,3,46,100,18,28,110
2011,LeBron James,SF,26,MIA,79,3063,758,1485,92,279,666,1206,503,663,2111
2011,Antawn Jamison,PF,34,CLE,56,1842,374,876,91,263,283,613,171,234,1010
2011,Othyus Jeffers,SG,25,TOT,17,322,31,65,1,4,30,61,30,46,93
2011,Othyus Jeffers,SG,25,SAS,1,8,1,3,0,0,1,3,0,0,2
2011,Othyus Jeffers,SG,25,WAS,16,314,30,62,1,4,29,58,30,46,91
2011,Al Jefferson,C,26,UTA,82,2940,654,1319,0,0,654,1319,220,289,1528
2011,Richard Jefferson,SF,30,SAS,81,2459,304,642,135,307,169,335,148,195,891
2011,Jared Jeffries,PF,29,TOT,42,601,30,86,2,9,28,77,12,29,74
2011,Jared Jeffries,PF,29,HOU,18,138,11,36,1,6,10,30,4,10,27
2011,Jared Jeffries,PF,29,NYK,24,463,19,50,1,3,18,47,8,19,47
2011,Brandon Jennings,PG,21,MIL,63,2169,361,926,98,303,263,623,199,246,1019
2011,Eugene Jeter,PG,27,SAC,62,858,106,259,6,30,100,229,37,41,255
2011,Yi Jianlian,PF,23,WAS,63,1112,145,347,3,13,142,334,62,91,355
2011,Amir Johnson,PF,23,TOR,72,1853,281,495,0,1,281,494,126,160,688
2011,Armon Johnson,PG,21,POR,38,277,46,101,5,12,41,89,13,22,110
2011,Chris Johnson,C,25,TOT,14,138,9,21,0,0,9,21,15,20,33
2011,Chris Johnson,C,25,POR,10,106,7,18,0,0,7,18,13,18,27
2011,Chris Johnson,C,25,BOS,4,32,2,3,0,0,2,3,2,2,6
2011,James Johnson,SF,23,TOT,38,822,108,237,8,34,100,203,47,71,271
2011,James Johnson,SF,23,CHI,13,123,17,41,2,9,15,32,6,13,42
2011,James Johnson,SF,23,TOR,25,699,91,196,6,25,85,171,41,58,229
2011,Joe Johnson,SG,29,ATL,72,2554,514,1161,89,300,425,861,195,243,1312
2011,Trey Johnson,SG,26,TOT,8,94,12,33,1,3,11,30,9,10,34
2011,Trey Johnson,SG,26,TOR,7,81,10,30,1,3,9,27,7,8,28
2011,Trey Johnson,SG,26,LAL,1,13,2,3,0,0,2,3,2,2,6
2011,Wesley Johnson,SG,23,MIN,79,2069,271,682,103,289,168,393,64,92,709
2011,Dahntay Jones,SG,30,IND,45,589,100,214,14,39,86,175,69,90,283
2011,Dominique Jones,SG,22,DAL,18,135,14,45,0,4,14,41,14,17,42
2011,James Jones,SF,30,MIA,81,1549,146,346,123,287,23,59,60,72,475
2011,Solomon Jones,C,26,IND,39,528,49,121,0,1,49,120,41,62,139
2011,DeAndre Jordan,C,22,LAC,80,2047,234,341,0,1,234,340,98,217,566
2011,Chris Kaman,C,28,LAC,32,838,177,376,0,0,177,376,43,57,397
2011,Jason Kapono,SF,29,PHI,24,112,7,28,1,8,6,20,1,2,16
2011,Jason Kidd,PG,37,DAL,80,2653,215,596,133,391,82,205,67,77,630
2011,Andrei Kirilenko,SF,29,UTA,64,1999,253,542,36,98,217,444,208,270,750
2011,Linas Kleiza,SF,26,TOR,39,1032,178,406,39,131,139,275,41,65,436
2011,Kyle Korver,SG,29,CHI,82,1649,242,557,120,289,122,268,77,87,681
2011,Kosta Koufos,C,21,TOT,50,434,68,150,0,2,68,148,24,43,160
2011,Kosta Koufos,C,21,MIN,39,336,47,108,0,2,47,106,12,24,106
2011,Kosta Koufos,C,21,DEN,11,98,21,42,0,0,21,42,12,19,54
2011,Nenad Krstic,C,27,TOT,71,1571,231,452,0,0,231,452,113,146,575
2011,Nenad Krstic,C,27,OKC,47,1018,152,305,0,0,152,305,53,66,357
2011,Nenad Krstic,C,27,BOS,24,553,79,147,0,0,79,147,60,80,218
2011,Carl Landry,PF,27,TOT,76,2008,345,687,0,4,345,683,213,288,903
2011,Carl Landry,PF,27,SAC,53,1406,238,484,0,3,238,481,155,215,631
2011,Carl Landry,PF,27,NOH,23,602,107,203,0,1,107,202,58,73,272
2011,Acie Law,PG,26,TOT,51,726,81,186,6,36,75,150,47,64,215
2011,Acie Law,PG,26,MEM,11,94,3,19,0,6,3,13,6,10,12
2011,Acie Law,PG,26,GSW,40,632,78,167,6,30,72,137,41,54,203
2011,Gani Lawal,PF,22,PHO,1,2,0,0,0,0,0,0,0,0,0
2011,Ty Lawson,PG,23,DEN,80,2103,346,688,69,171,277,517,172,225,933
2011,Courtney Lee,SG,25,HOU,81,1723,253,576,71,174,182,402,95,120,672
2011,David Lee,PF,27,GSW,73,2634,496,978,1,3,495,975,210,267,1203
2011,Rashard Lewis,SF-PF,31,TOT,57,1824,252,582,87,244,165,338,77,96,668
2011,Rashard Lewis,PF,31,ORL,25,810,113,270,44,120,69,150,34,45,304
2011,Rashard Lewis,SF,31,WAS,32,1014,139,312,43,124,96,188,43,51,364
2011,Jeremy Lin,PG,22,GSW,29,285,28,72,1,5,27,67,19,25,76
2011,Shaun Livingston,PG,25,CHA,73,1261,185,397,1,4,184,393,108,125,479
2011,Brook Lopez,C,22,NJN,82,2889,644,1309,0,1,644,1308,385,489,1673
2011,Robin Lopez,C,22,PHO,67,991,179,357,0,0,179,357,74,100,432
2011,Kevin Love,PF,22,MIN,73,2611,482,1026,88,211,394,815,424,499,1476
2011,Kyle Lowry,PG,24,HOU,75,2563,345,809,129,343,216,466,192,251,1011
2011,John Lucas,PG,28,CHI,2,10,1,3,0,1,1,2,0,2,2
2011,Corey Maggette,SF,31,MIL,67,1401,253,559,28,78,225,481,271,325,805
2011,Jamaal Magloire,C,32,MIA,18,158,13,22,0,0,13,22,9,18,35
2011,Ian Mahinmi,C,24,DAL,56,488,55,98,0,2,55,96,63,82,173
2011,Shawn Marion,SF,32,DAL,80,2253,434,834,5,33,429,801,126,164,999
2011,Sean Marks,C,35,POR,29,208,19,44,2,2,17,42,5,8,45
2011,Cartier Martin,SF,26,WAS,52,542,71,182,39,99,32,83,28,40,209
2011,Kenyon Martin,PF,33,DEN,48,1233,185,362,2,9,183,353,42,72,414
2011,Kevin Martin,SG,27,HOU,80,2603,553,1267,176,459,377,808,594,669,1876
2011,Roger Mason,SG,30,NYK,26,319,26,77,16,44,10,33,7,10,75
2011,Wesley Matthews,SG,24,POR,82,2758,440,979,154,378,286,601,266,315,1300
2011,Jason Maxiell,PF,27,DET,57,930,93,189,0,0,93,189,51,99,237
2011,Eric Maynor,PG,23,OKC,82,1200,134,333,37,96,97,237,43,59,348
2011,O.J. Mayo,SG,23,MEM,71,1869,304,747,96,264,208,483,99,131,803
2011,Luc Mbah,PF,24,MIL,79,2093,198,428,0,7,198,421,133,188,529
2011,Antonio McDyess,PF,36,SAS,73,1387,169,344,0,1,169,343,52,77,390
2011,JaVale McGee,C,23,WAS,79,2193,332,604,0,3,332,601,134,230,798
2011,Tracy McGrady,SG,31,DET,72,1686,227,514,30,88,197,426,90,129,574
2011,Dominic McGuire,SF,25,CHA,52,760,72,182,0,2,72,180,30,39,174
2011,Josh McRoberts,PF,23,IND,72,1597,211,386,23,60,188,326,88,119,533
2011,Jodie Meeks,SG,23,PHI,74,2062,242,570,138,348,104,222,152,170,774
2011,Pops Mensah-Bonsu,PF,27,NOH,7,35,1,3,0,0,1,3,0,0,2
2011,C.J. Miles,SF,23,UTA,78,1969,366,899,109,339,257,560,159,196,1000
2011,Darko Milicic,C,25,MIN,69,1686,271,578,0,0,271,578,64,115,606
2011,Andre Miller,PG,34,POR,81,2650,388,844,4,37,384,807,249,292,1029
2011,Brad Miller,C,34,HOU,60,1015,132,296,40,107,92,189,78,94,382
2011,Mike Miller,SG,30,MIA,41,838,81,202,43,118,38,84,23,34,228
2011,Patty Mills,PG,22,POR,64,783,135,328,47,133,88,195,36,47,353
2011,Paul Millsap,PF,25,UTA,76,2605,525,988,9,23,516,965,256,338,1315
2011,Yao Ming*,C,30,HOU,5,91,18,37,0,0,18,37,15,16,51
2011,Nazr Mohammed,C,33,TOT,75,1280,234,448,0,1,234,447,67,112,535
2011,Nazr Mohammed,C,33,CHA,51,851,159,317,0,1,159,316,52,88,370
2011,Nazr Mohammed,C,33,OKC,24,429,75,131,0,0,75,131,15,24,165
2011,Greg Monroe,C,20,DET,80,2222,303,550,0,1,303,549,145,233,751
2011,Jamario Moon,SF,30,TOT,59,1042,101,248,38,123,63,125,15,17,255
2011,Jamario Moon,SF,30,CLE,40,764,76,189,27,95,49,94,10,11,189
2011,Jamario Moon,SF,30,LAC,19,278,25,59,11,28,14,31,5,6,66
2011,Anthony Morrow,SG,25,NJN,58,1856,279,620,110,260,169,360,96,107,764
2011,Timofey Mozgov,C,24,TOT,45,524,63,133,0,0,63,133,37,52,163
2011,Timofey Mozgov,C,24,NYK,34,458,52,112,0,0,52,112,31,44,135
2011,Timofey Mozgov,C,24,DEN,11,66,11,21,0,0,11,21,6,8,28
2011,Byron Mullens,PF,21,OKC,13,85,9,28,0,0,9,28,7,14,25
2011,Troy Murphy,PF,30,TOT,35,466,42,114,5,33,37,81,20,30,109
2011,Troy Murphy,PF,30,NJN,18,288,26,76,4,23,22,53,9,17,65
2011,Troy Murphy,PF,30,BOS,17,178,16,38,1,10,15,28,11,13,44
2011,Hamady N'Diaye,C,24,WAS,16,80,4,5,0,0,4,5,6,12,14
2011,Eduardo Najera,PF,34,CHA,31,372,26,72,11,34,15,38,6,11,69
2011,Steve Nash,PG,36,PHO,75,2497,399,811,81,205,318,606,227,249,1106
2011,Gary Neal,SG,26,SAS,80,1685,285,632,129,308,156,324,84,104,783
2011,Jameer Nelson,PG,28,ORL,76,2319,374,838,119,297,255,541,130,162,997
2011,Joakim Noah,C,25,CHI,48,1576,211,402,0,1,211,401,139,188,561
2011,Andres Nocioni,SF,31,PHI,54,931,118,277,42,118,76,159,49,61,327
2011,Steve Novak,SF,27,TOT,30,215,35,67,26,46,9,21,8,8,104
2011,Steve Novak,SF,27,DAL,7,18,4,8,3,4,1,4,0,0,11
2011,Steve Novak,SF,27,SAS,23,197,31,59,23,42,8,17,8,8,93
2011,Dirk Nowitzki,PF,32,DAL,73,2504,610,1179,66,168,544,1011,395,443,1681
2011,Jermaine O'Neal,C,32,BOS,24,431,50,109,0,1,50,108,29,43,129
2011,Shaquille O'Neal*,C,38,BOS,37,752,134,201,0,0,134,201,73,131,341
2011,Fabricio Oberto,C,35,POR,5,45,3,5,0,0,3,5,1,2,7
2011,Lamar Odom,PF,31,LAL,82,2639,473,893,68,178,405,715,166,246,1180
2011,Emeka Okafor,C,28,NOH,72,2287,300,524,0,1,300,523,145,258,745
2011,Mehmet Okur,C,31,UTA,13,168,22,62,5,16,17,46,15,20,64
2011,Travis Outlaw,SF,26,NJN,82,2358,274,731,76,252,198,479,132,171,756
2011,Larry Owens,SF,28,TOT,12,143,15,32,6,13,9,19,4,9,40
2011,Larry Owens,SF,28,SAS,7,31,3,6,1,3,2,3,2,4,9
2011,Larry Owens,SF,28,WAS,5,112,12,26,5,10,7,16,2,5,31
2011,Zaza Pachulia,C,26,ATL,79,1244,107,232,0,0,107,232,135,179,349
2011,Anthony Parker,SF,35,CLE,72,2091,220,552,86,227,134,325,74,95,600
2011,Tony Parker,PG,28,SAS,78,2528,555,1069,25,70,530,999,233,303,1368
2011,Patrick Patterson,PF,21,HOU,52,868,149,267,0,2,149,265,30,42,328
2011,Chris Paul,PG,25,NOH,80,2880,430,928,71,183,359,745,337,384,1268
2011,Sasha Pavlovic,SF-SG,27,TOT,31,362,29,72,12,31,17,41,6,10,76
2011,Sasha Pavlovic,SF,27,DAL,10,163,15,35,7,16,8,19,4,5,41
2011,Sasha Pavlovic,SG,27,NOH,4,50,2,11,0,5,2,6,0,0,4
2011,Sasha Pavlovic,SG,27,BOS,17,149,12,26,5,10,7,16,2,5,31
2011,Nikola Pekovic,C,25,MIN,65,887,136,263,0,0,136,263,87,114,359
2011,Kendrick Perkins,C,26,TOT,29,742,67,130,0,0,67,130,40,72,174
2011,Kendrick Perkins,C,26,BOS,12,313,32,59,0,0,32,59,23,40,87
2011,Kendrick Perkins,C,26,OKC,17,429,35,71,0,0,35,71,17,32,87
2011,Morris Peterson,SG,33,OKC,4,23,2,5,0,1,2,4,0,0,4
2011,Johan Petro,C,25,NJN,77,893,129,290,0,4,129,286,15,28,273
2011,Paul Pierce,SF,33,BOS,80,2774,507,1021,111,297,396,724,386,449,1511
2011,Mickael Pietrus,SG-SF,28,TOT,57,1107,143,365,85,236,58,129,39,57,410
2011,Mickael Pietrus,SF,28,ORL,19,418,45,115,34,87,11,28,3,6,127
2011,Mickael Pietrus,SG,28,PHO,38,689,98,250,51,149,47,101,36,51,283
2011,Dexter Pittman,C,22,MIA,2,11,1,3,0,0,1,3,0,0,2
2011,Quincy Pondexter,SF,22,NOH,66,734,73,180,18,50,55,130,24,34,188
2011,James Posey,SF,34,IND,49,839,81,241,67,212,14,29,11,15,240
2011,Leon Powe,C-PF,27,TOT,30,328,59,119,0,2,59,117,40,72,158
2011,Leon Powe,PF,27,CLE,14,187,29,59,0,0,29,59,12,26,70
2011,Leon Powe,C,27,MEM,16,141,30,60,0,2,30,58,28,46,88
2011,Josh Powell,PF,28,ATL,54,653,94,208,0,1,94,207,36,45,224
2011,A.J. Price,PG,24,IND,50,795,114,320,41,149,73,171,54,81,323
2011,Ronnie Price,SG,27,UTA,59,717,74,210,20,69,54,141,29,39,197
2011,Tayshaun Prince,SF,30,DET,78,2562,473,1001,34,98,439,903,118,168,1098
2011,Joel Przybilla,C,31,TOT,36,519,25,44,0,0,25,44,14,27,64
2011,Joel Przybilla,C,31,POR,31,445,21,34,0,0,21,34,13,23,55
2011,Joel Przybilla,C,31,CHA,5,74,4,10,0,0,4,10,1,4,9
2011,Chris Quinn,PG,27,SAS,41,292,33,91,11,37,22,54,4,8,81
2011,Vladimir Radmanovic,PF,30,GSW,74,1169,137,318,70,173,67,145,30,34,374
2011,Anthony Randolph,C-PF,21,TOT,40,590,123,264,1,4,122,260,58,86,305
2011,Anthony Randolph,PF,21,NYK,17,127,14,45,1,4,13,41,6,12,35
2011,Anthony Randolph,C,21,MIN,23,463,109,219,0,0,109,219,52,74,270
2011,Zach Randolph,PF,29,MEM,75,2724,598,1188,8,43,590,1145,300,396,1504
2011,Theo Ratliff,C,37,LAL,10,71,1,6,0,0,1,6,0,2,2
2011,Andy Rautins,SG,24,NYK,5,24,3,7,1,4,2,3,1,2,8
2011,Michael Redd,SG,31,MIL,10,134,18,45,4,17,14,28,4,4,44
2011,J.J. Redick,SG,26,ORL,59,1513,197,447,87,219,110,228,112,128,593
2011,Jason Richardson,SG,30,TOT,80,2715,472,1056,189,479,283,577,116,159,1249
2011,Jason Richardson,SG,30,PHO,25,796,183,389,62,148,121,241,55,72,483
2011,Jason Richardson,SG,30,ORL,55,1919,289,667,127,331,162,336,61,87,766
2011,Quentin Richardson,SF,30,ORL,57,955,87,255,42,146,45,109,33,44,249
2011,Luke Ridnour,PG,29,MIN,71,2159,319,681,81,184,238,497,121,137,840
2011,Nate Robinson,PG,26,TOT,59,1013,150,376,65,200,85,176,36,44,401
2011,Nate Robinson,PG,26,BOS,55,983,146,361,63,192,83,169,33,40,388
2011,Nate Robinson,PG,26,OKC,4,30,4,15,2,8,2,7,3,4,13
2011,Rajon Rondo,PG,24,BOS,68,2527,318,670,10,43,308,627,75,132,721
2011,Derrick Rose,PG,22,CHI,81,3026,711,1597,128,385,583,1212,476,555,2026
2011,Quinton Ross,SF,29,NJN,36,353,26,59,0,3,26,56,5,14,57
2011,Brandon Roy,SG,26,POR,47,1310,209,523,38,114,171,409,117,138,573
2011,Brandon Rush,SG,25,IND,67,1754,217,515,93,223,124,292,80,106,607
2011,John Salmons,SG,31,MIL,73,2554,373,898,83,219,290,679,195,240,1024
2011,Samardo Samuels,PF,22,CLE,37,701,110,241,0,3,110,238,68,110,288
2011,Larry Sanders,C,22,MIL,60,872,116,268,0,0,116,268,28,50,260
2011,Brian Scalabrine,PF,32,CHI,18,88,10,19,0,5,10,14,0,0,20
2011,Luis Scola,PF,30,HOU,74,2412,569,1129,0,3,569,1126,214,290,1352
2011,Thabo Sefolosha,SG,26,OKC,79,2049,157,333,28,102,129,231,59,79,401
2011,Kevin Seraphin,PF,21,WAS,58,635,66,147,0,0,66,147,22,31,154
2011,Ramon Sessions,PG,24,CLE,81,2133,362,776,3,15,359,761,348,423,1075
2011,Mustafa Shakur,PG,26,WAS,22,159,21,59,1,10,20,49,8,15,51
2011,Garret Siler,C,24,PHO,21,101,17,31,0,0,17,31,11,22,45
2011,Bobby Simmons,SF,30,SAS,2,16,0,3,0,3,0,0,0,0,0
2011,Brian Skinner,C,34,MIL,2,6,0,0,0,0,0,0,0,0,0
2011,Craig Smith,PF,27,LAC,48,586,104,188,0,5,104,183,50,68,258
2011,Ish Smith,PG,22,TOT,43,442,43,115,3,10,40,105,12,21,101
2011,Ish Smith,PG,22,HOU,28,329,32,83,3,8,29,75,7,10,74
2011,Ish Smith,PG,22,MEM,15,113,11,32,0,2,11,30,5,11,27
2011,J.R. Smith,SF,25,DEN,79,1968,341,784,124,318,217,466,163,221,969
2011,Jason Smith,C,24,NOH,77,1102,136,307,0,2,136,305,59,70,331
2011,Joe Smith,PF,35,TOT,16,69,3,16,0,0,3,16,2,2,8
2011,Joe Smith,PF,35,NJN,4,25,1,4,0,0,1,4,0,0,2
2011,Joe Smith,PF,35,LAL,12,44,2,12,0,0,2,12,2,2,6
2011,Josh Smith,PF,25,ATL,77,2645,497,1041,51,154,446,887,229,316,1274
2011,Darius Songaila,C,32,PHI,10,71,7,15,0,0,7,15,2,4,16
2011,Marreese Speights,C,23,PHI,64,734,144,291,1,4,143,287,55,73,344
2011,Tiago Splitter,C,26,SAS,60,738,101,191,0,1,101,190,76,140,278
2011,Jerry Stackhouse,SG,36,MIA,7,50,3,12,1,4,2,8,5,7,12
2011,Lance Stephenson,SG,20,IND,12,115,13,39,0,5,13,34,11,14,37
2011,DeShawn Stevenson,SG,29,DAL,72,1158,128,330,94,249,34,81,33,43,383
2011,Peja Stojakovic,SF,33,TOT,33,617,100,227,57,136,43,91,23,25,280
2011,Peja Stojakovic,SF,33,NOH,6,89,14,33,11,25,3,8,6,7,45
2011,Peja Stojakovic,SF,33,TOR,2,22,7,10,4,6,3,4,2,2,20
2011,Peja Stojakovic,SF,33,DAL,25,506,79,184,42,105,37,79,15,16,215
2011,Amar'e Stoudemire,C,28,NYK,78,2870,744,1482,10,23,734,1459,473,597,1971
2011,Rodney Stuckey,PG,24,DET,70,2183,363,827,26,90,337,737,330,381,1082
2011,DaJuan Summers,SF,23,DET,22,199,28,69,9,21,19,48,9,20,74
2011,Pape Sy,SF,22,ATL,3,21,2,6,0,1,2,5,3,3,7
2011,Jermaine Taylor,SG,24,TOT,34,483,94,196,14,45,80,151,21,28,223
2011,Jermaine Taylor,SG,24,HOU,8,77,16,32,2,5,14,27,5,6,39
2011,Jermaine Taylor,SG,24,SAC,26,406,78,164,12,40,66,124,16,22,184
2011,Jeff Teague,PG,22,ATL,70,963,133,304,18,48,115,256,77,97,361
2011,Sebastian Telfair,PG,25,MIN,37,711,97,241,28,78,69,163,44,60,266
2011,Garrett Temple,PG-SG,24,TOT,24,230,20,68,10,37,10,31,7,17,57
2011,Garrett Temple,SG,24,SAS,3,21,1,5,0,1,1,4,0,2,2
2011,Garrett Temple,SG,24,MIL,9,83,7,21,3,10,4,11,0,4,17
2011,Garrett Temple,PG,24,CHA,12,126,12,42,7,26,5,16,7,11,38
2011,Jason Terry,SG,33,DAL,82,2564,492,1091,127,351,365,740,182,214,1293
2011,Hasheem Thabeet,C,23,TOT,47,373,17,40,0,0,17,40,19,35,53
2011,Hasheem Thabeet,C,23,MEM,45,369,17,39,0,0,17,39,19,35,53
2011,Hasheem Thabeet,C,23,HOU,2,4,0,1,0,0,0,1,0,0,0
2011,Etan Thomas,C,32,ATL,13,82,10,21,0,0,10,21,12,15,32
2011,Kurt Thomas,PF,38,CHI,52,1178,95,186,1,1,94,185,20,32,211
2011,Tyrus Thomas,C,24,CHA,41,861,156,331,0,3,156,328,107,136,419
2011,Jason Thompson,PF,24,SAC,75,1748,271,534,0,3,271,531,121,200,663
2011,Al Thornton,SF-PF,27,TOT,71,1383,205,431,4,26,201,405,110,142,524
2011,Al Thornton,SF,27,WAS,49,1069,154,327,4,25,150,302,81,107,393
2011,Al Thornton,PF,27,GSW,22,314,51,104,0,1,51,103,29,35,131
2011,Marcus Thornton,SG,23,TOT,73,1775,350,807,88,240,262,567,145,184,933
2011,Marcus Thornton,SG,23,NOH,46,745,137,334,35,93,102,241,50,66,359
2011,Marcus Thornton,SG,23,SAC,27,1030,213,473,53,147,160,326,95,118,574
2011,Anthony Tolliver,SF,25,MIN,65,1362,141,313,47,115,94,198,105,131,434
2011,Ronny Turiaf,C,28,NYK,64,1141,103,163,0,0,103,163,61,98,267
2011,Hedo Turkoglu,SF-PF,31,TOT,81,2540,322,722,127,310,195,412,106,156,877
2011,Hedo Turkoglu,PF,31,PHO,25,630,85,193,41,97,44,96,26,36,237
2011,Hedo Turkoglu,SF,31,ORL,56,1910,237,529,86,213,151,316,80,120,640
2011,Evan Turner,SG,22,PHI,78,1797,225,529,14,44,211,485,101,125,565
2011,Ekpe Udoh,C,23,GSW,58,1030,97,222,0,0,97,222,42,64,236
2011,Ime Udoka,SF,33,SAS,20,130,5,21,0,8,5,13,4,8,14
2011,Beno Udrih,PG,28,SAC,79,2734,412,824,65,182,347,642,197,228,1086
2011,Ben Uzoh,PG,22,NJN,42,438,61,144,3,8,58,136,33,56,158
2011,Anderson Varejao,C,28,CLE,31,994,114,216,0,2,114,214,54,81,282
2011,Greivis Vasquez,SG,24,MEM,70,860,95,233,25,86,70,147,34,44,249
2011,Charlie Villanueva,PF,26,DET,76,1666,313,708,125,323,188,385,89,116,840
2011,Sasha Vujacic,SG,26,TOT,67,1648,239,595,97,262,142,333,81,96,656
2011,Sasha Vujacic,SG,26,LAL,11,54,8,23,3,7,5,16,1,2,20
2011,Sasha Vujacic,SG,26,NJN,56,1594,231,572,94,255,137,317,80,94,636
2011,Dwyane Wade,SG,29,MIA,76,2823,692,1384,63,206,629,1178,494,652,1941
2011,Von Wafer,SG,25,BOS,58,553,67,159,18,67,49,92,32,38,184
2011,Henry Walker,SG,23,NYK,61,784,104,236,59,153,45,83,31,44,298
2011,John Wall,PG,20,WAS,69,2606,398,972,34,115,364,857,301,393,1131
2011,Ben Wallace,C,36,DET,54,1238,67,149,1,2,66,147,19,57,154
2011,Gerald Wallace,SF-PF,28,TOT,71,2693,386,851,62,186,324,665,279,374,1113
2011,Gerald Wallace,SF,28,CHA,48,1872,252,582,35,106,217,476,210,284,749
2011,Gerald Wallace,PF,28,POR,23,821,134,269,27,80,107,189,69,90,364
2011,Luke Walton,SF,30,LAL,54,484,38,116,8,34,30,82,7,10,91
2011,Willie Warren,PG,21,LAC,19,134,13,35,5,15,8,20,6,8,37
2011,Hakim Warrick,PF,28,PHO,80,1416,228,446,1,11,227,435,212,294,669
2011,C.J. Watson,PG,26,CHI,82,1091,146,394,44,112,102,282,69,93,405
2011,Earl Watson,PG,31,UTA,80,1567,126,307,36,107,90,200,55,82,343
2011,Kyle Weaver,SG,24,UTA,5,69,9,25,3,7,6,18,7,8,28
2011,Martell Webster,SF,24,MIN,46,1094,152,340,55,132,97,208,94,122,453
2011,Sonny Weems,SF,24,TOR,59,1413,228,513,17,61,211,452,72,94,545
2011,David West,PF,30,NOH,70,2451,528,1040,2,9,526,1031,264,327,1322
2011,Delonte West,PG,27,BOS,24,453,55,120,12,33,43,87,13,15,135
2011,Mario West,SG,26,NJN,6,116,9,21,1,4,8,17,3,5,22
2011,Russell Westbrook,PG,22,OKC,82,2847,614,1390,34,103,580,1287,531,631,1793
2011,D.J. White,C-PF,24,TOT,47,685,111,219,0,2,111,217,46,64,268
2011,D.J. White,PF,24,OKC,23,219,30,65,0,0,30,65,5,10,65
2011,D.J. White,C,24,CHA,24,466,81,154,0,2,81,152,41,54,203
2011,Hassan Whiteside,C,21,SAC,1,2,0,0,0,0,0,0,0,0,0
2011,Chris Wilcox,PF,28,DET,57,995,187,322,0,1,187,321,50,89,424
2011,Damien Wilkins,SF,31,ATL,52,676,69,137,2,10,67,127,40,56,180
2011,Deron Williams,PG,26,TOT,65,2465,428,975,105,317,323,658,348,412,1309
2011,Deron Williams,PG,26,UTA,53,2009,369,806,89,258,280,548,302,354,1129
2011,Deron Williams,PG,26,NJN,12,456,59,169,16,59,43,110,46,58,180
2011,Jason Williams,PG,35,TOT,27,295,22,67,10,38,12,29,0,0,54
2011,Jason Williams,PG,35,ORL,16,171,13,38,7,23,6,15,0,0,33
2011,Jason Williams,PG,35,MEM,11,124,9,29,3,15,6,14,0,0,21
2011,Jawad Williams,SF,27,CLE,26,391,41,126,13,45,28,81,9,12,104
2011,Lou Williams,SG,24,PHI,75,1747,323,795,88,253,235,542,293,356,1027
2011,Marvin Williams,SF,24,ATL,65,1865,246,537,37,110,209,427,147,174,676
2011,Mo Williams,PG,28,TOT,58,1788,291,730,79,244,212,486,151,177,812
2011,Mo Williams,PG,28,CLE,36,1065,178,462,36,136,142,326,85,102,477
2011,Mo Williams,PG,28,LAC,22,723,113,268,43,108,70,160,66,75,335
2011,Reggie Williams,SF,24,GSW,80,1626,268,572,102,241,166,331,100,134,738
2011,Shawne Williams,PF,24,NYK,64,1323,164,385,85,212,79,173,41,49,454
2011,Shelden Williams,PF,27,TOT,59,911,103,220,0,0,103,220,58,75,264
2011,Shelden Williams,PF,27,DEN,42,713,82,181,0,0,82,181,34,46,198
2011,Shelden Williams,PF,27,NYK,17,198,21,39,0,0,21,39,24,29,66
2011,Terrence Williams,SG,23,TOT,21,290,43,115,6,22,37,93,14,21,106
2011,Terrence Williams,SG,23,NJN,10,206,29,73,4,12,25,61,5,10,67
2011,Terrence Williams,SG,23,HOU,11,84,14,42,2,10,12,32,9,11,39
2011,Metta World,SF,31,LAL,82,2410,261,658,83,233,178,425,92,136,697
2011,Antoine Wright,SG,26,SAC,7,31,1,8,0,4,1,4,0,0,2
2011,Brandan Wright,PF,23,TOT,37,379,60,117,0,0,60,117,21,31,141
2011,Brandan Wright,PF,23,GSW,21,195,38,63,0,0,38,63,7,14,83
2011,Brandan Wright,PF,23,NJN,16,184,22,54,0,0,22,54,14,17,58
2011,Dorell Wright,SF,25,GSW,82,3147,485,1146,194,516,291,630,180,228,1344
2011,Julian Wright,SF,23,TOR,52,766,82,160,2,10,80,150,22,43,188
2011,Nick Young,SG,25,WAS,64,2034,412,935,105,271,307,664,186,228,1115
2011,Sam Young,SF,25,MEM,78,1577,233,494,17,50,216,444,89,116,572
2011,Thaddeus Young,PF,22,PHI,82,2135,458,847,6,22,452,825,123,174,1045
,,,,,,,,,,,,,,,
2012,Jeff Adrien,PF,25,HOU,8,63,7,16,0,0,7,16,7,12,21
2012,Arron Afflalo,SG,26,DEN,62,2086,329,699,88,221,241,478,197,247,943
2012,Blake Ahearn,PG,27,UTA,4,30,4,14,2,9,2,5,0,0,10
2012,Solomon Alabi,C,23,TOR,14,122,13,36,0,0,13,36,7,8,33
2012,Cole Aldrich,C,23,OKC,26,173,22,42,0,0,22,42,13,14,57
2012,LaMarcus Aldridge,PF,26,POR,55,1994,483,943,2,11,481,932,223,274,1191
2012,Lavoy Allen,PF,22,PHI,41,624,79,167,0,0,79,167,11,14,169
2012,Ray Allen,SG,36,BOS,46,1565,226,493,106,234,120,259,97,106,655
2012,Tony Allen,SG,30,MEM,58,1525,210,448,8,26,202,422,140,175,568
2012,Morris Almond,SG,26,WAS,4,67,6,17,1,3,5,14,1,3,14
2012,Al-Farouq Aminu,SF,21,NOH,66,1477,150,365,13,47,137,318,86,114,399
2012,Lou Amundson,PF,29,IND,60,753,89,207,0,0,89,207,35,82,213
2012,Chris Andersen,C,33,DEN,32,486,59,108,0,0,59,108,50,82,168
2012,Alan Anderson,SF,29,TOR,17,461,55,142,24,61,31,81,29,34,163
2012,James Anderson,SG,22,SAS,51,603,66,174,19,68,47,106,39,52,190
2012,Ryan Anderson,PF,23,ORL,61,1964,332,757,166,422,166,335,150,171,980
2012,Carmelo Anthony,SF,27,NYK,55,1876,441,1025,68,203,373,822,295,367,1245
2012,Joel Anthony,C,29,MIA,64,1349,85,152,0,0,85,152,49,71,219
2012,Gilbert Arenas,PG,30,MEM,17,211,26,64,13,39,13,25,7,10,72
2012,Trevor Ariza,SF,26,NOH,41,1350,168,403,29,87,139,316,79,102,444
2012,Omer Asik,C,25,CHI,66,971,79,156,0,0,79,156,47,103,205
2012,D.J. Augustin,PG,24,CHA,48,1408,183,487,61,179,122,308,105,120,532
2012,Gustavo Ayon,PF,26,NOH,54,1088,140,261,0,1,140,260,39,63,319
2012,Jeff Ayres,C,24,IND,20,106,15,36,0,0,15,36,4,7,34
2012,Kelenna Azubuike,SG,28,DAL,3,18,3,8,1,3,2,5,0,0,7
2012,Luke Babbitt,SF,22,POR,40,537,71,173,43,100,28,73,17,20,202
2012,Renaldo Balkman,SF,27,NYK,14,115,16,32,2,9,14,23,8,11,42
2012,Leandro Barbosa,SG,29,TOT,64,1382,271,637,65,170,206,467,101,124,708
2012,Leandro Barbosa,SG,29,TOR,42,946,198,454,40,111,158,343,76,91,512
2012,Leandro Barbosa,SG,29,IND,22,436,73,183,25,59,48,124,25,33,196
2012,J.J. Barea,PG,27,MIN,41,1032,167,418,53,143,114,275,76,98,463
2012,Andrea Bargnani,C,26,TOR,31,1032,209,484,34,115,175,369,151,173,603
2012,Matt Barnes,SF,31,LAL,63,1440,175,387,46,138,129,249,95,128,491
2012,Earl Barron,C,30,GSW,2,9,2,4,0,0,2,4,0,0,4
2012,Brandon Bass,PF,26,BOS,59,1868,303,632,0,0,303,632,132,163,738
2012,Tony Battie,C,35,PHI,27,295,19,51,0,1,19,50,4,4,42
2012,Shane Battier,SF,33,MIA,65,1499,113,292,62,183,51,109,23,37,311
2012,Nicolas Batum,SF,23,POR,59,1791,289,641,107,274,182,367,133,159,818
2012,Jerryd Bayless,PG,23,TOR,31,705,117,276,44,104,73,172,75,88,353
2012,Michael Beasley,SF,23,MIN,47,1087,221,497,38,101,183,396,61,95,541
2012,Rodrigue Beaubois,PG,23,DAL,53,1151,188,445,38,132,150,313,58,69,472
2012,Marco Belinelli,SG,25,NOH,66,1966,286,686,107,284,179,402,101,129,780
2012,Raja Bell,SG,35,UTA,34,796,81,174,34,87,47,87,21,25,217
2012,Keith Benson,C,23,GSW,3,9,0,1,0,0,0,1,0,0,0
2012,Mike Bibby,PG,33,NYK,39,557,35,124,27,85,8,39,6,8,103
2012,Andris Biedrins,C,25,GSW,47,739,39,64,0,0,39,64,1,9,79
2012,Chauncey Billups,SG,35,LAC,20,607,83,228,48,125,35,103,85,95,299
2012,Bismack Biyombo,C,19,CHA,63,1455,129,278,0,0,129,278,69,143,327
2012,DeJuan Blair,PF,22,SAS,64,1363,269,504,0,1,269,503,73,119,611
2012,Steve Blake,PG,31,LAL,53,1237,101,268,53,158,48,110,21,27,276
2012,Andray Blatche,PF,25,WAS,26,626,93,245,2,7,91,238,33,49,221
2012,Eric Bledsoe,PG,22,LAC,40,464,49,126,6,30,43,96,28,44,132
2012,Keith Bogans,SF,31,NJN,5,94,8,21,3,12,5,9,2,5,21
2012,Andrew Bogut,C,27,MIL,12,364,61,136,0,1,61,135,14,23,136
2012,Matt Bonner,PF,31,SAS,65,1326,154,350,105,250,49,100,16,21,429
2012,Trevor Booker,PF,24,WAS,50,1261,181,341,1,2,180,339,56,93,419
2012,Carlos Boozer,PF,30,CHI,66,1948,448,842,0,1,448,841,95,137,991
2012,Chris Bosh,PF,27,MIA,57,2007,393,807,10,35,383,772,229,279,1025
2012,Earl Boykins,PG,35,HOU,8,111,12,36,2,9,10,27,13,15,39
2012,Craig Brackins,PF,24,PHI,14,88,9,33,3,9,6,24,1,2,22
2012,Avery Bradley,PG,21,BOS,64,1368,200,402,22,54,178,348,62,78,484
2012,Elton Brand,C,32,PHI,60,1732,287,581,0,1,287,580,85,116,659
2012,Corey Brewer,SF,25,DEN,59,1287,201,463,33,127,168,336,90,130,525
2012,Ronnie Brewer,SG,26,CHI,66,1635,190,445,19,69,171,376,56,100,455
2012,Jon Brockman,PF,24,MIL,35,239,15,45,0,1,15,44,7,15,37
2012,MarShon Brooks,SG,23,NJN,56,1648,274,640,47,150,227,490,113,148,708
2012,Derrick Brown,SF,24,CHA,65,1443,212,409,6,24,206,385,94,141,524
2012,Kwame Brown,C,29,GSW,9,187,21,40,0,0,21,40,15,34,57
2012,Shannon Brown,SG,26,PHO,59,1400,251,598,68,188,183,410,80,99,650
2012,Kobe Bryant,SG,33,LAL,58,2232,574,1336,87,287,487,1049,381,451,1616
2012,Chase Budinger,SF,23,HOU,58,1298,208,471,88,219,120,252,54,70,558
2012,Alec Burks,SG,20,UTA,59,939,153,357,15,45,138,312,104,143,425
2012,Caron Butler,SF,31,LAC,63,1871,287,705,92,257,195,448,87,107,753
2012,Jimmy Butler,SG,22,CHI,42,359,32,79,2,11,30,68,43,56,109
2012,Rasual Butler,SF,32,TOR,34,453,41,133,21,77,20,56,7,12,110
2012,Derrick Byars,PF,27,SAS,2,37,3,11,0,6,3,5,4,4,10
2012,Andrew Bynum,C,24,LAL,60,2112,444,796,1,5,443,791,234,338,1123
2012,Will Bynum,PG,29,DET,36,514,74,194,7,29,67,165,49,64,204
2012,Jose Calderon,PG,30,TOR,53,1799,218,477,59,159,159,318,60,68,555
2012,Marcus Camby,C,37,TOT,59,1352,128,287,2,5,126,282,29,64,287
2012,Marcus Camby,C,37,POR,40,894,67,161,0,0,67,161,18,38,152
2012,Marcus Camby,C,37,HOU,19,458,61,126,2,5,59,121,11,26,135
2012,Brian Cardinal,SF,34,DAL,44,277,14,55,10,49,4,6,5,6,43
2012,DeMarre Carroll,SF-PF,25,TOT,24,348,43,105,7,19,36,86,14,16,107
2012,DeMarre Carroll,PF,25,DEN,4,21,6,6,0,0,6,6,0,0,12
2012,DeMarre Carroll,SF,25,UTA,20,327,37,99,7,19,30,80,14,16,95
2012,Matt Carroll,SG,31,CHA,53,596,52,157,8,43,44,114,30,38,142
2012,Anthony Carter,PG,36,TOR,24,209,17,53,5,17,12,36,8,10,47
2012,Vince Carter,SG,35,DAL,61,1542,223,542,74,205,149,337,95,115,615
2012,Omri Casspi,SF,23,CLE,65,1341,166,412,53,168,113,244,74,108,459
2012,Mario Chalmers,PG,25,MIA,64,1825,223,498,101,260,122,238,80,101,627
2012,Tyson Chandler,C,29,NYK,62,2061,241,355,0,2,241,353,217,315,699
2012,Wilson Chandler,SF,24,DEN,8,215,31,79,3,12,28,67,10,12,75
2012,Josh Childress,SF,28,PHO,34,491,48,99,4,24,44,75,0,2,100
2012,Earl Clark,PF,24,ORL,45,559,51,139,0,0,51,139,21,29,123
2012,Norris Cole,PG,23,MIA,65,1260,177,450,21,76,156,374,66,85,441
2012,Jason Collins,C,33,ATL,30,308,16,40,0,0,16,40,7,15,39
2012,Darren Collison,PG,24,IND,60,1878,230,523,34,94,196,429,127,153,621
2012,Nick Collison,PF,31,OKC,63,1307,120,201,0,1,120,200,44,62,284
2012,Mike Conley,PG,24,MEM,62,2174,296,684,60,159,236,525,136,158,788
2012,Brian Cook,PF,31,TOT,32,276,31,98,10,50,21,48,9,10,81
2012,Brian Cook,PF,31,LAC,16,121,11,49,5,27,6,22,4,4,31
2012,Brian Cook,PF,31,WAS,16,155,20,49,5,23,15,26,5,6,50
2012,Daequan Cook,SG,24,OKC,57,989,109,296,79,228,30,68,14,22,311
2012,DeMarcus Cousins,C,21,SAC,64,1950,448,999,2,14,446,985,262,373,1160
2012,Jamal Crawford,PG,31,POR,60,1613,283,737,80,260,203,477,191,206,837
2012,Jordan Crawford,SG,23,WAS,64,1753,349,872,79,273,270,599,161,203,938
2012,Dante Cunningham,PF,24,MEM,64,1124,144,279,0,2,144,277,45,69,333
2012,Eddy Curry,C,29,MIA,14,83,12,26,0,0,12,26,6,8,30
2012,Stephen Curry,PG,23,GSW,26,732,145,296,55,121,90,175,38,47,383
2012,Samuel Dalembert,C,30,HOU,65,1446,200,395,0,1,200,394,90,113,490
2012,Erick Dampier,C,36,ATL,15,83,1,8,0,0,1,8,0,0,2
2012,Marquis Daniels,SG,31,BOS,38,484,52,143,0,10,52,133,17,23,121
2012,Baron Davis,PG,32,NYK,29,595,68,184,26,85,42,99,16,24,178
2012,Ed Davis,PF,22,TOR,66,1534,172,335,0,1,172,334,71,106,415
2012,Glen Davis,PF,26,ORL,61,1427,225,534,2,14,223,520,114,167,566
2012,Josh Davis,PF,31,MEM,15,130,10,27,4,13,6,14,4,8,28
2012,Eric Dawson,C,27,SAS,4,39,7,12,0,0,7,12,1,2,15
2012,Austin Daye,SF,23,DET,41,603,73,227,13,62,60,165,35,43,194
2012,Carlos Delfino,SF,29,MIL,54,1537,182,453,86,239,96,214,38,48,488
2012,Luol Deng,SF,26,CHI,54,2129,311,755,79,215,232,540,127,165,828
2012,Justin Dentmon,PG,26,TOT,6,91,10,28,2,14,8,14,4,6,26
2012,Justin Dentmon,PG,26,SAS,2,19,2,6,0,4,2,2,0,0,4
2012,Justin Dentmon,PG,26,TOR,4,72,8,22,2,10,6,12,4,6,22
2012,DeMar DeRozan,SG,22,TOR,63,2206,381,903,24,92,357,811,268,331,1054
2012,Boris Diaw,PF,29,TOT,57,1424,156,351,31,99,125,252,22,35,365
2012,Boris Diaw,PF,29,CHA,37,1018,116,283,23,86,93,197,17,27,272
2012,Boris Diaw,PF,29,SAS,20,406,40,68,8,13,32,55,5,8,93
2012,Ike Diogu,PF,28,SAS,2,14,0,2,0,0,0,2,2,2,2
2012,DeSagana Diop,C,30,CHA,27,325,15,42,0,0,15,42,1,6,31
2012,Keyon Dooling,SG,31,BOS,46,662,66,163,27,81,39,82,23,31,182
2012,Toney Douglas,PG,25,NYK,38,656,94,290,27,117,67,173,22,26,237
2012,Goran Dragic,PG,25,HOU,66,1752,277,600,68,202,209,398,153,190,775
2012,Jared Dudley,SG,26,PHO,65,2020,312,643,80,209,232,434,119,164,823
2012,Chris Duhon,PG,29,ORL,63,1226,85,203,50,119,35,84,17,21,237
2012,Tim Duncan,C,35,SAS,58,1634,361,733,0,4,361,729,173,249,895
2012,Mike Dunleavy,SF,31,MIL,55,1445,239,504,83,208,156,296,116,143,677
2012,Kevin Durant,SF,23,OKC,66,2546,643,1297,133,344,510,953,431,501,1850
2012,Jerome Dyson,PG,24,NOH,9,180,19,48,1,8,18,40,28,36,67
2012,Devin Ebanks,SG,22,LAL,24,396,37,89,0,9,37,80,23,35,97
2012,Wayne Ellington,SG,24,MIN,51,973,122,302,35,108,87,194,32,40,311
2012,Monta Ellis,SG,26,TOT,58,2120,450,1040,62,201,388,839,219,275,1181
2012,Monta Ellis,SG,26,GSW,37,1365,305,704,50,156,255,548,151,186,811
2012,Monta Ellis,SG,26,MIL,21,755,145,336,12,45,133,291,68,89,370
2012,Francisco Elson,C,35,PHI,5,16,1,3,0,0,1,3,0,0,2
2012,Andre Emmett,SF,29,NJN,6,45,4,7,0,1,4,6,5,8,13
2012,Semih Erden,C,25,CLE,28,333,39,74,0,0,39,74,21,41,99
2012,Jeremy Evans,SF,24,UTA,29,217,27,42,0,1,27,41,8,16,62
2012,Maurice Evans,SF,33,WAS,24,343,45,112,17,45,28,67,10,13,117
2012,Reggie Evans,PF,31,LAC,56,771,34,72,0,0,34,72,36,71,104
2012,Tyreke Evans,SG,22,SAC,63,2162,408,900,20,99,388,801,201,258,1037
2012,Christian Eyenga,SF,22,TOT,7,102,6,25,1,3,5,22,4,8,17
2012,Christian Eyenga,SF,22,CLE,6,83,3,19,1,2,2,17,2,6,9
2012,Christian Eyenga,SF,22,LAL,1,19,3,6,0,1,3,5,2,2,8
2012,Kenneth Faried,PF,22,DEN,46,1037,181,309,0,0,181,309,109,164,471
2012,Jordan Farmar,PG,25,NJN,39,831,147,315,55,125,92,190,57,63,406
2012,Derrick Favors,PF,20,UTA,65,1376,222,445,0,0,222,445,126,194,570
2012,Raymond Felton,PG,27,POR,60,1906,261,642,62,203,199,439,100,124,684
2012,Rudy Fernandez,SG,26,DEN,31,710,99,225,40,122,59,103,30,43,268
2012,Kyrylo Fesenko,C,25,IND,3,17,2,5,0,0,2,5,4,6,8
2012,Landry Fields,SG,23,NYK,66,1894,236,513,31,121,205,392,77,137,580
2012,Derek Fisher,PG,37,TOT,63,1508,129,348,35,109,94,239,57,67,350
2012,Derek Fisher,PG,37,LAL,43,1101,92,240,24,74,68,166,44,53,252
2012,Derek Fisher,PG,37,OKC,20,407,37,108,11,35,26,73,13,14,98
2012,Jonny Flynn,PG,22,TOT,29,416,46,131,10,34,36,97,29,39,131
2012,Jonny Flynn,PG,22,HOU,11,135,12,41,2,9,10,32,11,14,37
2012,Jonny Flynn,PG,22,POR,18,281,34,90,8,25,26,65,18,25,94
2012,Jeff Foote,C,24,NOH,4,39,2,6,0,0,2,6,0,0,4
2012,Gary Forbes,SG,26,TOR,48,713,112,271,29,83,83,188,66,91,319
2012,T.J. Ford,PG,28,SAS,14,191,19,43,2,8,17,35,11,14,51
2012,Courtney Fortson,PG,23,TOT,10,95,11,32,3,13,8,19,10,15,35
2012,Courtney Fortson,PG,23,LAC,4,46,5,12,1,4,4,8,6,9,17
2012,Courtney Fortson,PG,23,HOU,6,49,6,20,2,9,4,11,4,6,18
2012,Jeff Foster,C,35,IND,11,141,9,18,1,1,8,17,6,9,25
2012,Randy Foye,SG,28,LAC,65,1682,256,644,127,329,129,315,73,85,712
2012,Jimmer Fredette,PG,22,SAC,61,1135,172,446,78,216,94,230,40,48,462
2012,Channing Frye,PF,28,PHO,64,1669,255,613,91,263,164,350,73,82,674
2012,Dan Gadzuric,C,33,NYK,2,13,0,2,0,0,0,2,0,2,0
2012,Sundiata Gaines,SG,25,NJN,57,793,102,271,28,82,74,189,59,96,291
2012,Danilo Gallinari,SF,23,DEN,43,1351,193,466,60,183,133,283,182,209,628
2012,Francisco Garcia,SF,30,SAC,49,798,86,229,38,131,48,98,24,30,234
2012,Kevin Garnett,C,35,BOS,60,1864,391,777,3,9,388,768,162,189,947
2012,Marc Gasol,C,27,MEM,65,2370,357,740,1,12,356,728,237,317,952
2012,Pau Gasol,PF,31,LAL,65,2430,459,917,7,27,452,890,204,261,1129
2012,Rudy Gay,SF,25,MEM,65,2422,485,1067,54,173,431,894,208,263,1232
2012,Alonzo Gee,SG,24,CLE,63,1827,227,551,44,137,183,414,167,212,665
2012,Paul George,SG,21,IND,66,1958,281,639,90,234,191,405,146,182,798
2012,Daniel Gibson,SG,25,CLE,35,916,87,248,55,139,32,109,34,43,263
2012,Taj Gibson,PF,26,CHI,63,1284,200,404,0,0,200,404,84,135,484
2012,Manu Ginobili,SG,34,SAS,34,792,150,285,52,126,98,159,88,101,440
2012,Mickell Gladness,PF,25,TOT,26,252,25,59,0,0,25,59,6,12,56
2012,Mickell Gladness,PF,25,MIA,8,28,1,3,0,0,1,3,0,0,2
2012,Mickell Gladness,PF,25,GSW,18,224,24,56,0,0,24,56,6,12,54
2012,Ryan Gomes,SF,29,LAC,32,425,31,95,4,29,27,66,8,11,74
2012,Drew Gooden,C,30,MIL,56,1469,287,657,16,55,271,602,176,208,766
2012,Ben Gordon,SG,28,DET,52,1398,234,530,63,147,171,383,117,136,648
2012,Eric Gordon,PG,23,NOH,9,310,63,140,10,40,53,100,49,65,185
2012,Marcin Gortat,C,27,PHO,66,2114,427,769,0,2,427,767,163,251,1017
2012,Andrew Goudelock,SG,23,LAL,40,419,68,174,28,75,40,99,11,12,175
2012,Danny Granger,SF,28,IND,62,2062,391,941,123,323,268,618,254,291,1159
2012,Aaron Gray,C,27,TOR,49,813,83,161,0,0,83,161,25,47,191
2012,Danny Green,SG,24,SAS,66,1522,211,477,102,234,109,243,79,100,603
2012,Gerald Green,SF,26,NJN,31,781,154,320,43,110,111,210,49,65,400
2012,Willie Green,SG,30,ATL,53,922,153,325,50,113,103,212,48,56,404
2012,Donte Greene,PF,23,SAC,53,777,108,266,25,105,83,161,44,55,285
2012,Blake Griffin,PF,22,LAC,66,2392,561,1022,2,16,559,1006,244,468,1368
2012,Hamed Haddadi,C,26,MEM,35,206,26,48,0,1,26,47,18,26,70
2012,Jordan Hamilton,SF,21,DEN,26,258,48,111,17,47,31,64,2,5,115
2012,Richard Hamilton,SG,33,CHI,28,697,140,310,17,46,123,264,29,37,326
2012,Tyler Hansbrough,PF,26,IND,66,1442,194,479,0,1,194,478,226,278,614
2012,Luke Harangody,PF,24,CLE,21,231,23,65,5,21,18,44,9,12,60
2012,James Harden,SG,22,OKC,62,1946,309,629,114,292,195,337,312,369,1044
2012,Justin Harper,PF,22,ORL,14,84,9,31,2,13,7,18,0,1,20
2012,Josh Harrellson,PF,22,NYK,37,540,63,149,20,59,43,90,16,26,162
2012,Al Harrington,PF,31,DEN,64,1761,345,773,101,303,244,470,119,176,910
2012,Devin Harris,PG,28,UTA,63,1741,241,542,77,213,164,329,156,209,715
2012,Manny Harris,SG,22,CLE,26,456,60,150,12,36,48,114,41,59,173
2012,Terrel Harris,SG,24,MIA,22,318,29,83,8,39,21,44,14,21,80
2012,Tobias Harris,SF,19,MIL,42,479,79,169,6,23,73,146,44,54,208
2012,Udonis Haslem,PF,31,MIA,64,1589,151,357,0,0,151,357,83,102,385
2012,Spencer Hawes,C,23,PHI,37,920,156,319,3,12,153,307,40,55,355
2012,Chuck Hayes,C,28,SAC,54,1039,73,170,0,2,73,168,26,39,172
2012,Gordon Hayward,SF,21,UTA,66,2015,267,586,55,159,212,427,193,232,782
2012,Lazar Hayward,SF,25,OKC,26,141,13,38,4,14,9,24,7,12,37
2012,Brendan Haywood,C,32,DAL,54,1146,118,228,0,0,118,228,45,96,281
2012,Gerald Henderson,SG,24,CHA,55,1831,332,723,11,47,321,676,155,204,830
2012,Xavier Henry,SG,20,NOH,45,759,90,228,7,17,83,211,52,85,239
2012,Roy Hibbert,C,25,IND,65,1937,332,668,0,1,332,667,170,239,834
2012,J.J. Hickson,PF,23,TOT,54,1244,183,392,0,2,183,390,86,134,452
2012,J.J. Hickson,PF,23,SAC,35,644,64,173,0,1,64,172,37,58,165
2012,J.J. Hickson,PF,23,POR,19,600,119,219,0,1,119,218,49,76,287
2012,Cory Higgins,PG,22,CHA,38,423,52,160,4,20,48,140,42,60,150
2012,Nene Hilario,C,29,TOT,39,1110,211,393,0,4,211,389,113,168,535
2012,Nene Hilario,C,29,DEN,28,826,143,281,0,2,143,279,90,133,376
2012,Nene Hilario,C,29,WAS,11,284,68,112,0,2,68,110,23,35,159
2012,George Hill,PG,25,IND,50,1274,168,380,54,147,114,233,91,117,481
2012,Grant Hill,SF,39,PHO,49,1378,201,451,14,53,187,398,83,109,499
2012,Jordan Hill,C,24,TOT,39,551,82,165,0,3,82,162,30,47,194
2012,Jordan Hill,C,24,HOU,32,469,68,135,0,3,68,132,25,39,161
2012,Jordan Hill,C,24,LAL,7,82,14,30,0,0,14,30,5,8,33
2012,Kirk Hinrich,SG,31,ATL,48,1237,122,295,47,136,75,159,25,32,316
2012,Darington Hobson,SG,24,MIL,5,39,2,13,0,6,2,7,0,0,4
2012,Jrue Holiday,PG,21,PHI,65,2196,360,834,65,171,295,663,94,120,879
2012,Ryan Hollins,C,27,TOT,39,522,46,84,0,0,46,84,39,75,131
2012,Ryan Hollins,C,27,CLE,24,362,28,56,0,0,28,56,33,55,89
2012,Ryan Hollins,C,27,BOS,15,160,18,28,0,0,18,28,6,20,42
2012,Tyler Honeycutt,SF,21,SAC,15,88,8,24,1,3,7,21,3,5,20
2012,Al Horford,C,25,ATL,11,348,57,103,0,1,57,102,22,30,136
2012,Dennis Horner,PF,23,NJN,8,22,1,4,0,1,1,3,3,4,5
2012,Dwight Howard,C,26,ORL,54,2070,416,726,0,7,416,719,281,572,1113
2012,Josh Howard,SF,31,UTA,43,991,144,361,9,37,135,324,75,97,372
2012,Juwan Howard,PF,38,MIA,28,190,17,55,0,0,17,55,8,10,42
2012,Lester Hudson,PG,27,TOT,16,334,62,162,16,64,46,98,34,41,174
2012,Lester Hudson,PG,27,CLE,13,314,59,151,15,61,44,90,32,38,165
2012,Lester Hudson,PG,27,MEM,3,20,3,11,1,3,2,8,2,3,9
2012,Larry Hughes,PG,33,ORL,9,114,5,22,1,7,4,15,1,2,12
2012,Kris Humphries,PF,26,NJN,62,2162,323,671,0,0,323,671,209,278,855
2012,Serge Ibaka,PF,22,OKC,66,1792,262,490,1,3,261,487,78,118,603
2012,Andre Iguodala,SF,28,PHI,62,2209,287,632,76,193,211,439,121,196,771
2012,Ersan Ilyasova,PF,24,MIL,60,1655,294,597,51,112,243,485,143,183,782
2012,Kyrie Irving,PG,19,CLE,51,1558,350,747,73,183,277,564,171,196,944
2012,Royal Ivey,SG,30,OKC,34,354,26,73,18,53,8,20,1,8,71
2012,Jarrett Jack,PG,28,NOH,45,1530,266,583,39,112,227,471,129,148,700
2012,Reggie Jackson,PG,21,OKC,45,501,51,159,13,62,38,97,25,29,140
2012,Stephen Jackson,SF,33,TOT,47,1212,159,425,49,170,110,255,94,114,461
2012,Stephen Jackson,SF,33,MIL,26,712,97,272,30,108,67,164,50,60,274
2012,Stephen Jackson,SF,33,SAS,21,500,62,153,19,62,43,91,44,54,187
2012,Damion James,SF,24,NJN,7,170,13,35,0,1,13,34,8,12,34
2012,LeBron James,SF,27,MIA,62,2326,621,1169,54,149,567,1020,387,502,1683
2012,Mike James,PG,36,CHI,11,120,20,49,6,10,14,39,7,8,53
2012,Antawn Jamison,PF,35,CLE,65,2151,421,1044,91,267,330,777,185,271,1118
2012,Al Jefferson,C,27,UTA,61,2075,516,1048,1,4,515,1044,137,177,1170
2012,Richard Jefferson,SF,31,TOT,63,1748,203,488,113,269,90,219,59,85,578
2012,Richard Jefferson,SF,31,SAS,41,1168,132,319,80,190,52,129,35,50,379
2012,Richard Jefferson,SF,31,GSW,22,580,71,169,33,79,38,90,24,35,199
2012,Jared Jeffries,PF,30,NYK,39,729,59,144,3,16,56,128,49,72,170
2012,Charles Jenkins,PG,22,GSW,51,893,130,291,3,20,127,271,34,39,297
2012,Brandon Jennings,PG,22,MIL,66,2331,469,1121,129,388,340,733,193,239,1260
2012,Jonas Jerebko,PF,24,DET,64,1468,212,453,32,106,180,347,100,124,556
2012,Yi Jianlian,PF,24,DAL,30,203,31,82,3,10,28,72,14,21,79
2012,Amir Johnson,PF,24,TOR,64,1553,196,340,2,5,194,335,58,84,452
2012,Armon Johnson,PG,22,TOT,9,124,20,43,1,3,19,40,6,6,47
2012,Armon Johnson,PG,22,POR,1,5,1,1,0,0,1,1,0,0,2
2012,Armon Johnson,PG,22,NJN,8,119,19,42,1,3,18,39,6,6,45
2012,Carldell Johnson,PG,29,NOH,15,119,11,35,4,15,7,20,1,3,27
2012,Chris Johnson,C,26,TOT,27,175,20,41,0,0,20,41,15,19,55
2012,Chris Johnson,C,26,POR,20,93,11,23,0,0,11,23,10,12,32
2012,Chris Johnson,C,26,NOH,7,82,9,18,0,0,9,18,5,7,23
2012,Ivan Johnson,PF,27,ATL,56,934,141,275,2,6,139,269,72,100,356
2012,JaJuan Johnson,PF,22,BOS,36,298,54,121,0,0,54,121,6,9,114
2012,James Johnson,SF,24,TOR,62,1561,233,518,19,60,214,458,81,115,566
2012,Joe Johnson,SG,30,ATL,60,2127,423,931,125,322,298,609,158,186,1129
2012,Trey Johnson,SG,27,NOH,11,61,8,14,0,0,8,14,5,5,21
2012,Wesley Johnson,SF,24,MIN,65,1469,158,397,53,169,105,228,24,34,393
2012,Dahntay Jones,SF,31,IND,65,1052,115,281,33,77,82,204,83,99,346
2012,Dominique Jones,SG,23,DAL,33,268,29,73,1,8,28,65,29,37,88
2012,James Jones,SG,31,MIA,51,666,57,150,46,114,11,36,25,30,185
2012,Solomon Jones,C-PF,27,TOT,21,292,24,61,0,0,24,61,19,23,67
2012,Solomon Jones,PF,27,LAC,10,96,1,8,0,0,1,8,4,5,6
2012,Solomon Jones,C,27,NOH,11,196,23,53,0,0,23,53,15,18,61
2012,DeAndre Jordan,C,23,LAC,66,1798,206,326,0,1,206,325,74,141,486
2012,Jerome Jordan,C,25,NYK,21,108,17,33,0,0,17,33,8,10,42
2012,Cory Joseph,PG,20,SAS,29,266,22,70,3,15,19,55,11,17,58
2012,Chris Kaman,C,29,NOH,47,1372,266,597,0,0,266,597,84,107,616
2012,Enes Kanter,C,19,UTA,66,874,117,236,0,1,117,235,70,105,304
2012,Jason Kapono,SG,30,LAL,27,269,21,55,8,27,13,28,4,4,54
2012,D.J. Kennedy,SF,22,CLE,2,59,5,12,2,4,3,8,0,2,12
2012,Jason Kidd,PG,38,DAL,48,1379,99,273,79,223,20,50,22,28,299
2012,Linas Kleiza,SF,27,TOR,49,1057,165,410,62,179,103,231,81,100,473
2012,Brandon Knight,PG,20,DET,66,2129,319,769,105,276,214,493,104,137,847
2012,Kyle Korver,SG,30,CHI,65,1469,178,412,118,271,60,141,55,66,529
2012,Kosta Koufos,C,22,DEN,48,792,115,192,0,0,115,192,33,55,263
2012,Carl Landry,PF,28,NOH,41,999,182,362,0,3,182,359,147,184,511
2012,Ty Lawson,PG,24,DEN,61,2124,374,767,73,200,301,567,178,216,999
2012,Courtney Lee,SG,26,HOU,58,1757,251,580,87,217,164,363,71,86,660
2012,David Lee,PF,28,GSW,57,2121,464,922,0,5,464,917,219,280,1147
2012,Malcolm Lee,SG,21,MIN,19,243,23,59,2,10,21,49,14,17,62
2012,Kawhi Leonard,SF,20,SAS,64,1534,199,404,41,109,158,295,68,88,507
2012,Travis Leslie,SG,21,LAC,10,45,5,14,0,0,5,14,4,9,14
2012,Jon Leuer,PF,22,MIL,46,555,97,191,3,9,94,182,21,28,218
2012,Rashard Lewis,SF,32,WAS,28,729,85,221,16,67,69,154,31,37,217
2012,DeAndre Liggins,SF,23,ORL,17,115,12,25,0,4,12,21,9,19,33
2012,Jeremy Lin,PG,23,NYK,35,940,171,383,24,75,147,308,146,183,512
2012,Shaun Livingston,SG,26,MIL,58,1092,127,271,2,3,125,268,62,79,318
2012,Brook Lopez,C,23,NJN,5,136,38,77,0,0,38,77,20,32,96
2012,Robin Lopez,C,23,PHO,64,895,124,269,0,0,124,269,100,140,348
2012,Kevin Love,PF,23,MIN,55,2145,474,1059,105,282,369,777,379,460,1432
2012,Kyle Lowry,PG,25,HOU,47,1510,210,513,79,211,131,302,171,198,670
2012,John Lucas,PG,29,CHI,49,726,143,358,55,140,88,218,28,32,369
2012,Shelvin Mack,PG,21,WAS,64,779,88,220,12,42,76,178,42,59,230
2012,Vernon Macklin,C,25,DET,23,135,19,35,0,0,19,35,8,14,46
2012,Corey Maggette,SF,32,CHA,32,881,139,373,24,66,115,307,178,208,480
2012,Jamaal Magloire,C,33,TOR,34,374,17,45,0,0,17,45,7,27,41
2012,Ian Mahinmi,C,25,DAL,61,1139,130,238,0,1,130,237,94,147,354
2012,Shawn Marion,SF,33,DAL,63,1919,288,646,20,68,268,578,74,93,670
2012,Cartier Martin,SF,27,WAS,17,391,59,134,29,75,30,59,11,19,158
2012,Kenyon Martin,PF,34,LAC,42,940,97,220,3,13,94,207,20,54,217
2012,Kevin Martin,SG,28,HOU,40,1264,222,537,78,225,144,312,160,179,682
2012,Roger Mason,SG,31,WAS,52,697,103,258,59,154,44,104,21,27,286
2012,Wesley Matthews,SG,25,POR,66,2228,314,763,129,337,185,426,147,171,904
2012,Jason Maxiell,PF,28,DET,65,1466,183,383,0,2,183,381,58,106,424
2012,Eric Maynor,PG,24,OKC,9,137,14,39,6,17,8,22,4,4,38
2012,O.J. Mayo,SG,24,MEM,66,1771,300,736,100,275,200,461,133,172,833
2012,Luc Mbah,PF,25,MIL,43,1009,133,261,1,4,132,257,66,103,333
2012,JaVale McGee,C,24,TOT,61,1535,307,552,0,0,307,552,77,167,691
2012,JaVale McGee,C,24,WAS,41,1124,214,400,0,0,214,400,58,116,486
2012,JaVale McGee,C,24,DEN,20,411,93,152,0,0,93,152,19,51,205
2012,Tracy McGrady,SF,32,ATL,52,837,101,231,15,33,86,198,56,83,273
2012,Dominic McGuire,PF,26,GSW,64,1127,94,210,0,4,94,206,39,53,227
2012,Josh McRoberts,PF,24,LAL,50,718,56,118,3,7,53,111,23,36,138
2012,Jodie Meeks,SG,24,PHI,66,1644,191,467,97,266,94,201,77,85,556
2012,C.J. Miles,SG,24,UTA,56,1145,177,465,46,150,131,315,108,136,508
2012,Darko Milicic,C,26,MIN,29,472,59,130,0,0,59,130,16,37,134
2012,Andre Miller,SG,35,DEN,66,1809,242,552,18,83,224,469,137,169,639
2012,Brad Miller,C,35,MIN,15,146,9,27,7,15,2,12,10,12,35
2012,Mike Miller,SG,31,MIA,39,752,91,209,53,117,38,92,2,5,237
2012,Patty Mills,PG,23,SAS,16,261,63,130,24,56,39,74,15,15,165
2012,Paul Millsap,PF,26,UTA,64,2100,426,861,7,31,419,830,202,255,1061
2012,Nazr Mohammed,C,34,OKC,63,692,79,169,0,1,79,168,13,23,171
2012,Greg Monroe,C,21,DET,66,2082,407,781,0,1,407,780,201,272,1015
2012,Jamario Moon,SF,31,CHA,8,123,7,24,2,10,5,14,2,2,18
2012,E'Twaun Moore,PG,22,BOS,38,331,43,113,17,45,26,68,7,7,110
2012,Mikki Moore,C,36,GSW,7,118,9,20,0,0,9,20,6,7,24
2012,Darius Morris,PG,21,LAL,19,169,18,42,4,9,14,33,6,9,46
2012,Marcus Morris,PF,22,HOU,17,126,16,54,2,17,14,37,6,8,40
2012,Markieff Morris,PF,22,PHO,63,1227,174,436,43,124,131,312,76,106,467
2012,Anthony Morrow,SG,26,NJN,62,1636,272,658,106,286,166,372,97,104,747
2012,Timofey Mozgov,C,25,DEN,44,687,100,190,0,0,100,190,39,57,239
2012,Byron Mullens,C,22,CHA,65,1465,251,591,12,51,239,540,92,112,606
2012,Troy Murphy,PF,31,LAL,59,956,77,171,28,67,49,104,6,9,188
2012,Hamady N'Diaye,C,25,WAS,3,3,0,1,0,0,0,1,0,0,0
2012,Eduardo Najera,PF,35,CHA,22,270,24,64,8,29,16,35,2,4,58
2012,Steve Nash,PG,37,PHO,62,1961,295,555,55,141,240,414,127,142,772
2012,Gary Neal,SG,27,SAS,56,1206,212,486,83,198,129,288,50,64,557
2012,Jameer Nelson,PG,29,ORL,57,1706,259,606,87,231,172,375,71,88,676
2012,Joakim Noah,C,26,CHI,64,1945,249,490,0,1,249,489,154,206,652
2012,Andres Nocioni,SF,32,PHI,11,56,5,20,1,6,4,14,6,11,17
2012,Steve Novak,PF,28,NYK,54,1020,161,337,133,282,28,55,22,26,477
2012,Dirk Nowitzki,PF,33,DAL,62,2079,473,1034,78,212,395,822,318,355,1342
2012,Jermaine O'Neal,C,33,BOS,25,570,52,120,0,0,52,120,21,31,125
2012,Lamar Odom,SF,32,DAL,50,1027,123,349,28,111,95,238,58,98,332
2012,Emeka Okafor,C,29,NOH,27,781,114,214,0,0,114,214,38,74,266
2012,Mehmet Okur,C,32,NJN,17,454,52,139,23,72,29,67,3,5,130
2012,Daniel Orton,PF,21,ORL,16,187,17,30,0,1,17,29,11,25,45
2012,Travis Outlaw,SF,27,SAC,39,500,60,175,16,60,44,115,31,46,167
2012,Larry Owens,SF,29,NJN,7,75,4,11,2,5,2,6,3,4,13
2012,Zaza Pachulia,C,27,ATL,58,1640,169,339,0,0,169,339,117,158,455
2012,Jannero Pargo,PG,32,ATL,50,671,105,253,53,138,52,115,19,20,282
2012,Jeremy Pargo,PG,25,MEM,44,424,50,150,10,38,40,112,16,27,126
2012,Anthony Parker,SF,36,CLE,51,1280,141,326,50,138,91,188,35,56,367
2012,Tony Parker,PG,29,SAS,60,1923,427,890,14,61,413,829,227,284,1095
2012,Chandler Parsons,SF,23,HOU,63,1804,248,549,60,178,188,371,43,78,599
2012,Patrick Patterson,PF,22,HOU,64,1483,225,511,0,3,225,508,40,57,490
2012,Chris Paul,PG,26,LAC,60,2181,425,890,79,213,346,677,260,302,1189
2012,Sasha Pavlovic,SF,28,BOS,45,527,50,128,17,58,33,70,3,8,120
2012,Nikola Pekovic,C,26,MIN,47,1264,256,454,0,0,256,454,139,187,651
2012,Kendrick Perkins,C,27,OKC,65,1744,128,262,0,0,128,262,73,112,329
2012,Johan Petro,C,26,NJN,59,920,109,260,1,1,108,259,31,37,250
2012,Paul Pierce,SF,34,BOS,61,2075,394,890,100,273,294,617,293,344,1181
2012,Mickael Pietrus,SG,29,BOS,42,921,104,270,61,182,43,88,20,31,289
2012,Dexter Pittman,C,23,MIA,35,301,44,94,0,0,44,94,18,28,106
2012,Quincy Pondexter,SF,23,MEM,64,1002,108,239,22,73,86,166,33,53,271
2012,A.J. Price,PG,25,IND,44,568,59,174,26,88,33,86,28,35,172
2012,Ronnie Price,PG,28,PHO,36,517,49,130,13,44,36,86,20,25,131
2012,Tayshaun Prince,SF,31,DET,63,2087,336,798,37,104,299,694,89,115,798
2012,Joel Przybilla,C,32,POR,27,449,22,48,0,0,22,48,11,18,55
2012,Vladimir Radmanovic,SF,31,ATL,49,755,74,197,50,135,24,62,22,29,220
2012,Anthony Randolph,PF,22,MIN,34,517,94,200,0,1,94,199,64,84,252
2012,Zach Randolph,PF,30,MEM,28,735,132,285,2,8,130,277,58,88,324
2012,Michael Redd,SG,32,PHO,51,770,144,360,42,132,102,228,88,111,418
2012,J.J. Redick,SG,27,ORL,65,1765,248,584,112,268,136,316,143,157,751
2012,Ryan Reid,PF,25,OKC,5,17,4,5,0,0,4,5,0,0,8
2012,Jason Richardson,SG,31,ORL,54,1591,243,596,102,277,141,319,41,69,629
2012,Quentin Richardson,SF,31,ORL,48,866,74,197,42,121,32,76,25,30,215
2012,Luke Ridnour,SG,30,MIN,53,1750,242,550,49,152,193,398,106,119,639
2012,Nate Robinson,PG,27,GSW,51,1192,205,484,66,181,139,303,94,113,570
2012,Rajon Rondo,PG,25,BOS,53,1957,256,572,10,42,246,530,108,181,630
2012,Derrick Rose,PG,23,CHI,39,1375,302,695,54,173,248,522,194,239,852
2012,Ricky Rubio,PG,21,MIN,41,1404,139,389,32,94,107,295,126,157,436
2012,Brandon Rush,SF,26,GSW,65,1717,235,469,99,219,136,250,65,82,634
2012,Walker Russell,PG,29,DET,28,357,33,95,4,13,29,82,14,22,84
2012,John Salmons,SF,32,SAC,46,1250,141,345,33,112,108,233,29,45,344
2012,Samardo Samuels,C,23,CLE,54,825,105,231,0,0,105,231,82,117,292
2012,Larry Sanders,PF,23,MIL,52,643,84,184,0,2,84,182,18,38,186
2012,Brian Scalabrine,PF,33,CHI,28,122,14,30,1,7,13,23,3,6,32
2012,Luis Scola,PF,31,HOU,66,2067,436,888,0,3,436,885,153,198,1025
2012,Thabo Sefolosha,SG,27,OKC,42,914,67,155,31,71,36,84,38,43,203
2012,Josh Selby,PG,20,MEM,28,237,25,72,2,15,23,57,11,14,63
2012,Kevin Seraphin,C,22,WAS,57,1176,203,382,0,1,203,381,47,70,453
2012,Ramon Sessions,PG,25,TOT,64,1707,242,565,43,97,199,468,194,248,721
2012,Ramon Sessions,PG,25,CLE,41,1006,141,354,26,62,115,292,122,147,430
2012,Ramon Sessions,PG,25,LAL,23,701,101,211,17,35,84,176,72,101,291
2012,Iman Shumpert,PG,21,NYK,59,1705,214,534,48,157,166,377,87,109,563
2012,Xavier Silas,SG,24,PHI,2,39,4,15,1,6,3,9,2,3,11
2012,Bobby Simmons,SF,31,LAC,28,418,28,90,20,60,8,30,4,7,80
2012,Chris Singleton,SF,22,WAS,66,1431,116,312,44,127,72,185,30,44,306
2012,James Singleton,PF,30,WAS,12,262,41,75,2,9,39,66,14,15,98
2012,Brian Skinner,C,35,MEM,1,4,0,1,0,0,0,1,0,0,0
2012,Donald Sloan,PG,24,TOT,33,669,79,198,2,25,77,173,23,30,183
2012,Donald Sloan,PG,24,ATL,5,20,3,8,0,1,3,7,0,0,6
2012,Donald Sloan,PG,24,NOH,3,41,5,14,0,2,5,12,2,4,12
2012,Donald Sloan,PG,24,CLE,25,608,71,176,2,22,69,154,21,26,165
2012,Craig Smith,PF,28,POR,47,464,59,117,0,1,59,116,38,53,156
2012,Greg Smith,C,21,HOU,8,69,7,11,0,0,7,11,0,0,14
2012,Ish Smith,PG,23,TOT,26,234,31,81,3,9,28,72,7,10,72
2012,Ish Smith,PG,23,GSW,6,63,12,30,2,5,10,25,1,2,27
2012,Ish Smith,PG,23,ORL,20,171,19,51,1,4,18,47,6,8,45
2012,J.R. Smith,SG,26,NYK,35,967,165,405,67,193,98,212,39,55,436
2012,Jason Smith,PF,25,NOH,40,947,181,348,1,9,180,339,33,47,396
2012,Jerry Smith,PG,24,NJN,5,46,3,14,1,6,2,8,0,0,7
2012,Josh Smith,PF,26,ATL,66,2329,504,1101,28,109,476,992,203,322,1239
2012,Nolan Smith,PG,23,POR,44,541,67,180,13,45,54,135,20,28,167
2012,Marreese Speights,PF,24,MEM,60,1345,221,488,0,3,221,485,84,109,526
2012,Tiago Splitter,C,27,SAS,59,1121,212,343,0,0,212,343,125,181,549
2012,Jerry Stackhouse,SF,37,ATL,30,273,37,100,13,38,24,62,21,23,108
2012,Lance Stephenson,SG,21,IND,42,442,47,125,4,30,43,95,8,17,106
2012,DeShawn Stevenson,SF,30,NJN,51,960,49,172,41,145,8,27,9,16,148
2012,Greg Stiemsma,C,26,BOS,55,766,66,121,0,0,66,121,29,41,161
2012,Julyan Stone,SG,23,DEN,22,179,13,31,2,11,11,20,8,11,36
2012,Amar'e Stoudemire,PF,29,NYK,47,1543,316,654,5,21,311,633,186,243,823
2012,Rodney Stuckey,SG,25,DET,55,1644,256,597,33,104,223,493,267,320,812
2012,DaJuan Summers,SF,24,NOH,15,209,28,65,5,16,23,49,7,9,68
2012,Jeff Teague,PG,23,ATL,66,2183,320,672,51,149,269,523,140,185,831
2012,Sebastian Telfair,PG,26,PHO,60,895,141,342,33,105,108,237,53,67,368
2012,Jason Terry,SG,34,DAL,63,2000,357,830,138,365,219,465,98,111,950
2012,Hasheem Thabeet,C,24,TOT,20,139,11,21,0,0,11,21,13,20,35
2012,Hasheem Thabeet,C,24,HOU,5,23,3,3,0,0,3,3,0,0,6
2012,Hasheem Thabeet,C,24,POR,15,116,8,18,0,0,8,18,13,20,29
2012,Isaiah Thomas,PG,22,SAC,65,1656,256,571,83,219,173,352,154,185,749
2012,Kurt Thomas,C,39,POR,53,803,73,157,0,0,73,157,14,20,160
2012,Lance Thomas,PF,23,NOH,42,630,57,126,0,1,57,125,52,62,166
2012,Malcolm Thomas,PF,23,SAS,3,15,0,3,0,0,0,3,1,2,1
2012,Tyrus Thomas,PF,25,CHA,54,1013,120,327,1,3,119,324,63,83,304
2012,Trey Thompkins,C,21,LAC,24,119,24,61,4,13,20,48,5,7,57
2012,Jason Thompson,PF,25,SAC,64,1657,237,443,0,2,237,441,109,181,583
2012,Klay Thompson,SG,21,GSW,66,1608,318,718,111,268,207,450,79,91,826
2012,Mychel Thompson,SG,23,CLE,5,95,7,24,4,11,3,13,0,0,18
2012,Tristan Thompson,PF,20,CLE,60,1424,194,442,0,2,194,440,106,192,494
2012,Marcus Thornton,SG,24,SAC,51,1780,352,803,107,310,245,493,141,163,952
2012,Jamaal Tinsley,PG,33,UTA,37,507,57,141,10,37,47,104,13,17,137
2012,Anthony Tolliver,SF,26,MIN,51,882,71,182,25,101,46,81,41,55,208
2012,Ronny Turiaf,C,29,TOT,17,279,19,33,0,1,19,32,13,22,51
2012,Ronny Turiaf,C,29,WAS,4,58,3,3,0,0,3,3,0,0,6
2012,Ronny Turiaf,C,29,MIA,13,221,16,30,0,1,16,29,13,22,45
2012,Hedo Turkoglu,SF,32,ORL,53,1653,209,504,91,258,118,246,67,95,576
2012,Evan Turner,SF,23,PHI,65,1713,263,590,11,49,252,541,73,108,610
2012,Jeremy Tyler,C,20,GSW,42,568,88,209,0,1,88,208,29,52,205
2012,Edwin Ubiles,SF,25,WAS,4,52,5,18,1,5,4,13,3,3,14
2012,Ekpe Udoh,C,24,TOT,61,1290,127,295,0,2,127,293,86,114,340
2012,Ekpe Udoh,C,24,GSW,38,827,82,185,0,0,82,185,46,64,210
2012,Ekpe Udoh,C,24,MIL,23,463,45,110,0,2,45,108,40,50,130
2012,Beno Udrih,SG,29,MIL,59,1080,146,332,17,59,129,273,39,55,348
2012,Ben Uzoh,PG,23,TOT,18,370,35,99,0,1,35,98,11,19,81
2012,Ben Uzoh,PG,23,CLE,2,13,2,5,0,0,2,5,0,0,4
2012,Ben Uzoh,PG,23,TOR,16,357,33,94,0,1,33,93,11,19,77
2012,Anderson Varejao,C,29,CLE,25,785,114,222,0,4,114,218,43,64,271
2012,Greivis Vasquez,SG,25,NOH,66,1706,225,523,43,135,182,388,96,117,589
2012,Jan Vesely,PF,21,WAS,57,1078,117,218,0,1,117,217,33,62,267
2012,Charlie Villanueva,PF,27,DET,13,180,35,91,15,45,20,46,6,7,91
2012,Nikola Vucevic,C,21,PHI,51,812,131,291,3,8,128,283,18,34,283
2012,Dwyane Wade,SG,30,MIA,49,1625,416,837,15,56,401,781,235,297,1082
2012,Von Wafer,SG,26,ORL,33,469,71,157,14,39,57,118,38,54,194
2012,Henry Walker,SG,24,NYK,32,620,68,171,36,113,32,58,17,20,189
2012,Kemba Walker,PG,21,CHA,66,1792,281,767,69,226,212,541,168,213,799
2012,John Wall,PG,21,WAS,66,2386,378,894,3,42,375,852,317,402,1076
2012,Ben Wallace,C,37,DET,62,980,34,86,1,4,33,82,16,47,85
2012,Gerald Wallace,SF,29,TOT,58,2076,287,632,46,150,241,482,180,225,800
2012,Gerald Wallace,SF,29,POR,42,1503,203,430,26,98,177,332,125,161,557
2012,Gerald Wallace,SF,29,NJN,16,573,84,202,20,52,64,150,55,64,243
2012,Luke Walton,PF-SF,31,TOT,30,364,24,65,7,20,17,45,0,0,55
2012,Luke Walton,SF,31,LAL,9,65,6,14,0,4,6,10,0,0,12
2012,Luke Walton,PF,31,CLE,21,299,18,51,7,16,11,35,0,0,43
2012,Hakim Warrick,PF,29,PHO,35,503,74,180,1,10,73,170,76,99,225
2012,Darryl Watkins,C,27,NOH,5,98,7,14,0,0,7,14,9,18,23
2012,C.J. Watson,PG,27,CHI,49,1159,161,437,68,173,93,264,84,104,474
2012,Earl Watson,PG,32,UTA,50,1033,54,160,10,52,44,108,31,46,149
2012,Martell Webster,SF,25,MIN,47,1140,115,272,37,109,78,163,57,72,324
2012,David West,PF,31,IND,66,1925,349,716,2,9,347,707,142,176,842
2012,Delonte West,PG,28,DAL,44,1060,166,360,27,76,139,284,62,70,421
2012,Russell Westbrook,PG,23,OKC,66,2331,578,1266,62,196,516,1070,340,413,1558
2012,D.J. White,PF,25,CHA,58,1098,174,353,1,1,173,352,43,61,392
2012,Hassan Whiteside,C,22,SAC,18,109,12,27,0,0,12,27,5,12,29
2012,Chris Wilcox,C,29,BOS,28,481,64,107,0,0,64,107,24,39,152
2012,Damien Wilkins,SF,32,DET,60,922,76,193,7,23,69,170,34,54,193
2012,Deron Williams,PG,27,NJN,55,1999,391,961,115,342,276,619,257,305,1154
2012,Derrick Williams,PF,20,MIN,66,1418,205,498,37,138,168,360,136,195,583
2012,Elliot Williams,SG,22,POR,24,149,37,74,8,27,29,47,6,18,88
2012,Jordan Williams,C,21,NJN,43,635,77,152,0,0,77,152,43,66,197
2012,Lou Williams,PG,25,PHI,64,1682,318,782,83,229,235,553,237,292,956
2012,Marvin Williams,SF,25,ATL,57,1500,203,470,58,149,145,321,115,146,579
2012,Mo Williams,SG,29,LAC,52,1472,260,611,93,239,167,372,72,80,685
2012,Reggie Williams,SF,25,CHA,33,747,106,255,33,107,73,148,29,40,274
2012,Sean Williams,C,25,TOT,11,107,14,22,0,0,14,22,12,13,40
2012,Sean Williams,C,25,DAL,8,65,12,16,0,0,12,16,5,6,29
2012,Sean Williams,C,25,BOS,3,42,2,6,0,0,2,6,7,7,11
2012,Shawne Williams,SF,25,NJN,25,514,42,147,21,87,21,60,8,11,113
2012,Shelden Williams,C,28,NJN,58,1276,96,201,0,0,96,201,76,104,268
2012,Terrence Williams,SG,24,TOT,30,550,85,198,16,46,69,152,27,46,213
2012,Terrence Williams,SG,24,HOU,12,181,20,57,8,19,12,38,6,12,54
2012,Terrence Williams,SG,24,SAC,18,369,65,141,8,27,57,114,21,34,159
2012,Metta World,SF,32,LAL,64,1720,183,465,56,189,127,276,71,115,493
2012,Brandan Wright,C,24,DAL,49,791,144,233,0,1,144,232,52,82,340
2012,Chris Wright,SF,23,GSW,24,186,23,45,0,0,23,45,24,31,70
2012,Dorell Wright,SF,26,GSW,61,1650,222,526,105,292,117,234,80,98,629
2012,Nick Young,SG,26,TOT,62,1729,316,784,103,282,213,502,144,169,879
2012,Nick Young,SG,26,WAS,40,1211,240,591,73,197,167,394,112,130,665
2012,Nick Young,SG,26,LAC,22,518,76,193,30,85,46,108,32,39,214
2012,Sam Young,SF,26,TOT,35,375,45,127,5,17,40,110,19,26,114
2012,Sam Young,SF,26,MEM,21,240,32,83,0,9,32,74,10,12,74
2012,Sam Young,SF,26,PHI,14,135,13,44,5,8,8,36,9,14,40
2012,Thaddeus Young,PF,23,PHI,63,1755,348,687,1,4,347,683,111,144,808
,,,,,,,,,,,,,,,
2013,Quincy Acy,PF,22,TOR,29,342,42,75,1,2,41,73,31,38,116
2013,Jeff Adrien,PF,26,CHA,52,713,72,168,0,2,72,166,65,100,209
2013,Arron Afflalo,SF,27,ORL,64,2307,397,905,72,240,325,665,191,223,1057
2013,Josh Akognon,PG,26,DAL,3,9,2,4,1,2,1,2,0,0,5
2013,Cole Aldrich,C,24,TOT,45,388,44,80,0,0,44,80,12,20,100
2013,Cole Aldrich,C,24,HOU,30,213,23,43,0,0,23,43,4,9,50
2013,Cole Aldrich,C,24,SAC,15,175,21,37,0,0,21,37,8,11,50
2013,LaMarcus Aldridge,PF,27,POR,74,2790,638,1318,2,14,636,1304,282,348,1560
2013,Lavoy Allen,C,23,PHI,79,1669,206,454,0,1,206,453,43,60,455
2013,Ray Allen,SG,37,MIA,79,2035,292,651,139,332,153,319,140,158,863
2013,Tony Allen,SG,31,MEM,79,2109,284,638,3,24,281,614,134,187,705
2013,Al-Farouq Aminu,SF,22,NOH,76,2066,225,474,4,19,221,455,101,137,555
2013,Lou Amundson,PF,30,TOT,39,372,32,81,0,0,32,81,12,36,76
2013,Lou Amundson,PF,30,MIN,20,161,14,38,0,0,14,38,4,20,32
2013,Lou Amundson,PF,30,CHI,1,2,0,1,0,0,0,1,0,0,0
2013,Lou Amundson,PF,30,NOH,18,209,18,42,0,0,18,42,8,16,44
2013,Chris Andersen,C,34,MIA,42,624,71,123,2,3,69,120,63,93,207
2013,Alan Anderson,SF,30,TOR,65,1495,236,616,95,285,141,331,126,147,693
2013,James Anderson,SG-SF,23,TOT,39,401,52,126,21,60,31,66,24,28,149
2013,James Anderson,SF,23,SAS,10,94,11,25,5,11,6,14,7,9,34
2013,James Anderson,SG,23,HOU,29,307,41,101,16,49,25,52,17,19,115
2013,Ryan Anderson,PF,24,NOH,81,2503,472,1115,213,557,259,558,152,180,1309
2013,Carmelo Anthony,PF,28,NYK,67,2482,669,1489,157,414,512,1075,425,512,1920
2013,Joel Anthony,C,30,MIA,62,566,35,68,0,0,35,68,17,28,87
2013,Trevor Ariza,SF,27,WAS,56,1471,188,451,76,209,112,242,78,95,530
2013,Darrell Arthur,PF,24,MEM,59,970,162,359,5,18,157,341,33,46,362
2013,Omer Asik,C,26,HOU,82,2464,332,614,0,1,332,613,168,299,832
2013,D.J. Augustin,PG,25,IND,76,1226,103,294,67,190,36,104,83,99,356
2013,Gustavo Ayon,C,27,TOT,55,734,92,167,0,0,92,167,20,50,204
2013,Gustavo Ayon,C,27,ORL,43,571,67,125,0,0,67,125,19,38,153
2013,Gustavo Ayon,C,27,MIL,12,163,25,42,0,0,25,42,1,12,51
2013,Jeff Ayres,PF,25,IND,37,369,61,126,2,4,59,122,21,23,145
2013,Luke Babbitt,PF,23,POR,62,730,86,234,62,178,24,56,10,13,244
2013,Leandro Barbosa,PG,30,BOS,41,513,83,193,18,47,65,146,31,41,215
2013,J.J. Barea,PG,28,MIN,74,1713,316,758,97,280,219,478,105,134,834
2013,Andrea Bargnani,PF,27,TOR,35,1003,170,426,38,123,132,303,65,77,443
2013,Harrison Barnes,SF,20,GSW,81,2058,276,628,52,145,224,483,144,190,748
2013,Matt Barnes,SF,32,LAC,80,2058,312,675,111,325,201,350,87,117,822
2013,Earl Barron,C,31,TOT,12,159,18,51,0,0,18,51,3,7,39
2013,Earl Barron,C,31,WAS,11,122,13,37,0,0,13,37,2,5,28
2013,Earl Barron,C,31,NYK,1,37,5,14,0,0,5,14,1,2,11
2013,Will Barton,SG,22,POR,73,894,118,309,9,65,109,244,50,65,295
2013,Brandon Bass,PF,27,BOS,81,2239,286,589,0,2,286,587,129,150,701
2013,Shane Battier,SF,34,MIA,72,1786,152,362,136,316,16,46,32,38,472
2013,Nicolas Batum,SF,24,POR,73,2807,352,833,165,444,187,389,178,210,1047
2013,Jerryd Bayless,PG,24,MEM,80,1765,260,621,71,201,189,420,102,122,693
2013,Aron Baynes,C,26,SAS,16,141,18,36,0,1,18,35,7,12,43
2013,Kent Bazemore,SG,23,GSW,61,267,43,116,10,34,33,82,27,44,123
2013,Bradley Beal,SG,19,WAS,56,1745,282,687,91,236,191,451,125,159,780
2013,Michael Beasley,SF,24,PHO,75,1554,310,766,45,144,265,622,94,126,759
2013,Rodrigue Beaubois,PG,24,DAL,45,549,65,176,21,72,44,104,30,38,181
2013,Marco Belinelli,SG,26,CHI,73,1882,241,610,79,221,162,389,141,168,702
2013,Patrick Beverley,PG,24,HOU,41,713,79,189,36,96,43,93,34,41,228
2013,Andris Biedrins,C,26,GSW,53,495,10,21,0,0,10,21,4,13,24
2013,Chauncey Billups,SG,36,LAC,22,418,53,132,33,90,20,42,45,48,184
2013,Bismack Biyombo,C,20,CHA,80,2186,156,346,0,0,156,346,74,142,386
2013,DeJuan Blair,PF,23,SAS,61,851,142,271,0,1,142,270,44,70,328
2013,Steve Blake,PG,32,LAL,45,1175,114,270,72,171,42,99,27,35,327
2013,Andray Blatche,C,26,BRK,82,1555,346,676,3,22,343,654,148,216,843
2013,Eric Bledsoe,PG,23,LAC,76,1553,253,568,31,78,222,490,106,134,643
2013,Keith Bogans,SG,32,BRK,74,1408,108,284,84,245,24,39,11,17,311
2013,Andrew Bogut,C,28,GSW,32,786,83,184,1,1,82,183,19,38,186
2013,Matt Bonner,PF,32,SAS,68,909,112,230,53,120,59,110,11,15,288
2013,Trevor Booker,PF,25,WAS,48,887,108,220,0,5,108,215,40,72,256
2013,Carlos Boozer,PF,31,CHI,79,2546,544,1140,0,2,544,1138,193,264,1281
2013,Chris Bosh,C,28,MIA,74,2454,485,907,21,74,464,833,241,302,1232
2013,Avery Bradley,PG,22,BOS,50,1435,192,478,40,126,152,352,37,49,461
2013,Elton Brand,C,33,DAL,72,1527,226,478,0,1,226,477,66,93,518
2013,Corey Brewer,SF,26,DEN,82,2003,375,883,91,307,284,576,149,216,990
2013,Ronnie Brewer,SF,27,TOT,60,853,70,198,23,76,47,122,16,39,179
2013,Ronnie Brewer,SF,27,NYK,46,711,64,175,22,71,42,104,16,39,166
2013,Ronnie Brewer,SF,27,OKC,14,142,6,23,1,5,5,18,0,0,13
2013,Aaron Brooks,PG,28,TOT,53,997,143,316,50,134,93,182,40,52,376
2013,Aaron Brooks,PG,28,SAC,46,959,139,303,48,127,91,176,40,52,366
2013,Aaron Brooks,PG,28,HOU,7,38,4,13,2,7,2,6,0,0,10
2013,MarShon Brooks,SG,24,BRK,73,912,155,335,15,55,140,280,69,94,394
2013,Kwame Brown,C,30,PHI,22,269,17,37,0,0,17,37,7,19,41
2013,Shannon Brown,SG,27,PHO,59,1402,240,571,39,141,201,430,98,125,617
2013,Kobe Bryant,SG,34,LAL,78,3013,738,1595,132,407,606,1188,525,626,2133
2013,Chase Budinger,SF,24,MIN,23,508,79,191,26,81,53,110,32,42,216
2013,Alec Burks,SG,21,UTA,64,1137,163,388,33,92,130,296,92,129,451
2013,Caron Butler,SF,32,LAC,78,1879,305,720,128,330,177,390,75,90,813
2013,Jimmy Butler,SF,23,CHI,82,2134,239,512,40,105,199,407,187,233,705
2013,Will Bynum,PG,30,DET,65,1219,253,540,24,76,229,464,106,131,636
2013,Jose Calderon,PG,31,TOT,73,2160,312,635,130,282,182,353,72,80,826
2013,Jose Calderon,PG,31,TOR,45,1273,187,398,79,184,108,214,47,52,500
2013,Jose Calderon,PG,31,DET,28,887,125,237,51,98,74,139,25,28,326
2013,Marcus Camby,PF,38,NYK,24,250,17,53,0,0,17,53,8,19,42
2013,DeMarre Carroll,SF,26,UTA,66,1111,149,324,20,70,129,254,75,98,393
2013,Matt Carroll,SG,32,CHA,1,6,0,0,0,0,0,0,0,0,0
2013,Vince Carter,SF,36,DAL,81,2093,372,855,162,399,210,456,182,223,1088
2013,Omri Casspi,SF,24,CLE,43,503,63,160,25,76,38,84,22,41,173
2013,Mario Chalmers,PG,26,MIA,77,2068,227,529,123,301,104,228,89,112,666
2013,Tyson Chandler,C,30,NYK,66,2164,255,400,0,0,255,400,179,258,689
2013,Wilson Chandler,PF,25,DEN,43,1079,210,455,52,126,158,329,88,111,560
2013,Josh Childress,SF,29,BRK,14,100,6,21,1,3,5,18,1,2,14
2013,Earl Clark,PF,25,LAL,59,1363,170,386,35,104,135,282,53,76,428
2013,Victor Claver,SF,24,POR,49,812,74,189,25,87,49,102,14,30,187
2013,Norris Cole,PG,24,MIA,80,1590,179,425,35,98,144,327,52,80,445
2013,Jason Collins,C,34,TOT,38,384,9,29,0,0,9,29,23,32,41
2013,Jason Collins,C,34,BOS,32,330,8,23,0,0,8,23,21,30,37
2013,Jason Collins,C,34,WAS,6,54,1,6,0,0,1,6,2,2,4
2013,Darren Collison,PG,25,DAL,81,2372,341,724,48,136,293,588,242,275,972
2013,Nick Collison,C,32,OKC,81,1583,176,296,0,4,176,292,60,78,412
2013,Mike Conley,PG,25,MEM,80,2757,414,940,106,293,308,647,234,282,1168
2013,Will Conroy,PG,30,MIN,4,20,0,9,0,3,0,6,1,2,1
2013,Daequan Cook,SG,25,TOT,49,441,51,167,26,91,25,76,9,12,137
2013,Daequan Cook,SG,25,HOU,16,165,21,59,11,30,10,29,2,3,55
2013,Daequan Cook,SG,25,CHI,33,276,30,108,15,61,15,47,7,9,82
2013,Chris Copeland,PF,28,NYK,56,862,182,380,59,140,123,240,63,83,486
2013,DeMarcus Cousins,C,22,SAC,75,2289,482,1036,4,22,478,1014,312,423,1280
2013,Jamal Crawford,SG,32,LAC,76,2230,445,1016,149,396,296,620,216,248,1255
2013,Jordan Crawford,SG,24,TOT,70,1709,301,725,83,246,218,479,129,159,814
2013,Jordan Crawford,SG,24,WAS,43,1127,211,508,59,171,152,337,87,106,568
2013,Jordan Crawford,SG,24,BOS,27,582,90,217,24,75,66,142,42,53,246
2013,Jae Crowder,SF,22,DAL,78,1353,141,367,63,192,78,175,47,73,392
2013,Dante Cunningham,PF,25,MIN,80,2010,314,671,0,6,314,665,67,103,695
2013,Jared Cunningham,SG,21,DAL,8,26,6,14,2,3,4,11,2,2,16
2013,Eddy Curry,C,30,DAL,2,25,4,8,0,0,4,8,1,4,9
2013,Stephen Curry,PG,24,GSW,78,2983,626,1388,272,600,354,788,262,291,1786
2013,Samuel Dalembert,C,31,MIL,47,765,137,253,1,1,136,252,38,55,313
2013,Marquis Daniels,SF,32,MIL,59,1085,132,351,20,72,112,279,40,54,324
2013,Anthony Davis,PF,19,NOH,64,1846,349,676,0,6,349,670,169,225,867
2013,Ed Davis,C-PF,23,TOT,81,1631,260,482,0,0,260,482,103,167,623
2013,Ed Davis,C,23,TOR,45,1087,186,339,0,0,186,339,66,102,438
2013,Ed Davis,PF,23,MEM,36,544,74,143,0,0,74,143,37,65,185
2013,Glen Davis,PF,27,ORL,34,1064,214,478,0,2,214,476,84,117,512
2013,Austin Daye,SF,24,TOT,55,676,90,208,41,98,49,110,26,34,247
2013,Austin Daye,SF,24,DET,24,348,43,97,21,40,22,57,15,18,122
2013,Austin Daye,SF,24,MEM,31,328,47,111,20,58,27,53,11,16,125
2013,Nando De,SG,25,SAS,72,920,105,241,31,82,74,159,35,44,276
2013,Carlos Delfino,SF,30,HOU,67,1689,251,620,158,421,93,199,48,56,708
2013,Luol Deng,SF,27,CHI,75,2903,466,1093,75,233,391,860,230,282,1237
2013,Justin Dentmon,PG,27,DAL,2,4,0,2,0,0,0,2,0,0,0
2013,DeMar DeRozan,SG,23,TOR,82,3013,548,1231,34,120,514,1111,355,427,1485
2013,Boris Diaw,PF,30,SAS,75,1709,179,332,30,78,149,254,47,65,435
2013,DeSagana Diop,C,31,CHA,22,226,8,27,0,1,8,26,0,1,16
2013,Keyon Dooling,PG,32,MEM,7,82,10,21,5,12,5,9,6,7,31
2013,Toney Douglas,PG,26,TOT,71,1289,188,466,82,216,106,250,76,84,534
2013,Toney Douglas,PG,26,HOU,49,913,139,352,61,162,78,190,60,68,399
2013,Toney Douglas,PG,26,SAC,22,376,49,114,21,54,28,60,16,16,135
2013,Chris Douglas-Roberts,SG,26,DAL,6,63,5,14,0,4,5,10,7,10,17
2013,Goran Dragic,PG,26,PHO,77,2581,401,906,88,276,313,630,244,326,1134
2013,Andre Drummond,C,19,DET,60,1243,208,342,1,2,207,340,59,159,476
2013,Jared Dudley,SF,27,PHO,79,2170,313,669,106,271,207,398,129,162,861
2013,Chris Duhon,PG,30,LAL,46,820,47,123,33,91,14,32,6,13,133
2013,Tim Duncan,C,36,SAS,69,2078,490,976,2,7,488,969,245,300,1227
2013,Mike Dunleavy,SF,32,MIL,75,1943,276,624,128,299,148,325,105,128,785
2013,Kevin Durant,SF,24,OKC,81,3119,731,1433,139,334,592,1099,679,750,2280
2013,Devin Ebanks,SF,23,LAL,19,197,24,73,6,22,18,51,11,14,65
2013,Wayne Ellington,SG,25,TOT,78,1661,226,529,94,240,132,289,68,75,614
2013,Wayne Ellington,SG,25,MEM,40,676,81,199,41,97,40,102,15,16,218
2013,Wayne Ellington,SG,25,CLE,38,985,145,330,53,143,92,187,53,59,396
2013,Monta Ellis,SG,27,MIL,82,3076,597,1436,94,328,503,1108,289,374,1577
2013,Kim English,SG,24,DET,41,407,42,112,14,50,28,62,21,29,119
2013,Jeremy Evans,PF,25,UTA,37,215,27,44,0,1,27,43,21,33,75
2013,Reggie Evans,PF,32,BRK,80,1967,125,261,0,0,125,261,113,222,363
2013,Tyreke Evans,SG,23,SAC,65,2016,366,765,45,133,321,632,210,271,987
2013,Festus Ezeli,C,23,GSW,78,1120,74,169,0,0,74,169,43,81,191
2013,Kenneth Faried,PF,23,DEN,80,2248,380,689,0,0,380,689,163,266,923
2013,Derrick Favors,PF,21,UTA,77,1787,274,568,0,5,274,563,179,260,727
2013,Raymond Felton,PG,28,NYK,68,2313,377,882,93,258,284,624,101,128,948
2013,Landry Fields,SF,24,TOR,51,1037,102,223,2,14,100,209,34,53,240
2013,Derek Fisher,SG-PG,38,TOT,33,575,55,161,30,80,25,81,35,38,175
2013,Derek Fisher,PG,38,DAL,9,229,23,65,10,23,13,42,21,23,77
2013,Derek Fisher,SG,38,OKC,24,346,32,96,20,57,12,39,14,15,98
2013,Evan Fournier,SG,20,DEN,38,428,75,152,22,54,53,98,30,39,202
2013,Randy Foye,SG,29,UTA,82,2249,293,738,178,434,115,304,118,144,882
2013,Jimmer Fredette,SG,23,SAC,69,967,172,409,65,156,107,253,85,99,494
2013,Joel Freeland,PF,25,POR,51,477,58,142,0,0,58,142,18,27,134
2013,Danilo Gallinari,SF,24,DEN,71,2309,364,871,135,362,229,509,286,348,1149
2013,Francisco Garcia,SG-SF,31,TOT,58,1029,118,300,67,179,51,121,18,21,321
2013,Francisco Garcia,SG,31,SAC,40,710,77,205,40,109,37,96,12,14,206
2013,Francisco Garcia,SF,31,HOU,18,319,41,95,27,70,14,25,6,7,115
2013,Kevin Garnett,C,36,BOS,68,2022,422,850,2,16,420,834,158,201,1004
2013,Diante Garrett,PG,24,PHO,19,149,16,49,3,15,13,34,5,10,40
2013,Marc Gasol,C,28,MEM,80,2796,429,869,1,14,428,855,268,316,1127
2013,Pau Gasol,PF,32,LAL,49,1655,270,579,8,28,262,551,125,178,673
2013,Rudy Gay,SF,26,TOT,75,2687,521,1253,84,260,437,993,240,295,1366
2013,Rudy Gay,SF,26,MEM,42,1541,281,688,40,129,241,559,121,156,723
2013,Rudy Gay,SF,26,TOR,33,1146,240,565,44,131,196,434,119,139,643
2013,Alonzo Gee,SF,25,CLE,82,2541,305,744,69,219,236,525,163,205,842
2013,Mickael Gelabale,SF,29,MIN,36,644,72,139,16,52,56,87,21,24,181
2013,Paul George,SF,22,IND,79,2972,493,1176,170,469,323,707,221,274,1377
2013,Daniel Gibson,PG,26,CLE,46,919,84,247,56,163,28,84,26,37,250
2013,Taj Gibson,PF,27,CHI,65,1459,214,441,0,4,214,437,89,131,517
2013,Manu Ginobili,SG,35,SAS,60,1393,229,539,83,235,146,304,164,206,705
2013,Drew Gooden,C,31,MIL,16,151,20,61,1,5,19,56,11,16,52
2013,Ben Gordon,SG,29,CHA,75,1560,310,760,113,292,197,468,107,127,840
2013,Eric Gordon,SG,24,NOH,42,1264,235,584,56,173,179,411,187,222,713
2013,Marcin Gortat,C,28,PHO,61,1876,295,566,0,3,295,563,90,138,680
2013,Andrew Goudelock,SG,24,LAL,1,6,0,2,0,0,0,2,0,0,0
2013,Danny Granger,SF,29,IND,5,74,10,35,2,10,8,25,5,8,27
2013,Aaron Gray,C,28,TOR,42,513,48,90,0,0,48,90,23,44,119
2013,Danny Green,SG,25,SAS,80,2201,297,663,177,413,120,250,67,79,838
2013,Draymond Green,SF,22,GSW,79,1061,84,257,14,67,70,190,45,55,227
2013,Gerald Green,SF,27,IND,60,1080,155,424,59,188,96,236,52,65,421
2013,Jeff Green,PF,26,BOS,81,2252,376,806,70,182,306,624,214,265,1036
2013,Willie Green,SG,31,LAC,72,1188,178,386,71,166,107,220,23,32,450
2013,Blake Griffin,PF,23,LAC,80,2598,577,1072,5,28,572,1044,281,426,1440
2013,Hamed Haddadi,C,27,TOT,30,322,35,82,0,0,35,82,14,27,84
2013,Hamed Haddadi,C,27,MEM,13,87,7,21,0,0,7,21,1,2,15
2013,Hamed Haddadi,C,27,PHO,17,235,28,61,0,0,28,61,13,25,69
2013,Jordan Hamilton,SF,22,DEN,40,397,84,201,27,73,57,128,13,26,208
2013,Richard Hamilton,SG,34,CHI,50,1088,204,475,16,52,188,423,66,77,490
2013,Ben Hansbrough,PG,25,IND,28,200,15,45,6,23,9,22,21,27,57
2013,Tyler Hansbrough,PF,27,IND,81,1366,176,407,0,3,176,404,216,300,568
2013,James Harden,SG,23,HOU,78,2985,585,1337,179,486,406,851,674,792,2023
2013,Maurice Harkless,SF,19,ORL,76,1974,260,564,32,117,228,447,73,128,625
2013,Josh Harrellson,C,23,MIA,6,31,4,9,1,5,3,4,1,2,10
2013,Al Harrington,C,32,ORL,10,119,20,57,8,30,12,27,3,4,51
2013,Devin Harris,SG,29,ATL,58,1421,194,443,77,230,117,213,112,154,577
2013,Terrel Harris,SG,25,TOT,20,137,4,27,0,8,4,19,7,10,15
2013,Terrel Harris,SG,25,MIA,7,29,2,8,0,1,2,7,6,8,10
2013,Terrel Harris,SG,25,NOH,13,108,2,19,0,7,2,12,1,2,5
2013,Tobias Harris,SF-PF,20,TOT,55,1299,233,512,34,108,199,404,103,137,603
2013,Tobias Harris,SF,20,MIL,28,325,53,115,7,21,46,94,23,26,136
2013,Tobias Harris,PF,20,ORL,27,974,180,397,27,87,153,310,80,111,467
2013,Udonis Haslem,PF,32,MIA,75,1414,129,251,0,0,129,251,32,45,290
2013,Spencer Hawes,C,24,PHI,82,2233,376,811,31,87,345,724,122,157,905
2013,Chuck Hayes,C,29,SAC,74,1209,84,190,0,1,84,189,30,48,198
2013,Gordon Hayward,SF,22,UTA,72,2104,336,773,102,246,234,527,243,294,1017
2013,Lazar Hayward,SF,26,MIN,4,31,2,10,0,4,2,6,6,6,10
2013,Brendan Haywood,C,33,CHA,61,1162,93,216,0,1,93,215,30,66,216
2013,Gerald Henderson,SG,25,CHA,68,2133,382,855,33,100,349,755,258,313,1055
2013,Xavier Henry,SF,21,NOH,50,625,66,161,4,11,62,150,58,92,194
2013,John Henson,PF,22,MIL,63,827,162,336,0,3,162,333,56,105,380
2013,Roy Hibbert,C,26,IND,79,2269,385,859,1,4,384,855,166,224,937
2013,J.J. Hickson,C,24,POR,80,2323,418,744,0,2,418,742,182,268,1018
2013,Cory Higgins,SG,23,CHA,6,32,6,19,1,5,5,14,1,2,14
2013,Nene Hilario,PF,30,WAS,61,1659,285,594,0,1,285,593,196,269,766
2013,George Hill,PG,26,IND,76,2620,386,871,130,353,256,518,174,213,1076
2013,Grant Hill,SF,40,LAC,29,437,38,98,3,11,35,87,14,24,93
2013,Jordan Hill,PF,25,LAL,29,458,77,155,0,2,77,153,40,61,194
2013,Kirk Hinrich,PG,32,CHI,60,1764,159,422,71,182,88,240,70,98,459
2013,Jrue Holiday,PG,22,PHI,78,2926,555,1288,91,247,464,1041,182,242,1383
2013,Justin Holiday,SG,23,PHI,9,142,16,48,4,16,12,32,6,8,42
2013,Ryan Hollins,C,28,LAC,60,663,70,114,0,0,70,114,66,88,206
2013,Tyler Honeycutt,SF,22,SAC,9,32,3,11,0,2,3,9,2,2,8
2013,Al Horford,C,26,ATL,74,2756,576,1060,3,6,573,1054,134,208,1289
2013,Dwight Howard,C,27,LAL,76,2722,470,813,1,6,469,807,355,721,1296
2013,Josh Howard,SF,32,MIN,11,207,31,77,5,16,26,61,7,12,74
2013,Juwan Howard,PF,39,MIA,7,51,10,19,0,0,10,19,1,1,21
2013,Kris Humphries,PF,27,BRK,65,1191,139,310,0,2,139,308,97,123,375
2013,Serge Ibaka,PF,23,OKC,80,2486,446,778,20,57,426,721,143,191,1055
2013,Andre Iguodala,SG,29,DEN,80,2779,396,879,91,287,305,592,155,270,1038
2013,Ersan Ilyasova,PF,25,MIL,73,2012,371,803,95,214,276,589,125,157,962
2013,Kyrie Irving,PG,20,CLE,59,2048,484,1070,109,279,375,791,248,290,1325
2013,Royal Ivey,SG,31,PHI,53,698,62,144,37,88,25,56,9,16,170
2013,Jarrett Jack,SG,29,GSW,79,2349,387,857,82,203,305,654,167,198,1023
2013,Reggie Jackson,PG,22,OKC,70,993,149,325,24,104,125,221,52,62,374
2013,Stephen Jackson,SF,34,SAS,55,1075,123,330,46,170,77,160,49,70,341
2013,Bernard James,C,27,DAL,46,457,53,103,0,2,53,101,25,41,131
2013,Damion James,SF,25,BRK,2,0,0,0,0,0,0,0,0,0,0
2013,LeBron James,PF,28,MIA,76,2877,765,1354,103,254,662,1100,403,535,2036
2013,Mike James,PG,37,DAL,45,862,101,271,48,125,53,146,23,29,273
2013,Antawn Jamison,PF,36,LAL,76,1636,267,575,84,233,183,342,94,136,712
2013,Al Jefferson,C,28,UTA,78,2578,611,1236,2,17,609,1219,167,217,1391
2013,Richard Jefferson,SF,32,GSW,56,568,62,136,14,45,48,91,38,53,176
2013,Jared Jeffries,PF,31,POR,38,350,16,54,0,2,16,52,12,23,44
2013,Charles Jenkins,SG-PG,23,TOT,59,441,49,121,1,2,48,119,12,22,111
2013,Charles Jenkins,SG,23,GSW,47,291,35,83,1,2,34,81,10,18,81
2013,Charles Jenkins,PG,23,PHI,12,150,14,38,0,0,14,38,2,4,30
2013,John Jenkins,SG,21,ATL,61,902,131,294,53,138,78,156,59,70,374
2013,Brandon Jennings,PG,23,MIL,80,2897,497,1247,173,461,324,786,230,281,1397
2013,Jonas Jerebko,PF,25,DET,49,892,142,316,25,83,117,233,68,88,377
2013,Amir Johnson,PF,25,TOR,81,2325,336,606,5,13,331,593,136,187,813
2013,Chris Johnson,C,27,MIN,30,284,48,75,0,0,48,75,21,34,117
2013,Chris Johnson,SF,22,MEM,8,102,11,25,6,18,5,7,1,2,29
2013,Ivan Johnson,PF,28,ATL,69,1035,185,356,1,13,184,343,81,131,452
2013,James Johnson,SF,25,SAC,54,878,117,283,2,21,115,262,40,67,276
2013,Joe Johnson,SG,31,BRK,72,2642,445,1052,148,395,297,657,132,161,1170
2013,Orlando Johnson,SG,23,IND,51,619,72,180,36,94,36,86,23,32,203
2013,Wesley Johnson,SF,25,PHO,50,953,161,396,50,155,111,241,27,35,399
2013,Darius Johnson-Odom,SG,23,LAL,4,6,0,4,0,1,0,3,0,0,0
2013,Dahntay Jones,SF,32,TOT,78,1016,82,222,11,49,71,173,87,113,262
2013,Dahntay Jones,SF,32,DAL,50,635,50,140,8,37,42,103,66,82,174
2013,Dahntay Jones,SF,32,ATL,28,381,32,82,3,12,29,70,21,31,88
2013,DeQuan Jones,SF,22,ORL,63,803,95,218,9,35,86,183,34,51,233
2013,Dominique Jones,PG,24,DAL,29,338,40,109,1,9,39,100,35,53,116
2013,James Jones,SF,32,MIA,38,221,21,61,16,53,5,8,2,4,60
2013,Kevin Jones,PF,23,CLE,32,334,43,107,0,0,43,107,9,15,95
2013,Perry Jones,SF,21,OKC,38,280,39,99,0,2,39,97,10,15,88
2013,Solomon Jones,PF,28,NYK,2,26,0,1,0,0,0,1,0,0,0
2013,Terrence Jones,PF,21,HOU,19,276,43,94,5,19,38,75,13,17,104
2013,DeAndre Jordan,C,24,LAC,82,2010,314,488,0,0,314,488,96,249,724
2013,Cory Joseph,PG,21,SAS,28,388,51,110,6,21,45,89,18,21,126
2013,Kris Joseph,SF,24,TOT,10,54,2,14,0,3,2,11,5,8,9
2013,Kris Joseph,SF,24,BOS,6,24,2,11,0,2,2,9,3,4,7
2013,Kris Joseph,SF,24,BRK,4,30,0,3,0,1,0,2,2,4,2
2013,Chris Kaman,C,30,DAL,66,1363,313,617,0,1,313,616,67,85,693
2013,Enes Kanter,C,20,UTA,70,1078,206,379,1,1,205,378,93,117,506
2013,Jason Kidd,SG,39,NYK,76,2043,152,409,114,325,38,84,40,48,458
2013,Michael Kidd-Gilchrist,SF,19,CHA,78,2025,281,613,2,9,279,604,140,187,704
2013,Andrei Kirilenko,SF,31,MIN,64,2034,284,560,35,120,249,440,188,250,791
2013,Linas Kleiza,SF,28,TOR,20,376,48,144,20,66,28,78,32,38,148
2013,Brandon Knight,PG,21,DET,75,2365,357,878,120,327,237,551,165,225,999
2013,Kyle Korver,SF,31,ATL,74,2259,277,601,189,414,88,187,67,78,810
2013,Kosta Koufos,C,23,DEN,81,1817,295,508,0,1,295,507,58,104,648
2013,Viacheslav Kravtsov,C,25,DET,25,224,33,46,0,0,33,46,11,37,77
2013,Doron Lamb,SG,21,TOT,47,577,60,163,14,37,46,126,20,34,154
2013,Doron Lamb,SG,21,MIL,23,280,33,95,4,16,29,79,8,15,78
2013,Doron Lamb,SG,21,ORL,24,297,27,68,10,21,17,47,12,19,76
2013,Jeremy Lamb,SF,20,OKC,23,147,24,68,9,30,15,38,14,14,71
2013,Carl Landry,PF,29,GSW,81,1876,325,602,1,3,324,599,223,273,874
2013,Ty Lawson,PG,25,DEN,73,2513,448,971,85,232,363,739,235,311,1216
2013,Courtney Lee,SG,27,BOS,78,1941,246,530,58,156,188,374,62,72,612
2013,David Lee,PF,29,GSW,79,2907,602,1160,0,4,602,1156,255,320,1459
2013,Malcolm Lee,SG,22,MIN,16,289,29,76,8,24,21,52,12,20,78
2013,Kawhi Leonard,SF,21,SAS,58,1810,260,526,65,174,195,352,104,126,689
2013,Meyers Leonard,C,20,POR,69,1206,151,277,3,7,148,270,72,89,377
2013,Jon Leuer,PF-C,23,TOT,28,187,25,52,0,3,25,49,6,13,56
2013,Jon Leuer,C,23,CLE,9,91,10,28,0,3,10,25,2,6,22
2013,Jon Leuer,PF,23,MEM,19,96,15,24,0,0,15,24,4,7,34
2013,Rashard Lewis,PF,33,MIA,55,792,103,249,51,131,52,118,28,45,285
2013,DeAndre Liggins,SG,24,OKC,39,290,21,47,7,19,14,28,9,18,58
2013,Damian Lillard,PG,22,POR,82,3167,553,1288,185,503,368,785,271,321,1562
2013,Jeremy Lin,PG,24,HOU,82,2640,396,897,87,257,309,640,216,275,1095
2013,Shaun Livingston,PG,27,TOT,66,1455,166,346,0,4,166,342,85,98,417
2013,Shaun Livingston,PG,27,WAS,17,320,24,66,0,3,24,63,15,15,63
2013,Shaun Livingston,PG,27,CLE,49,1135,142,280,0,1,142,279,70,83,354
2013,Brook Lopez,C,24,BRK,74,2253,570,1094,0,1,570,1093,297,392,1437
2013,Robin Lopez,C,24,NOH,82,2136,384,719,0,0,384,719,161,207,929
2013,Kevin Love,PF,24,MIN,18,618,105,298,20,92,85,206,100,142,330
2013,Kyle Lowry,PG,26,TOR,68,2020,250,623,101,279,149,344,190,239,791
2013,John Lucas,PG,30,TOR,63,827,129,334,57,151,72,183,18,25,333
2013,Scott Machado,PG,22,HOU,6,21,3,6,0,1,3,5,2,2,8
2013,Shelvin Mack,PG-SG,22,TOT,31,416,58,126,18,49,40,77,9,16,143
2013,Shelvin Mack,PG,22,WAS,7,141,16,40,4,13,12,27,1,2,37
2013,Shelvin Mack,SG,22,PHI,4,7,1,2,0,1,1,1,0,0,2
2013,Shelvin Mack,PG,22,ATL,20,268,41,84,14,35,27,49,8,14,104
2013,Corey Maggette,SF,33,DET,18,257,27,76,5,21,22,55,36,48,95
2013,Ian Mahinmi,C,26,IND,80,1322,149,329,0,2,149,327,104,171,402
2013,Shawn Marion,PF,34,DAL,67,2010,355,690,23,73,332,617,79,101,812
2013,Kendall Marshall,PG,21,PHO,48,702,56,151,23,73,33,78,8,14,143
2013,Cartier Martin,SF,28,WAS,41,694,96,252,58,146,38,106,20,28,270
2013,Kenyon Martin,C,35,NYK,18,431,56,93,0,0,56,93,17,40,129
2013,Kevin Martin,SG,29,OKC,77,2136,350,778,158,371,192,407,219,246,1077
2013,Roger Mason,SG,32,NOH,69,1219,132,305,66,159,66,146,39,43,369
2013,Wesley Matthews,SG,26,POR,69,2403,352,808,169,425,183,383,149,187,1022
2013,Jason Maxiell,PF,29,DET,72,1789,204,457,0,0,204,457,90,145,498
2013,Eric Maynor,PG-SG,25,TOT,64,963,106,281,34,96,72,185,45,62,291
2013,Eric Maynor,PG,25,OKC,37,391,36,115,15,46,21,69,17,21,104
2013,Eric Maynor,SG,25,POR,27,572,70,166,19,50,51,116,28,41,187
2013,O.J. Mayo,SG,25,DAL,82,2913,461,1026,142,349,319,677,191,233,1255
2013,Luc Mbah,SF,26,MIL,58,1326,151,377,13,37,138,340,72,126,387
2013,JaVale McGee,C,25,DEN,79,1433,303,527,1,1,302,526,110,186,717
2013,Dominic McGuire,SF,27,TOT,26,387,24,56,0,0,24,56,3,10,51
2013,Dominic McGuire,SF,27,TOR,15,230,15,32,0,0,15,32,2,6,32
2013,Dominic McGuire,SF,27,NOH,9,145,9,21,0,0,9,21,1,2,19
2013,Dominic McGuire,SF,27,IND,2,12,0,3,0,0,0,3,0,2,0
2013,Josh McRoberts,PF,25,TOT,67,1487,156,343,24,84,132,259,65,85,401
2013,Josh McRoberts,PF,25,ORL,41,685,60,153,17,55,43,98,22,30,159
2013,Josh McRoberts,PF,25,CHA,26,802,96,190,7,29,89,161,43,55,242
2013,Jodie Meeks,SG,25,LAL,78,1663,205,530,122,342,83,188,86,96,618
2013,Fab Melo,C,22,BOS,6,36,3,6,0,0,3,6,1,4,7
2013,Khris Middleton,SG,21,DET,27,475,62,141,14,45,48,96,27,32,165
2013,C.J. Miles,SF,25,CLE,65,1364,255,614,126,328,129,286,93,107,729
2013,Darko Milicic,C,27,BOS,1,5,0,1,0,0,0,1,0,0,0
2013,Andre Miller,PG,36,DEN,82,2151,303,632,17,64,286,568,163,194,786
2013,Darius Miller,SF,22,NOH,52,694,44,108,22,56,22,52,8,8,118
2013,Mike Miller,SF,32,MIA,59,900,100,231,73,175,27,56,8,11,281
2013,Quincy Miller,PF,20,DEN,7,26,4,12,0,1,4,11,1,2,9
2013,Patty Mills,PG,24,SAS,58,656,113,241,52,130,61,111,16,19,294
2013,Paul Millsap,PF,27,UTA,78,2375,429,875,13,39,416,836,264,356,1135
2013,Nazr Mohammed,C,35,CHI,63,693,66,180,0,2,66,178,34,47,166
2013,Greg Monroe,C,22,DET,81,2687,514,1058,0,4,514,1054,270,392,1298
2013,E'Twaun Moore,SG,23,ORL,75,1682,237,598,67,197,170,401,47,59,588
2013,Darius Morris,PG,22,LAL,48,683,73,188,24,66,49,122,24,37,194
2013,Marcus Morris,PF-SF,23,TOT,77,1524,222,526,86,233,136,293,66,117,596
2013,Marcus Morris,PF,23,HOU,54,1154,171,400,74,194,97,206,49,75,465
2013,Marcus Morris,SF,23,PHO,23,370,51,126,12,39,39,87,17,42,131
2013,Markieff Morris,PF,23,PHO,82,1837,266,653,45,134,221,519,93,127,670
2013,Anthony Morrow,SG,27,TOT,41,383,64,145,16,43,48,102,20,22,164
2013,Anthony Morrow,SG,27,ATL,24,301,47,111,15,38,32,73,16,18,125
2013,Anthony Morrow,SG,27,DAL,17,82,17,34,1,5,16,29,4,4,39
2013,Donatas Motiejunas,PF,22,HOU,44,538,97,213,24,83,73,130,32,51,250
2013,Arnett Moultrie,PF,22,PHI,47,542,78,134,0,0,78,134,18,28,174
2013,Timofey Mozgov,C,26,DEN,41,366,44,87,0,2,44,85,20,26,108
2013,Byron Mullens,PF,23,CHA,53,1428,217,563,66,208,151,355,64,99,564
2013,Kevin Murphy,SG,22,UTA,17,52,7,28,1,5,6,23,0,0,15
2013,Troy Murphy,PF,32,DAL,14,256,22,61,11,35,11,26,10,11,65
2013,Steve Nash,PG,38,LAL,50,1627,236,475,57,130,179,345,107,116,636
2013,Gary Neal,SG,28,SAS,68,1484,246,597,89,251,157,346,64,74,645
2013,Jameer Nelson,PG,30,ORL,56,1977,306,780,121,355,185,425,89,102,822
2013,Andrew Nicholson,PF,23,ORL,75,1249,256,486,0,0,256,486,75,94,587
2013,Joakim Noah,C,27,CHI,66,2426,303,630,0,5,303,625,178,237,784
2013,Steve Novak,SF,29,NYK,81,1641,178,430,149,351,29,79,30,33,535
2013,Dirk Nowitzki,PF,34,DAL,53,1661,343,728,65,157,278,571,166,193,917
2013,Jermaine O'Neal,C,34,PHO,55,1029,179,371,0,0,179,371,96,115,454
2013,Kyle O'Quinn,C,22,ORL,57,638,101,197,0,1,101,196,30,45,232
2013,Lamar Odom,PF,33,LAC,82,1616,146,366,18,90,128,276,20,42,330
2013,Tim Ohlbrecht,C,24,HOU,3,12,1,3,0,0,1,3,1,1,3
2013,Emeka Okafor,C,30,WAS,79,2052,328,687,0,0,328,687,109,191,765
2013,Daniel Orton,C,22,OKC,13,104,12,26,0,0,12,26,9,17,33
2013,Travis Outlaw,SF,28,SAC,38,444,74,177,14,50,60,127,38,52,200
2013,Zaza Pachulia,C,28,ATL,52,1134,114,241,0,3,114,238,78,103,306
2013,Jannero Pargo,PG,33,TOT,32,507,78,212,39,116,39,96,12,13,207
2013,Jannero Pargo,PG,33,WAS,7,102,8,32,3,20,5,12,2,2,21
2013,Jannero Pargo,PG,33,ATL,7,113,13,38,7,20,6,18,2,2,35
2013,Jannero Pargo,PG,33,CHA,18,292,57,142,29,76,28,66,8,9,151
2013,Jeremy Pargo,PG-SG,26,TOT,39,655,99,250,25,74,74,176,42,62,265
2013,Jeremy Pargo,PG,26,CLE,25,447,75,187,18,57,57,130,28,41,196
2013,Jeremy Pargo,SG,26,PHI,14,208,24,63,7,17,17,46,14,21,69
2013,Tony Parker,PG,30,SAS,66,2174,519,995,24,68,495,927,279,330,1341
2013,Chandler Parsons,SF,24,HOU,76,2758,456,939,152,395,304,544,113,155,1177
2013,Patrick Patterson,PF,23,TOT,71,1775,319,623,51,132,268,491,48,63,737
2013,Patrick Patterson,PF,23,HOU,47,1219,236,455,35,96,201,359,37,49,544
2013,Patrick Patterson,PF,23,SAC,24,556,83,168,16,36,67,132,11,14,193
2013,Chris Paul,PG,27,LAC,70,2335,412,856,76,232,336,624,286,323,1186
2013,Sasha Pavlovic,SG,29,POR,39,528,42,119,18,60,24,59,1,6,103
2013,Nikola Pekovic,C,27,MIN,62,1959,385,741,0,0,385,741,241,324,1011
2013,Kendrick Perkins,C,28,OKC,78,1954,143,313,0,1,143,312,44,72,330
2013,Johan Petro,C,27,ATL,31,352,48,110,1,4,47,106,11,12,108
2013,Paul Pierce,SF,35,BOS,77,2575,476,1092,145,382,331,710,333,423,1430
2013,Mickael Pietrus,SF,30,TOR,19,386,34,98,20,64,14,34,12,18,100
2013,Dexter Pittman,C,24,TOT,11,32,4,11,0,0,4,11,0,3,8
2013,Dexter Pittman,C,24,MIA,4,12,3,5,0,0,3,5,0,0,6
2013,Dexter Pittman,C,24,MEM,7,20,1,6,0,0,1,6,0,3,2
2013,Miles Plumlee,C,24,IND,14,55,5,21,0,0,5,21,3,4,13
2013,Quincy Pondexter,SF,24,MEM,59,1243,128,299,60,152,68,147,59,75,375
2013,A.J. Price,PG,26,WAS,57,1278,161,413,70,200,91,213,49,62,441
2013,Ronnie Price,PG,29,POR,39,510,39,120,10,39,29,81,17,24,105
2013,Pablo Prigioni,PG,35,NYK,78,1263,100,220,53,134,47,86,22,25,275
2013,Tayshaun Prince,SF,32,TOT,82,2631,359,820,38,94,321,726,96,130,852
2013,Tayshaun Prince,SF,32,DET,45,1457,215,484,23,53,192,431,74,93,527
2013,Tayshaun Prince,SF,32,MEM,37,1174,144,336,15,41,129,295,22,37,325
2013,Joel Przybilla,C,33,MIL,12,68,1,4,0,0,1,4,0,2,2
2013,Chris Quinn,SG,29,CLE,7,78,4,16,0,5,4,11,2,2,10
2013,Vladimir Radmanovic,PF,32,CHI,25,144,13,43,5,27,8,16,2,3,33
2013,Anthony Randolph,PF,23,DEN,39,329,56,114,0,8,56,106,31,45,143
2013,Shavlik Randolph,PF,29,BOS,16,198,28,48,0,0,28,48,11,27,67
2013,Zach Randolph,PF,31,MEM,76,2607,471,1024,2,23,469,1001,225,300,1169
2013,J.J. Redick,SG,28,TOT,78,2379,382,880,165,451,217,429,171,190,1100
2013,J.J. Redick,SG,28,ORL,50,1575,262,582,117,300,145,282,115,129,756
2013,J.J. Redick,SG,28,MIL,28,804,120,298,48,151,72,147,56,61,344
2013,Jason Richardson,SG,32,PHI,33,936,135,336,57,167,78,169,20,33,347
2013,Quentin Richardson,SF,32,NYK,1,29,1,11,1,4,0,7,2,2,5
2013,Luke Ridnour,SG,31,MIN,82,2474,367,811,66,212,301,599,139,164,939
2013,Austin Rivers,SG,20,NOH,61,1418,145,390,28,86,117,304,59,108,377
2013,Brian Roberts,PG,27,NOH,78,1324,213,511,59,153,154,358,70,77,555
2013,Nate Robinson,PG,28,CHI,82,2086,399,921,141,348,258,573,135,169,1074
2013,Thomas Robinson,PF,21,TOT,70,1056,138,321,0,1,138,320,57,109,333
2013,Thomas Robinson,PF,21,SAC,51,809,103,243,0,0,103,243,41,71,247
2013,Thomas Robinson,PF,21,HOU,19,247,35,78,0,1,35,77,16,38,86
2013,Rajon Rondo,PG,26,BOS,38,1423,225,465,12,50,213,415,60,93,522
2013,Terrence Ross,SG,21,TOR,73,1239,186,457,65,196,121,261,30,42,467
2013,Brandon Roy,SG,28,MIN,5,122,11,35,0,9,11,26,7,10,29
2013,Ricky Rubio,PG,22,MIN,57,1691,185,514,27,92,158,422,211,264,608
2013,Brandon Rush,SF,27,GSW,2,25,6,9,0,2,6,7,2,3,14
2013,Robert Sacre,C,23,LAL,32,203,18,48,0,0,18,48,7,11,43
2013,John Salmons,SF,33,SAC,76,2278,244,612,99,267,145,345,85,110,672
2013,Samardo Samuels,C,24,CLE,18,196,22,60,0,1,22,59,14,24,58
2013,Larry Sanders,C,24,MIL,71,1937,306,605,0,2,306,603,84,136,696
2013,Luis Scola,PF,32,PHO,82,2184,432,915,3,16,429,899,181,230,1048
2013,Mike Scott,PF,24,ATL,40,376,70,147,0,1,70,146,43,56,183
2013,Thabo Sefolosha,SG,28,OKC,81,2229,224,466,108,258,116,208,57,69,613
2013,Josh Selby,PG,21,MEM,10,59,6,22,1,6,5,16,7,11,20
2013,Kevin Seraphin,C,23,WAS,79,1721,330,716,0,0,330,716,61,88,721
2013,Ramon Sessions,SG,26,CHA,61,1652,276,676,33,107,243,569,291,347,876
2013,Tornike Shengelia,SF,21,BRK,19,93,10,23,1,2,9,21,9,16,30
2013,Iman Shumpert,SG,22,NYK,45,996,109,275,51,127,58,148,36,47,305
2013,Alexey Shved,SG,24,MIN,77,1840,236,635,85,288,151,347,108,150,665
2013,Henry Sims,C,22,NOH,2,5,2,3,0,0,2,3,0,0,4
2013,Kyle Singler,SF,24,DET,82,2293,275,642,70,200,205,442,100,124,720
2013,Chris Singleton,PF,23,WAS,57,924,92,241,7,36,85,205,40,70,231
2013,Donald Sloan,SG-PG,25,TOT,23,263,27,78,7,19,20,59,20,25,81
2013,Donald Sloan,SG,25,CLE,20,257,27,78,7,19,20,59,20,25,81
2013,Donald Sloan,PG,25,NOH,3,6,0,0,0,0,0,0,0,0,0
2013,Greg Smith,C,22,HOU,70,1110,170,274,0,1,170,273,81,130,421
2013,Ish Smith,PG,24,TOT,52,516,56,159,8,27,48,132,3,7,123
2013,Ish Smith,PG,24,ORL,36,378,39,116,4,17,35,99,3,7,85
2013,Ish Smith,PG,24,MIL,16,138,17,43,4,10,13,33,0,0,38
2013,J.R. Smith,SG,27,NYK,80,2678,527,1249,155,436,372,813,237,311,1446
2013,Jason Smith,C,26,NOH,51,876,167,341,0,4,167,337,86,102,420
2013,Josh Smith,PF,27,ATL,76,2683,550,1182,61,201,489,981,166,321,1327
2013,Nolan Smith,PG,24,POR,40,288,42,114,6,28,36,86,20,28,110
2013,Marreese Speights,C,25,TOT,79,1300,260,584,3,10,257,574,135,175,658
2013,Marreese Speights,C,25,MEM,40,579,106,247,2,5,104,242,48,67,262
2013,Marreese Speights,C,25,CLE,39,721,154,337,1,5,153,332,87,108,396
2013,Tiago Splitter,PF,28,SAS,81,1997,315,563,0,2,315,561,208,285,838
2013,Jerry Stackhouse,SF,38,BRK,37,544,66,172,30,89,36,83,20,23,182
2013,Lance Stephenson,SG,22,IND,78,2278,275,598,62,188,213,410,75,115,687
2013,DeShawn Stevenson,SG,31,ATL,56,1158,98,262,76,209,22,53,12,23,284
2013,Greg Stiemsma,C,27,MIN,76,1209,127,278,0,0,127,278,53,69,307
2013,Julyan Stone,PG,24,DEN,4,28,2,2,0,0,2,2,3,4,7
2013,Amar'e Stoudemire,PF,30,NYK,29,682,154,267,0,0,154,267,105,130,413
2013,Rodney Stuckey,SG,26,DET,76,2171,304,748,55,182,249,566,213,272,876
2013,Jared Sullinger,PF,20,BOS,45,892,111,225,1,5,110,220,47,63,270
2013,DaJuan Summers,PF,25,LAC,2,7,1,4,0,0,1,4,0,0,2
2013,Jeffery Taylor,SF,23,CHA,77,1507,172,399,53,154,119,245,75,103,472
2013,Tyshawn Taylor,PG,22,BRK,38,221,32,87,6,13,26,74,15,27,85
2013,Jeff Teague,PG,24,ATL,80,2628,439,974,89,248,350,726,199,226,1166
2013,Marquis Teague,PG,19,CHI,48,392,43,113,4,23,39,90,9,16,99
2013,Mirza Teletovic,PF,27,BRK,53,499,71,185,37,108,34,77,9,11,188
2013,Sebastian Telfair,PG,27,TOT,59,980,112,309,53,150,59,159,54,69,331
2013,Sebastian Telfair,PG,27,PHO,46,795,94,247,43,113,51,134,44,57,275
2013,Sebastian Telfair,PG,27,TOR,13,185,18,62,10,37,8,25,10,12,56
2013,Garrett Temple,SG,26,WAS,51,1156,105,258,26,80,79,178,26,37,262
2013,Jason Terry,SG,35,BOS,79,2124,281,648,123,331,158,317,114,131,799
2013,Hasheem Thabeet,C,25,OKC,66,770,64,106,0,0,64,106,32,53,160
2013,Isaiah Thomas,PG,23,SAC,79,2122,366,832,115,321,251,511,253,287,1100
2013,Kurt Thomas,PF,40,NYK,39,392,45,83,1,1,44,82,6,13,97
2013,Lance Thomas,SF,24,NOH,59,646,53,106,0,0,53,106,43,59,149
2013,Malcolm Thomas,PF,24,TOT,12,57,5,10,0,0,5,10,5,8,15
2013,Malcolm Thomas,PF,24,GSW,5,21,0,1,0,0,0,1,3,4,3
2013,Malcolm Thomas,PF,24,CHI,7,36,5,9,0,0,5,9,2,4,12
2013,Tyrus Thomas,PF,26,CHA,26,360,48,136,3,8,45,128,26,31,125
2013,Jason Thompson,PF,26,SAC,82,2285,374,745,0,3,374,742,143,206,891
2013,Klay Thompson,SG,22,GSW,82,2936,508,1205,211,526,297,679,132,157,1359
2013,Tristan Thompson,PF,21,CLE,82,2564,390,799,0,3,390,796,177,291,957
2013,Marcus Thornton,SG,25,SAC,72,1726,332,774,141,379,191,395,111,126,916
2013,Jamaal Tinsley,PG,34,UTA,66,1221,86,234,39,127,47,107,18,26,229
2013,Anthony Tolliver,SF,27,ATL,62,963,82,216,45,133,37,83,44,51,253
2013,P.J. Tucker,SG,27,PHO,79,1910,210,444,22,70,188,374,64,86,506
2013,Ronny Turiaf,C,30,LAC,65,701,49,97,0,0,49,97,23,63,121
2013,Hedo Turkoglu,SF,33,ORL,11,189,14,53,1,24,13,29,3,6,32
2013,Evan Turner,SF,24,PHI,82,2892,441,1053,58,159,383,894,154,208,1094
2013,Jeremy Tyler,C,21,TOT,21,68,9,24,0,0,9,24,4,6,22
2013,Jeremy Tyler,C,21,GSW,20,63,9,24,0,0,9,24,4,6,22
2013,Jeremy Tyler,C,21,ATL,1,5,0,0,0,0,0,0,0,0,0
2013,Ekpe Udoh,C,25,MIL,76,1312,117,269,0,1,117,268,89,119,323
2013,Beno Udrih,SG-PG,30,TOT,66,1457,210,476,34,102,176,374,84,103,538
2013,Beno Udrih,SG,30,MIL,39,719,113,238,13,49,100,189,24,33,263
2013,Beno Udrih,PG,30,ORL,27,738,97,238,21,53,76,185,60,70,275
2013,Jonas Valanciunas,C,20,TOR,62,1482,204,366,0,0,204,366,146,185,554
2013,Anderson Varejao,C,30,CLE,25,901,138,289,0,5,138,284,77,102,353
2013,Jarvis Varnado,PF,24,TOT,13,58,3,7,0,0,3,7,2,4,8
2013,Jarvis Varnado,PF,24,BOS,5,18,2,4,0,0,2,4,2,4,6
2013,Jarvis Varnado,PF,24,MIA,8,40,1,3,0,0,1,3,0,0,2
2013,Greivis Vasquez,PG,26,NOH,78,2685,438,1012,83,243,355,769,124,154,1083
2013,Jan Vesely,PF,22,WAS,51,601,57,114,0,1,57,113,12,39,126
2013,Charlie Villanueva,PF,28,DET,69,1092,175,464,90,259,85,205,27,49,467
2013,Nikola Vucevic,C,22,ORL,77,2559,461,889,0,3,461,886,86,126,1008
2013,Dwyane Wade,SG,31,MIA,69,2391,569,1093,17,66,552,1027,308,425,1463
2013,Dion Waiters,SG,21,CLE,61,1756,336,815,63,203,273,612,159,213,894
2013,Kemba Walker,PG,22,CHA,82,2859,526,1244,107,332,419,912,296,371,1455
2013,John Wall,PG,22,WAS,49,1602,324,735,12,45,312,690,246,306,906
2013,Gerald Wallace,SF,30,BRK,69,2076,182,458,46,163,136,295,121,190,531
2013,Rasheed Wallace,C,38,NYK,21,296,55,142,22,69,33,73,14,20,146
2013,Luke Walton,PF,32,CLE,50,857,71,181,20,67,51,114,10,20,172
2013,Hakim Warrick,PF,30,TOT,28,489,67,165,0,3,67,162,60,88,194
2013,Hakim Warrick,PF,30,NOH,1,7,1,2,0,0,1,2,2,2,4
2013,Hakim Warrick,PF,30,CHA,27,482,66,163,0,3,66,160,58,86,190
2013,C.J. Watson,PG,28,BRK,80,1521,192,459,88,214,104,245,71,91,543
2013,Earl Watson,PG,33,UTA,48,829,37,120,5,28,32,92,17,25,96
2013,Maalik Wayns,PG,21,TOT,27,202,26,88,7,31,19,57,17,19,76
2013,Maalik Wayns,PG,21,PHI,21,165,19,72,5,25,14,47,13,15,56
2013,Maalik Wayns,PG,21,LAC,6,37,7,16,2,6,5,10,4,4,20
2013,Martell Webster,SF,26,WAS,76,2200,281,636,139,329,142,307,168,198,869
2013,David West,PF,32,IND,73,2435,502,1009,4,19,498,990,242,315,1250
2013,Russell Westbrook,PG,24,OKC,82,2861,673,1535,97,300,576,1235,460,575,1903
2013,D.J. White,PF,26,BOS,12,86,12,23,0,0,12,23,5,9,29
2013,James White,SF,30,NYK,57,435,50,116,14,41,36,75,11,19,125
2013,Chris Wilcox,C,30,BOS,61,830,110,153,0,1,110,152,39,58,259
2013,Damien Wilkins,SG,33,PHI,61,1095,145,316,17,51,128,265,81,109,388
2013,Deron Williams,PG,28,BRK,78,2842,495,1124,169,447,326,677,317,369,1476
2013,Derrick Williams,PF,21,MIN,78,1916,338,786,65,196,273,590,192,272,933
2013,Lou Williams,SG,26,ATL,39,1119,187,443,72,196,115,247,105,121,551
2013,Marvin Williams,SF,26,UTA,73,1727,199,470,54,166,145,304,77,99,529
2013,Mo Williams,PG,30,UTA,46,1418,229,533,59,154,170,379,75,85,592
2013,Reggie Williams,SF,26,CHA,40,380,57,132,22,72,35,60,10,21,146
2013,Terrence Williams,SF,25,BOS,24,318,48,97,5,15,43,82,9,21,110
2013,Metta World,SF,33,LAL,75,2530,332,824,141,412,191,412,124,169,929
2013,Brandan Wright,C,25,DAL,64,1149,241,404,0,3,241,401,59,96,541
2013,Chris Wright,SG,23,DAL,3,4,1,2,0,0,1,2,0,0,2
2013,Dorell Wright,SF,27,PHI,79,1783,237,599,135,361,102,238,120,141,729
2013,Tony Wroten,SG,19,MEM,35,272,33,86,4,16,29,70,21,29,91
2013,Nick Young,SG,27,PHI,59,1411,224,542,75,210,149,332,105,128,628
2013,Sam Young,SG,27,IND,56,693,58,148,16,52,42,96,23,43,155
2013,Thaddeus Young,PF,24,PHI,76,2629,509,958,1,8,508,950,108,188,1127
2013,Luke Zeller,C,25,PHO,16,58,9,26,1,5,8,21,0,0,19
2013,Tyler Zeller,C,23,CLE,77,2033,245,559,0,4,245,555,120,157,610
,,,,,,,,,,,,,,,
2014,Quincy Acy,SF,23,TOT,63,847,66,141,4,15,62,126,35,53,171
2014,Quincy Acy,SF,23,TOR,7,61,6,14,2,5,4,9,5,8,19
2014,Quincy Acy,SF,23,SAC,56,786,60,127,2,10,58,117,30,45,152
2014,Steven Adams,C,20,OKC,81,1197,93,185,0,0,93,185,79,136,265
2014,Jeff Adrien,PF,27,TOT,53,961,143,275,0,0,143,275,76,119,362
2014,Jeff Adrien,PF,27,CHA,25,256,22,40,0,0,22,40,13,25,57
2014,Jeff Adrien,PF,27,MIL,28,705,121,235,0,0,121,235,63,94,305
2014,Arron Afflalo,SG,28,ORL,73,2552,464,1011,128,300,336,711,274,336,1330
2014,Alexis Ajinca,C,25,NOP,56,951,136,249,0,1,136,248,56,67,328
2014,Cole Aldrich,C,25,NYK,46,330,33,61,0,0,33,61,26,30,92
2014,LaMarcus Aldridge,PF,28,POR,69,2498,652,1423,3,15,649,1408,296,360,1603
2014,Lavoy Allen,PF,24,TOT,65,1072,134,300,2,13,132,287,33,50,303
2014,Lavoy Allen,PF,24,PHI,51,960,117,266,2,13,115,253,27,40,263
2014,Lavoy Allen,PF,24,IND,14,112,17,34,0,0,17,34,6,10,40
2014,Ray Allen,SG,38,MIA,73,1936,240,543,116,309,124,234,105,116,701
2014,Tony Allen,SG,32,MEM,55,1278,204,413,11,47,193,366,76,121,495
2014,Al-Farouq Aminu,SF,23,NOP,80,2045,234,494,13,48,221,446,91,137,572
2014,Lou Amundson,PF,31,TOT,19,185,16,32,0,0,16,32,6,24,38
2014,Lou Amundson,PF,31,NOP,18,184,16,32,0,0,16,32,6,24,38
2014,Lou Amundson,PF,31,CHI,1,1,0,0,0,0,0,0,0,0,0
2014,Chris Andersen,C,35,MIA,72,1396,177,275,3,12,174,263,120,169,477
2014,Alan Anderson,SF,31,BRK,78,1773,194,485,84,248,110,237,92,118,564
2014,James Anderson,SG,24,PHI,80,2309,309,717,115,351,194,366,77,106,810
2014,Ryan Anderson,PF,25,NOP,22,795,155,354,67,164,88,190,59,62,436
2014,Giannis Antetokounmpo,SF,19,MIL,77,1897,173,418,41,118,132,300,138,202,525
2014,Carmelo Anthony,PF,29,NYK,77,2982,743,1643,167,415,576,1228,459,541,2112
2014,Joel Anthony,C,31,TOT,33,186,12,32,0,0,12,32,4,8,28
2014,Joel Anthony,C,31,MIA,12,37,2,6,0,0,2,6,2,2,6
2014,Joel Anthony,C,31,BOS,21,149,10,26,0,0,10,26,2,6,22
2014,Pero Antic,C,31,ATL,50,925,123,294,56,171,67,123,50,66,352
2014,Trevor Ariza,SF,28,WAS,77,2723,389,853,180,442,209,411,149,193,1107
2014,Hilton Armstrong,C,29,GSW,15,97,9,19,0,0,9,19,7,16,25
2014,Darrell Arthur,SF,25,DEN,68,1161,162,410,24,64,138,346,53,62,401
2014,Omer Asik,C,27,HOU,48,968,101,190,0,0,101,190,78,126,280
2014,D.J. Augustin,PG,26,TOT,71,1939,298,718,133,332,165,386,201,227,930
2014,D.J. Augustin,PG,26,TOR,10,82,7,24,1,11,6,13,6,6,21
2014,D.J. Augustin,PG,26,CHI,61,1857,291,694,132,321,159,373,195,221,909
2014,Gustavo Ayon,C,28,ATL,26,429,52,102,0,0,52,102,8,20,112
2014,Jeff Ayres,PF,26,SAS,73,952,101,174,0,0,101,174,38,55,240
2014,Chris Babb,SG,23,BOS,14,132,8,30,6,27,2,3,0,0,22
2014,Luke Babbitt,PF,24,NOP,27,473,60,154,36,95,24,59,14,18,170
2014,Leandro Barbosa,PG,31,PHO,20,368,56,131,7,25,49,106,31,39,150
2014,J.J. Barea,PG,29,MIN,79,1471,254,656,73,231,181,425,79,100,660
2014,Andrea Bargnani,C,28,NYK,42,1257,222,502,30,108,192,394,84,102,558
2014,Harrison Barnes,SF,21,GSW,78,2204,271,679,66,190,205,489,130,181,738
2014,Matt Barnes,SF,33,LAC,63,1735,231,527,97,283,134,244,66,90,625
2014,Will Barton,SG,23,POR,41,387,65,156,10,33,55,123,26,32,166
2014,Brandon Bass,PF,28,BOS,82,2266,352,725,2,6,350,719,205,239,911
2014,Shane Battier,SF,35,MIA,73,1468,105,275,73,210,32,65,15,23,298
2014,Nicolas Batum,SF,25,POR,82,2956,381,819,145,402,236,417,163,203,1070
2014,Jerryd Bayless,PG,25,TOT,72,1686,248,617,76,212,172,405,94,118,666
2014,Jerryd Bayless,PG,25,MEM,31,650,90,239,25,83,65,156,45,57,250
2014,Jerryd Bayless,PG,25,BOS,41,1036,158,378,51,129,107,249,49,61,416
2014,Aron Baynes,C,27,SAS,53,491,71,163,0,0,71,163,19,21,161
2014,Kent Bazemore,SG,24,TOT,67,911,147,343,43,128,104,215,66,109,403
2014,Kent Bazemore,SG,24,GSW,44,268,36,97,10,39,26,58,19,36,101
2014,Kent Bazemore,SG,24,LAL,23,643,111,246,33,89,78,157,47,73,302
2014,Bradley Beal,SG,20,WAS,73,2530,481,1149,138,343,343,806,149,189,1249
2014,Michael Beasley,SF,25,MIA,55,831,177,355,21,54,156,301,61,79,436
2014,Marco Belinelli,SF,27,SAS,80,2016,337,695,126,293,211,402,111,131,911
2014,Anthony Bennett,PF,20,CLE,52,663,80,225,13,53,67,172,44,69,217
2014,Patrick Beverley,PG,25,HOU,56,1751,199,481,92,255,107,226,83,102,573
2014,Andris Biedrins,C,27,UTA,6,45,1,1,0,0,1,1,1,6,3
2014,Chauncey Billups,SG,37,DET,19,309,24,79,14,48,10,31,10,12,72
2014,Bismack Biyombo,C,21,CHA,77,1072,88,144,0,0,88,144,46,89,222
2014,DeJuan Blair,PF,24,DAL,78,1214,210,393,0,2,210,391,77,121,497
2014,Steve Blake,PG,33,TOT,55,1498,133,353,79,210,54,143,33,43,378
2014,Steve Blake,PG,33,LAL,27,891,88,233,52,131,36,102,28,35,256
2014,Steve Blake,PG,33,GSW,28,607,45,120,27,79,18,41,5,8,122
2014,Andray Blatche,PF,27,BRK,73,1618,321,674,15,54,306,620,164,221,821
2014,Eric Bledsoe,PG,24,PHO,43,1416,265,556,50,140,215,416,183,237,763
2014,Vander Blue,SG,21,BOS,3,15,2,4,0,1,2,3,1,5,5
2014,Keith Bogans,SG,33,BOS,6,55,3,6,3,6,0,0,3,3,12
2014,Andrew Bogut,C,29,GSW,67,1769,235,375,0,0,235,375,22,64,492
2014,Matt Bonner,PF,33,SAS,61,690,73,164,42,98,31,66,9,12,197
2014,Trevor Booker,PF,26,WAS,72,1553,222,403,0,2,222,401,47,76,491
2014,Carlos Boozer,PF,32,CHI,76,2141,447,980,0,2,447,978,148,193,1042
2014,Chris Bosh,C,29,MIA,79,2531,492,953,74,218,418,735,223,272,1281
2014,Avery Bradley,PG,23,BOS,60,1855,361,825,79,200,282,625,90,112,891
2014,Elton Brand,C,34,ATL,73,1414,179,332,0,2,179,330,61,94,419
2014,Corey Brewer,SF,27,MIN,81,2609,388,807,59,211,329,596,163,227,998
2014,Ronnie Brewer,SF,28,TOT,24,160,3,15,1,8,2,7,0,2,7
2014,Ronnie Brewer,SF,28,HOU,23,158,3,15,1,8,2,7,0,2,7
2014,Ronnie Brewer,SF,28,CHI,1,2,0,0,0,0,0,0,0,0,0
2014,Aaron Brooks,PG,29,TOT,72,1557,233,581,96,248,137,333,83,95,645
2014,Aaron Brooks,PG,29,HOU,43,716,104,263,54,132,50,131,37,44,299
2014,Aaron Brooks,PG,29,DEN,29,841,129,318,42,116,87,202,46,51,346
2014,MarShon Brooks,SG,25,TOT,35,316,57,125,13,25,44,100,32,44,159
2014,MarShon Brooks,SG,25,BOS,10,73,9,24,2,4,7,20,11,14,31
2014,MarShon Brooks,SG,25,GSW,7,15,5,13,0,2,5,11,3,4,13
2014,MarShon Brooks,SG,25,LAL,18,228,43,88,11,19,32,69,18,26,115
2014,Lorenzo Brown,PG,23,PHI,26,224,26,86,3,30,23,56,9,13,64
2014,Shannon Brown,SG,28,TOT,29,251,24,66,0,2,24,64,15,21,63
2014,Shannon Brown,SG,28,SAS,10,103,8,28,0,2,8,26,7,9,23
2014,Shannon Brown,SG,28,NYK,19,148,16,38,0,0,16,38,8,12,40
2014,Kobe Bryant,SG,35,LAL,6,177,31,73,3,16,28,57,18,21,83
2014,Chase Budinger,SF,25,MIN,41,751,100,254,42,120,58,134,32,39,274
2014,Reggie Bullock,SF,22,LAC,43,395,43,121,22,73,21,48,7,9,115
2014,Trey Burke,PG,21,UTA,70,2262,341,897,111,336,230,561,102,113,895
2014,Alec Burks,SG,22,UTA,78,2193,380,831,50,143,330,688,279,373,1089
2014,Caron Butler,SF,33,TOT,56,1419,213,540,98,249,115,291,63,75,587
2014,Caron Butler,SF,33,MIL,34,821,137,354,53,147,84,207,47,56,374
2014,Caron Butler,SF,33,OKC,22,598,76,186,45,102,31,84,16,19,213
2014,Jimmy Butler,SG,24,CHI,67,2591,275,693,68,240,207,453,260,338,878
2014,Rasual Butler,SG,34,IND,50,378,51,110,26,62,25,48,8,14,136
2014,Dwight Buycks,PG,24,TOR,14,146,15,48,5,17,10,31,8,9,43
2014,Andrew Bynum,C,26,TOT,26,516,94,225,0,0,94,225,37,49,225
2014,Andrew Bynum,C,26,CLE,24,480,85,203,0,0,85,203,32,42,202
2014,Andrew Bynum,C,26,IND,2,36,9,22,0,0,9,22,5,7,23
2014,Will Bynum,PG,31,DET,56,1054,184,430,20,62,164,368,97,121,485
2014,Nick Calathes,SG,24,MEM,71,1173,142,311,19,61,123,250,44,72,347
2014,Jose Calderon,PG,32,DAL,81,2468,341,748,191,425,150,323,52,63,925
2014,Kentavious Caldwell-Pope,SG,20,DET,80,1583,182,460,59,185,123,275,47,61,470
2014,Isaiah Canaan,PG,22,HOU,22,252,31,87,18,55,13,32,21,29,101
2014,DeMarre Carroll,SF,27,ATL,73,2341,302,642,97,268,205,374,109,141,810
2014,Vince Carter,SG,37,DAL,81,1973,330,811,146,371,184,440,161,196,967
2014,Michael Carter-Williams,PG,22,PHI,70,2414,427,1054,55,208,372,846,258,367,1167
2014,Omri Casspi,PF,25,HOU,71,1283,173,410,61,176,112,234,83,122,490
2014,Mario Chalmers,PG,27,MIA,73,2178,254,560,87,226,167,334,121,163,716
2014,Tyson Chandler,C,31,NYK,55,1662,191,322,0,1,191,321,98,155,480
2014,Wilson Chandler,SF,26,DEN,62,1927,307,738,122,351,185,387,110,152,846
2014,Josh Childress,SF,30,NOP,4,24,0,0,0,0,0,0,0,0,0
2014,Dionte Christmas,SF,27,PHO,31,198,22,62,9,31,13,31,18,24,71
2014,Earl Clark,PF,26,TOT,54,768,97,261,41,122,56,139,22,34,257
2014,Earl Clark,PF,26,CLE,45,698,90,240,40,116,50,124,14,24,234
2014,Earl Clark,PF,26,NYK,9,70,7,21,1,6,6,15,8,10,23
2014,Ian Clark,SG,22,UTA,23,172,26,67,11,31,15,36,5,7,68
2014,Victor Claver,SF,25,POR,21,184,17,42,3,18,14,24,10,11,47
2014,Norris Cole,PG,25,MIA,82,2014,207,500,60,174,147,326,53,68,527
2014,Jason Collins,C,35,BRK,22,172,11,24,0,3,11,21,3,4,25
2014,Darren Collison,PG,26,LAC,80,2069,324,694,71,189,253,505,192,224,911
2014,Nick Collison,PF,33,OKC,81,1353,134,241,4,17,130,224,66,93,338
2014,Mike Conley,PG,26,MEM,73,2446,463,1030,105,291,358,739,225,276,1256
2014,Chris Copeland,SF,29,IND,41,265,55,117,33,79,22,38,10,14,153
2014,DeMarcus Cousins,C,23,SAC,71,2298,591,1191,0,7,591,1184,432,595,1614
2014,Robert Covington,SF,23,HOU,7,34,6,14,4,11,2,3,0,0,16
2014,Allen Crabbe,SG,21,POR,15,100,12,33,6,14,6,19,3,4,33
2014,Jamal Crawford,SG,33,LAC,69,2094,421,1011,161,446,260,565,279,322,1282
2014,Jordan Crawford,SG,25,TOT,81,1859,327,788,90,285,237,503,146,169,890
2014,Jordan Crawford,SG,25,BOS,39,1198,188,455,50,157,138,298,110,126,536
2014,Jordan Crawford,SG,25,GSW,42,661,139,333,40,128,99,205,36,43,354
2014,Jae Crowder,SF,23,DAL,78,1254,130,296,50,151,80,145,46,61,356
2014,Dante Cunningham,PF,26,MIN,81,1635,236,509,0,5,236,504,38,67,510
2014,Jared Cunningham,SG,22,TOT,13,80,6,21,1,7,5,14,13,16,26
2014,Jared Cunningham,SG,22,ATL,5,22,1,2,0,1,1,1,0,2,2
2014,Jared Cunningham,SG,22,SAC,8,58,5,19,1,6,4,13,13,14,24
2014,Seth Curry,PG,23,TOT,2,13,1,3,1,1,0,2,0,0,3
2014,Seth Curry,PG,23,MEM,1,4,0,0,0,0,0,0,0,0,0
2014,Seth Curry,PG,23,CLE,1,9,1,3,1,1,0,2,0,0,3
2014,Stephen Curry,PG,25,GSW,78,2846,652,1383,261,615,391,768,308,348,1873
2014,Samuel Dalembert,C,32,DAL,80,1614,214,377,0,1,214,376,101,137,529
2014,Troy Daniels,SG,22,HOU,5,75,15,31,12,25,3,6,0,0,42
2014,Luigi Datome,SF,26,DET,34,238,34,97,7,39,27,58,8,10,83
2014,Brandon Davies,PF,22,PHI,51,575,54,128,2,10,52,118,34,53,144
2014,Anthony Davis,PF,20,NOP,67,2358,522,1005,2,9,520,996,348,440,1394
2014,Ed Davis,PF,24,MEM,63,956,155,290,0,0,155,290,47,89,357
2014,Glen Davis,PF,28,TOT,68,1662,271,593,4,11,267,582,95,137,641
2014,Glen Davis,PF,28,ORL,45,1354,232,512,4,10,228,502,77,114,545
2014,Glen Davis,PF,28,LAC,23,308,39,81,0,1,39,80,18,23,96
2014,Austin Daye,SF,25,TOT,22,148,24,68,12,37,12,31,6,10,66
2014,Austin Daye,SF,25,TOR,8,33,3,13,0,8,3,5,2,3,8
2014,Austin Daye,SF,25,SAS,14,115,21,55,12,29,9,26,4,7,58
2014,Nando De,SF,26,TOT,47,494,64,153,18,53,46,100,31,35,177
2014,Nando De,SF,26,SAS,26,301,42,93,10,31,32,62,18,22,112
2014,Nando De,SF,26,TOR,21,193,22,60,8,22,14,38,13,13,65
2014,Dewayne Dedmon,C,24,TOT,31,390,38,83,0,0,38,83,21,32,97
2014,Dewayne Dedmon,C,24,GSW,4,6,0,1,0,0,0,1,1,2,1
2014,Dewayne Dedmon,C,24,PHI,11,150,15,29,0,0,15,29,7,13,37
2014,Dewayne Dedmon,C,24,ORL,16,234,23,53,0,0,23,53,13,17,59
2014,Matthew Dellavedova,SG,23,CLE,72,1271,122,296,57,155,65,141,38,48,339
2014,Luol Deng,SF,28,TOT,63,2213,371,860,57,189,314,671,212,268,1011
2014,Luol Deng,SF,28,CHI,23,860,160,354,17,62,143,292,101,124,438
2014,Luol Deng,SF,28,CLE,40,1353,211,506,40,127,171,379,111,144,573
2014,DeMar DeRozan,SG,24,TOR,79,3017,604,1407,64,210,540,1197,519,630,1791
2014,Boris Diaw,PF,31,SAS,79,1974,302,580,45,112,257,468,68,92,717
2014,Gorgui Dieng,C,24,MIN,60,818,113,227,1,1,112,226,59,93,286
2014,Toney Douglas,PG,27,TOT,51,675,73,190,31,102,42,88,25,34,202
2014,Toney Douglas,PG,27,GSW,24,265,32,86,19,59,13,27,5,8,88
2014,Toney Douglas,PG,27,MIA,27,410,41,104,12,43,29,61,20,26,114
2014,Chris Douglas-Roberts,SF,27,CHA,49,1016,111,252,51,132,60,120,66,82,339
2014,Goran Dragic,SG,27,PHO,76,2668,552,1093,122,299,430,794,316,416,1542
2014,Andre Drummond,C,20,DET,81,2619,479,769,0,2,479,767,137,328,1095
2014,Jared Dudley,SF,28,LAC,74,1729,196,447,81,225,115,222,38,58,511
2014,Tim Duncan,C,37,SAS,74,2158,444,906,0,5,444,901,231,316,1119
2014,Mike Dunleavy,SF,33,CHI,82,2584,333,774,123,324,210,450,140,164,929
2014,Kevin Durant,SF,25,OKC,81,3122,849,1688,192,491,657,1197,703,805,2593
2014,Shane Edwards,SF,26,CLE,2,12,1,3,0,0,1,3,0,0,2
2014,Wayne Ellington,SG,26,DAL,45,393,55,126,25,59,30,67,10,11,145
2014,Monta Ellis,SG,28,DAL,82,3023,576,1278,69,209,507,1069,339,430,1560
2014,Melvin Ely,C,35,NOP,2,27,3,6,0,0,3,6,0,0,6
2014,Jeremy Evans,SF,26,UTA,66,1209,175,332,0,2,175,330,51,75,401
2014,Reggie Evans,PF,33,TOT,54,899,71,150,0,0,71,150,72,130,214
2014,Reggie Evans,PF,33,BRK,30,399,23,59,0,0,23,59,35,65,81
2014,Reggie Evans,PF,33,SAC,24,500,48,91,0,0,48,91,37,65,133
2014,Tyreke Evans,SF,24,NOP,72,2028,391,897,21,95,370,802,239,310,1042
2014,Kenneth Faried,PF,24,DEN,80,2178,447,820,0,3,447,817,202,311,1096
2014,Jordan Farmar,PG,27,LAL,41,912,151,364,70,160,81,204,44,59,416
2014,Vitor Faverani,C,25,BOS,37,488,64,147,12,40,52,107,24,37,164
2014,Derrick Favors,PF,22,UTA,73,2201,390,747,0,1,390,746,190,284,970
2014,Carrick Felix,SG,23,CLE,7,38,7,14,2,5,5,9,3,4,19
2014,Raymond Felton,PG,29,NYK,65,2017,240,608,62,195,178,413,88,122,630
2014,Landry Fields,SF,25,TOR,30,322,27,67,0,5,27,62,14,22,68
2014,Derek Fisher,SG,39,OKC,81,1428,141,361,88,229,53,132,55,71,425
2014,Evan Fournier,SG,21,DEN,76,1503,228,544,89,237,139,307,93,123,638
2014,Randy Foye,SG,30,DEN,81,2485,361,875,189,498,172,377,157,185,1068
2014,Jamaal Franklin,SG,22,MEM,21,161,16,39,5,11,11,28,2,2,39
2014,Jimmer Fredette,SG,24,TOT,49,519,107,227,40,84,67,143,19,21,273
2014,Jimmer Fredette,SG,24,SAC,41,463,94,198,36,73,58,125,17,19,241
2014,Jimmer Fredette,SG,24,CHI,8,56,13,29,4,11,9,18,2,2,32
2014,Joel Freeland,C,26,POR,52,727,77,162,0,2,77,160,20,29,174
2014,Channing Frye,PF,30,PHO,82,2312,336,778,160,432,176,346,78,95,910
2014,Francisco Garcia,SF,32,HOU,55,1083,118,294,69,193,49,101,10,19,315
2014,Kevin Garnett,C,37,BRK,54,1109,157,356,0,3,157,353,38,47,352
2014,Diante Garrett,PG,25,UTA,71,1048,101,265,36,96,65,169,10,12,248
2014,Marc Gasol,C,29,MEM,59,1970,336,711,2,11,334,700,185,241,859
2014,Pau Gasol,C,33,LAL,60,1884,425,885,4,14,421,871,187,254,1041
2014,Rudy Gay,SF,27,TOT,73,2531,537,1179,65,197,472,982,318,387,1457
2014,Rudy Gay,SF,27,TOR,18,639,130,335,22,59,108,276,68,88,350
2014,Rudy Gay,SF,27,SAC,55,1892,407,844,43,138,364,706,250,299,1107
2014,Alonzo Gee,SF,26,CLE,65,1020,98,236,19,58,79,178,43,61,258
2014,Paul George,SF,23,IND,80,2898,577,1362,182,500,395,862,401,464,1737
2014,Taj Gibson,PF,28,CHI,82,2351,429,896,0,7,429,889,211,281,1069
2014,Manu Ginobili,SG,36,SAS,68,1550,294,627,90,258,204,369,160,188,838
2014,Rudy Gobert,C,21,UTA,45,434,36,74,0,0,36,74,32,65,104
2014,Ryan Gomes,SF,31,OKC,5,34,3,8,0,2,3,6,0,0,6
2014,Drew Gooden,C,32,WAS,22,395,76,143,7,17,69,126,24,27,183
2014,Archie Goodwin,SG,19,PHO,52,533,76,167,5,36,71,131,37,55,194
2014,Ben Gordon,SG,30,CHA,19,279,37,108,8,29,29,79,17,21,99
2014,Eric Gordon,SG,25,NOP,64,2057,356,817,101,258,255,559,175,223,988
2014,Marcin Gortat,C,29,WAS,81,2655,455,840,1,1,454,839,157,229,1068
2014,Danny Granger,SF,30,TOT,41,847,116,307,43,128,73,179,63,67,338
2014,Danny Granger,SF,30,IND,29,653,80,223,31,94,49,129,51,53,242
2014,Danny Granger,SF,30,LAC,12,194,36,84,12,34,24,50,12,14,96
2014,Aaron Gray,C,29,TOT,37,355,27,61,0,1,27,60,11,20,65
2014,Aaron Gray,C,29,TOR,4,20,2,3,0,0,2,3,1,2,5
2014,Aaron Gray,C,29,SAC,33,335,25,58,0,1,25,57,10,18,60
2014,Danny Green,SG,26,SAS,68,1651,218,505,132,318,86,187,50,63,618
2014,Draymond Green,SF,23,GSW,82,1797,187,459,55,165,132,294,82,123,511
2014,Gerald Green,SG,28,PHO,82,2330,448,1006,204,510,244,496,195,230,1295
2014,Jeff Green,SF,27,BOS,82,2805,482,1171,135,396,347,775,283,356,1382
2014,Willie Green,SG,32,LAC,55,869,102,271,41,121,61,150,28,34,273
2014,Blake Griffin,PF,24,LAC,80,2863,718,1359,12,44,706,1315,482,674,1930
2014,Jorge Gutierrez,PG,25,BRK,15,244,25,54,3,12,22,42,9,12,62
2014,Jordan Hamilton,SF,23,TOT,60,1019,147,376,70,198,77,178,40,51,404
2014,Jordan Hamilton,SF,23,DEN,39,670,99,254,45,129,54,125,23,31,266
2014,Jordan Hamilton,SF,23,HOU,21,349,48,122,25,69,23,53,17,20,138
2014,Justin Hamilton,C,23,TOT,8,72,9,20,3,9,6,11,5,5,26
2014,Justin Hamilton,C,23,CHA,1,4,0,0,0,0,0,0,0,0,0
2014,Justin Hamilton,C,23,MIA,7,68,9,20,3,9,6,11,5,5,26
2014,Tyler Hansbrough,PF,28,TOR,64,978,93,196,0,2,93,194,126,185,312
2014,Tim Hardaway,SG,21,NYK,81,1875,294,687,130,358,164,329,106,128,824
2014,James Harden,SG,24,HOU,73,2777,549,1205,177,483,372,722,576,665,1851
2014,Maurice Harkless,SF,20,ORL,80,1950,224,483,59,154,165,329,85,143,592
2014,Josh Harrellson,C,24,DET,32,317,38,82,12,31,26,51,5,7,93
2014,Al Harrington,PF,33,WAS,34,511,82,207,34,100,48,107,27,35,225
2014,Devin Harris,PG,30,DAL,40,818,96,254,31,101,65,153,92,115,315
2014,Elias Harris,SF,24,LAL,2,11,0,1,0,0,0,1,0,0,0
2014,Manny Harris,SG,24,LAL,9,180,28,70,7,20,21,50,10,12,73
2014,Mike Harris,PF,30,UTA,20,225,29,61,0,2,29,59,26,27,84
2014,Tobias Harris,PF,21,ORL,61,1850,332,716,32,126,300,590,197,244,893
2014,Udonis Haslem,PF,33,MIA,46,653,74,146,0,0,74,146,25,44,173
2014,Spencer Hawes,C,25,TOT,80,2470,403,883,128,308,275,575,119,152,1053
2014,Spencer Hawes,C,25,PHI,53,1666,264,586,81,203,183,383,79,101,688
2014,Spencer Hawes,C,25,CLE,27,804,139,297,47,105,92,192,40,51,365
2014,Chuck Hayes,C,30,TOT,61,754,56,130,0,1,56,129,20,25,132
2014,Chuck Hayes,C,30,SAC,16,179,14,32,0,0,14,32,5,7,33
2014,Chuck Hayes,C,30,TOR,45,575,42,98,0,1,42,97,15,18,99
2014,Gordon Hayward,SF,23,UTA,77,2800,426,1032,85,280,341,752,311,381,1248
2014,Gerald Henderson,SG,26,CHA,77,2461,403,930,40,115,363,815,235,309,1081
2014,Xavier Henry,SF,22,LAL,43,908,144,345,28,81,116,264,116,177,432
2014,John Henson,PF,23,MIL,70,1856,344,639,0,1,344,638,91,177,779
2014,Roy Hibbert,C,27,IND,81,2409,331,754,2,5,329,749,207,269,871
2014,J.J. Hickson,PF,25,DEN,69,1859,332,654,0,8,332,646,150,290,814
2014,Nene Hilario,PF,31,WAS,53,1560,299,594,1,5,298,589,155,266,754
2014,George Hill,PG,27,IND,76,2434,272,616,95,260,177,356,142,176,781
2014,Jordan Hill,PF,26,LAL,72,1500,286,521,0,1,286,520,124,181,696
2014,Solomon Hill,SF,22,IND,28,226,17,40,7,23,10,17,6,7,47
2014,Kirk Hinrich,PG,33,CHI,73,2116,243,619,85,242,158,377,95,125,666
2014,Jrue Holiday,PG,23,NOP,34,1143,203,454,30,77,173,377,51,63,487
2014,Ryan Hollins,PF,29,LAC,61,482,53,72,0,0,53,72,35,56,141
2014,Scotty Hopson,SG,24,CLE,2,7,0,4,0,2,0,2,1,2,1
2014,Al Horford,C,27,ATL,29,958,238,420,4,11,234,409,58,85,538
2014,Dwight Howard,C,28,HOU,71,2396,473,800,2,7,471,793,349,638,1297
2014,Robbie Hummel,SF,24,MIN,53,655,67,177,32,89,35,88,15,16,181
2014,Kris Humphries,PF,28,BOS,69,1376,231,461,0,2,231,459,117,144,579
2014,Serge Ibaka,PF,24,OKC,81,2666,524,978,23,60,501,918,156,199,1227
2014,Andre Iguodala,SF,30,GSW,63,2040,220,458,62,175,158,283,86,132,588
2014,Ersan Ilyasova,PF,26,MIL,55,1478,237,579,37,131,200,448,107,130,618
2014,Kyrie Irving,PG,21,CLE,71,2496,532,1237,123,344,409,893,291,338,1478
2014,Royal Ivey,SG,32,OKC,2,5,0,2,0,1,0,1,0,0,0
2014,Jarrett Jack,PG,30,CLE,80,2252,286,698,63,185,223,513,125,149,760
2014,Reggie Jackson,PG,23,OKC,80,2277,403,916,83,245,320,671,158,177,1047
2014,Stephen Jackson,SF,35,LAC,9,107,6,26,1,14,5,12,2,4,15
2014,Bernard James,C,28,DAL,30,146,11,23,0,1,11,22,6,11,28
2014,Damion James,SF,26,SAS,5,50,2,9,0,2,2,7,2,2,6
2014,LeBron James,PF,29,MIA,77,2902,767,1353,116,306,651,1047,439,585,2089
2014,Mike James,PG,38,CHI,11,77,5,21,1,5,4,16,0,2,11
2014,Antawn Jamison,PF,37,LAC,22,248,29,92,8,41,21,51,18,25,84
2014,Othyus Jeffers,SG,28,TOT,6,47,3,6,0,2,3,4,3,4,9
2014,Othyus Jeffers,SG,28,SAS,4,34,3,5,0,1,3,4,1,2,7
2014,Othyus Jeffers,SG,28,MIN,2,13,0,1,0,1,0,0,2,2,2
2014,Al Jefferson,C,29,CHA,73,2553,700,1376,3,15,697,1361,191,277,1594
2014,Richard Jefferson,SF,33,UTA,82,2213,294,654,123,301,171,353,120,162,831
2014,John Jenkins,SG,22,ATL,13,158,16,42,4,18,12,24,4,4,40
2014,Brandon Jennings,PG,24,DET,80,2728,423,1135,154,457,269,678,241,321,1241
2014,Jonas Jerebko,PF,26,DET,64,741,98,208,31,74,67,134,43,59,270
2014,Amir Johnson,PF,26,TOR,77,2214,344,612,20,66,324,546,91,143,799
2014,Chris Johnson,SF,23,BOS,40,789,85,214,43,127,42,87,37,43,250
2014,James Johnson,SF,26,MEM,52,956,143,308,22,87,121,221,76,90,384
2014,Joe Johnson,SG,32,BRK,79,2575,462,1018,162,404,300,614,159,195,1245
2014,Orlando Johnson,SG,24,TOT,45,392,36,113,9,47,27,66,19,26,100
2014,Orlando Johnson,SG,24,IND,38,342,33,96,8,41,25,55,17,22,91
2014,Orlando Johnson,SG,24,SAC,7,50,3,17,1,6,2,11,2,4,9
2014,Wesley Johnson,SF,26,LAL,79,2240,277,651,100,271,177,380,61,77,715
2014,Darius Johnson-Odom,SG,24,PHI,3,15,0,7,0,3,0,4,0,2,0
2014,James Jones,SF,33,MIA,20,236,31,68,28,54,3,14,7,11,97
2014,Perry Jones,PF,22,OKC,62,764,83,181,22,61,61,120,28,42,216
2014,Solomon Jones,PF,29,ORL,11,85,6,17,0,0,6,17,2,4,14
2014,Terrence Jones,PF,22,HOU,76,2078,386,712,31,101,355,611,118,195,921
2014,DeAndre Jordan,C,25,LAC,82,2870,348,515,0,0,348,515,160,374,856
2014,Cory Joseph,SG,22,SAS,68,936,126,265,12,38,114,227,79,96,343
2014,Chris Kaman,C,31,LAL,39,736,176,346,0,3,176,343,52,68,404
2014,Enes Kanter,C,21,UTA,80,2138,419,853,0,1,419,852,149,204,987
2014,Sergey Karasev,SF,20,CLE,22,156,12,35,4,19,8,16,9,10,37
2014,Ryan Kelly,PF,22,LAL,59,1312,157,371,48,142,109,229,110,135,472
2014,Michael Kidd-Gilchrist,SF,20,CHA,62,1502,167,353,1,9,166,344,113,184,448
2014,Andrei Kirilenko,PF,32,BRK,45,857,82,160,1,5,81,155,61,119,226
2014,Brandon Knight,PG,22,MIL,72,2400,461,1092,110,338,351,754,259,323,1291
2014,Kyle Korver,SG,32,ATL,71,2408,289,609,185,392,104,217,87,94,850
2014,Kosta Koufos,C,24,MEM,80,1349,227,459,0,0,227,459,60,93,514
2014,Viacheslav Kravtsov,C,26,PHO,20,59,8,15,0,0,8,15,4,8,20
2014,Ognjen Kuzmic,C,23,GSW,21,92,5,13,0,0,5,13,5,11,15
2014,Doron Lamb,SG,22,ORL,53,695,63,160,36,90,27,70,29,36,191
2014,Jeremy Lamb,SG,21,OKC,78,1538,263,609,88,247,175,362,51,64,665
2014,Carl Landry,PF,30,SAC,18,233,31,60,0,0,31,60,14,17,76
2014,Shane Larkin,PG,21,DAL,48,489,52,137,12,38,40,99,16,25,132
2014,Ty Lawson,PG,26,DEN,62,2222,347,806,72,202,275,604,324,406,1090
2014,Ricky Ledo,SG,21,DAL,11,33,6,17,3,8,3,9,4,4,19
2014,Courtney Lee,SG,28,TOT,79,1973,295,614,72,194,223,420,99,112,761
2014,Courtney Lee,SG,28,BOS,30,504,90,183,23,52,67,131,18,22,221
2014,Courtney Lee,SG,28,MEM,49,1469,205,431,49,142,156,289,81,90,540
2014,David Lee,PF,30,GSW,69,2288,513,981,0,1,513,980,231,296,1257
2014,Alex Len,C,20,PHO,42,362,33,78,0,0,33,78,20,31,86
2014,Kawhi Leonard,SF,22,SAS,66,1923,337,645,69,182,268,463,101,126,844
2014,Meyers Leonard,C,21,POR,40,355,41,91,0,6,41,85,16,21,98
2014,Jon Leuer,PF,24,MEM,49,642,121,246,23,49,98,197,37,47,302
2014,Rashard Lewis,SF,34,MIA,60,971,98,236,46,134,52,102,26,33,268
2014,DeAndre Liggins,SG,25,MIA,1,1,1,1,0,0,1,1,0,0,2
2014,Damian Lillard,PG,23,POR,82,2937,553,1304,218,554,335,750,371,426,1695
2014,Jeremy Lin,PG,25,HOU,71,2054,295,662,82,229,213,433,218,265,890
2014,Shaun Livingston,PG,28,BRK,76,1974,235,487,1,6,234,481,158,191,629
2014,Brook Lopez,C,25,BRK,17,533,129,229,0,1,129,228,94,115,352
2014,Robin Lopez,C,25,POR,82,2603,355,644,0,1,355,643,198,242,908
2014,Kevin Love,PF,25,MIN,77,2797,650,1421,190,505,460,916,520,633,2010
2014,Kyle Lowry,PG,27,TOR,79,2862,457,1080,190,500,267,580,313,385,1417
2014,John Lucas,PG,31,UTA,42,591,62,190,25,84,37,106,10,16,159
2014,Shelvin Mack,PG,23,ATL,73,1490,209,501,62,184,147,317,64,74,544
2014,Ian Mahinmi,C,27,IND,77,1248,91,189,0,1,91,188,90,145,272
2014,Shawn Marion,SF,35,DAL,76,2409,341,708,58,162,283,546,51,65,791
2014,Kendall Marshall,PG,22,LAL,54,1564,170,419,71,178,99,241,19,36,430
2014,Cartier Martin,SF,29,TOT,59,870,111,264,59,151,52,113,48,65,329
2014,Cartier Martin,SF,29,ATL,53,822,106,256,56,146,50,110,46,61,314
2014,Cartier Martin,SF,29,CHI,6,48,5,8,3,5,2,3,2,4,15
2014,Kenyon Martin,PF,36,NYK,32,633,63,123,0,1,63,122,11,19,137
2014,Kevin Martin,SG,30,MIN,68,2177,440,1023,115,297,325,726,303,340,1298
2014,Roger Mason,SG,33,MIA,25,260,25,67,17,48,8,19,7,7,74
2014,Wesley Matthews,SG,27,POR,82,2780,445,1009,201,511,244,498,252,301,1343
2014,Jason Maxiell,PF,30,ORL,34,488,47,105,0,0,47,105,15,31,109
2014,Eric Maynor,PG,26,TOT,31,327,32,101,12,37,20,64,6,11,82
2014,Eric Maynor,PG,26,WAS,23,215,21,72,8,25,13,47,2,3,52
2014,Eric Maynor,PG,26,PHI,8,112,11,29,4,12,7,17,4,8,30
2014,O.J. Mayo,SG,26,MIL,52,1346,224,550,84,227,140,323,76,88,608
2014,Luc Mbah,PF-SF,27,TOT,64,1003,87,193,4,17,83,176,46,67,224
2014,Luc Mbah,SF,27,SAC,9,196,15,32,1,3,14,29,9,13,40
2014,Luc Mbah,PF,27,MIN,55,807,72,161,3,14,69,147,37,54,184
2014,Ray McCallum,PG,22,SAC,45,897,113,300,22,59,91,241,32,43,280
2014,C.J. McCollum,SG,22,POR,38,476,74,178,30,80,44,98,23,34,201
2014,JaVale McGee,C,26,DEN,5,79,17,38,0,0,17,38,1,1,35
2014,Ben McLemore,SG,20,SAC,82,2187,255,679,95,297,160,382,115,143,720
2014,Josh McRoberts,PF,26,CHA,78,2360,247,566,105,291,142,275,62,85,661
2014,Jodie Meeks,SG,26,LAL,77,2556,413,892,162,404,251,488,221,258,1209
2014,Gal Mekel,PG,25,DAL,31,292,30,86,5,20,25,66,8,12,73
2014,Khris Middleton,SF,22,MIL,82,2460,376,854,120,290,256,564,118,137,990
2014,C.J. Miles,SG,26,CLE,51,984,178,409,83,211,95,198,64,75,503
2014,Andre Miller,SG,37,TOT,58,982,106,231,11,21,95,210,60,77,283
2014,Andre Miller,SG,37,DEN,30,570,66,144,9,18,57,126,35,47,176
2014,Andre Miller,SG,37,WAS,28,412,40,87,2,3,38,84,25,30,107
2014,Darius Miller,SF,23,NOP,45,723,73,166,25,77,48,89,29,36,200
2014,Mike Miller,SF,33,MEM,82,1707,213,443,107,233,106,210,46,56,579
2014,Quincy Miller,PF,21,DEN,52,789,94,256,30,94,64,162,39,55,257
2014,Patty Mills,PG,25,SAS,81,1527,309,666,135,318,174,348,73,82,826
2014,Paul Millsap,PF,28,ATL,74,2482,483,1047,76,212,407,835,286,391,1328
2014,Tony Mitchell,SF,24,MIL,3,10,3,5,0,1,3,4,0,0,6
2014,Tony Mitchell,PF,21,DET,21,79,5,12,1,1,4,11,11,19,22
2014,Nazr Mohammed,C,36,CHI,80,562,54,126,0,0,54,126,16,30,124
2014,Greg Monroe,PF,23,DET,82,2690,504,1015,0,1,504,1014,241,367,1249
2014,E'Twaun Moore,SG,24,ORL,79,1506,195,456,57,161,138,295,52,68,499
2014,Darius Morris,PG,23,TOT,27,313,39,96,12,38,27,58,17,26,107
2014,Darius Morris,PG,23,PHI,12,193,29,67,10,24,19,43,15,21,83
2014,Darius Morris,PG,23,LAC,10,54,4,13,0,7,4,6,1,2,9
2014,Darius Morris,PG,23,MEM,5,66,6,16,2,7,4,9,1,3,15
2014,Marcus Morris,SF,24,PHO,82,1800,288,651,99,260,189,391,121,159,796
2014,Markieff Morris,PF,24,PHO,81,2153,411,845,34,108,377,737,259,327,1115
2014,Anthony Morrow,SG,28,NOP,76,1426,238,520,88,195,150,325,72,87,636
2014,Donatas Motiejunas,PF,23,HOU,62,952,131,296,21,84,110,212,58,96,341
2014,Arnett Moultrie,PF,23,PHI,12,187,16,38,0,0,16,38,4,5,36
2014,Timofey Mozgov,C,27,DEN,82,1770,285,545,4,24,281,521,196,260,770
2014,Shabazz Muhammad,SG,21,MIN,37,290,57,124,3,11,54,113,26,40,143
2014,Byron Mullens,C,24,TOT,45,414,73,165,33,89,40,76,10,20,189
2014,Byron Mullens,C,24,LAC,27,167,26,64,13,39,13,25,2,6,67
2014,Byron Mullens,C,24,PHI,18,247,47,101,20,50,27,51,8,14,122
2014,Erik Murphy,C,23,CHI,24,62,3,13,0,3,3,10,0,0,6
2014,Toure' Murry,PG,24,NYK,51,373,56,129,5,12,51,117,23,39,140
2014,Mike Muscala,PF,22,ATL,20,215,31,73,0,3,31,70,14,14,76
2014,Hamady N'Diaye,C,27,SAC,14,74,3,9,0,0,3,9,0,1,6
2014,Steve Nash,PG,39,LAL,15,313,36,94,8,24,28,70,22,24,102
2014,Gary Neal,SG,29,TOT,52,1114,193,471,68,180,125,291,94,105,548
2014,Gary Neal,SG,29,MIL,30,607,108,277,40,111,68,166,45,54,301
2014,Gary Neal,SG,29,CHA,22,507,85,194,28,69,57,125,49,51,247
2014,Nemanja Nedovic,SG,22,GSW,24,142,8,39,3,18,5,21,7,8,26
2014,Jameer Nelson,PG,31,ORL,68,2179,294,747,136,391,158,356,96,112,820
2014,Andrew Nicholson,PF,24,ORL,76,1174,180,420,28,89,152,331,47,57,435
2014,Joakim Noah,C,28,CHI,80,2820,380,800,0,2,380,798,247,335,1007
2014,Steve Novak,PF,30,TOR,54,540,60,146,52,122,8,24,6,6,178
2014,Dirk Nowitzki,PF,35,DAL,80,2628,633,1273,131,329,502,944,338,376,1735
2014,James Nunnally,SF,23,TOT,13,165,15,46,8,25,7,21,6,9,44
2014,James Nunnally,SF,23,ATL,4,54,6,18,3,10,3,8,3,4,18
2014,James Nunnally,SF,23,PHI,9,111,9,28,5,15,4,13,3,5,26
2014,Jermaine O'Neal,PF,35,GSW,44,883,125,248,0,0,125,248,99,132,349
2014,Kyle O'Quinn,C,23,ORL,69,1188,186,371,0,3,186,368,57,83,429
2014,Greg Oden,C,26,MIA,23,212,27,49,0,0,27,49,13,23,67
2014,Victor Oladipo,PG,21,ORL,80,2487,392,936,74,226,318,710,248,318,1106
2014,Kelly Olynyk,C,22,BOS,70,1400,234,502,40,114,194,388,99,122,607
2014,Arinze Onuaku,PF,26,TOT,5,30,1,5,0,0,1,5,1,2,3
2014,Arinze Onuaku,PF,26,NOP,3,25,1,4,0,0,1,4,1,2,3
2014,Arinze Onuaku,PF,26,CLE,2,5,0,1,0,0,0,1,0,0,0
2014,Daniel Orton,C,23,PHI,22,251,21,47,0,0,21,47,23,30,65
2014,Travis Outlaw,SF,29,SAC,63,1065,130,326,41,117,89,209,42,52,343
2014,Zaza Pachulia,C,29,MIL,53,1325,149,349,0,1,149,348,110,130,408
2014,Jannero Pargo,PG,34,CHA,29,242,52,118,24,60,28,58,8,11,136
2014,Tony Parker,PG,31,SAS,68,1997,456,914,25,67,431,847,197,243,1134
2014,Chandler Parsons,SF,25,HOU,74,2783,466,987,130,351,336,636,164,221,1226
2014,Patrick Patterson,PF,24,TOT,65,1533,225,489,55,151,170,338,50,71,555
2014,Patrick Patterson,PF,24,SAC,17,415,50,122,9,39,41,83,9,16,118
2014,Patrick Patterson,PF,24,TOR,48,1118,175,367,46,112,129,255,41,55,437
2014,Chris Paul,PG,28,LAC,62,2171,406,870,78,212,328,658,295,345,1185
2014,Nikola Pekovic,C,28,MIN,54,1663,379,701,0,0,379,701,186,249,944
2014,Kendrick Perkins,C,29,OKC,62,1207,87,193,0,1,87,192,37,67,211
2014,Paul Pierce,SF,36,BRK,75,2098,321,712,112,300,209,412,256,310,1010
2014,Dexter Pittman,C,25,ATL,2,3,0,1,0,0,0,1,0,2,0
2014,Mason Plumlee,C,23,BRK,70,1275,199,302,0,3,199,299,122,195,520
2014,Miles Plumlee,C,25,PHO,80,1964,286,553,0,0,286,553,74,132,646
2014,Quincy Pondexter,SG,25,MEM,15,270,31,79,11,34,20,45,21,26,94
2014,Otto Porter,SF,20,WAS,37,319,33,91,4,21,29,70,8,12,78
2014,Josh Powell,PF,31,HOU,1,19,2,6,0,0,2,6,0,0,4
2014,Phil Pressey,PG,22,BOS,75,1132,78,253,28,106,50,147,29,45,213
2014,A.J. Price,SG,27,MIN,28,99,19,46,6,22,13,24,0,2,44
2014,Ronnie Price,SG,30,ORL,31,377,28,92,9,43,19,49,9,13,74
2014,Pablo Prigioni,PG,36,NYK,66,1283,88,191,65,140,23,51,11,12,252
2014,Tayshaun Prince,SF,33,MEM,76,1948,200,492,20,69,180,423,34,60,454
2014,Miroslav Raduljica,C,26,MIL,48,465,68,126,0,0,68,126,45,55,181
2014,Anthony Randolph,PF,24,DEN,43,527,68,176,18,61,50,115,52,69,206
2014,Shavlik Randolph,PF,30,PHO,14,95,7,14,0,0,7,14,6,11,20
2014,Zach Randolph,PF,32,MEM,79,2705,560,1198,2,20,558,1178,250,337,1372
2014,J.J. Redick,SG,29,LAC,35,987,181,398,73,185,108,213,97,106,532
2014,Glen Rice,SG,23,WAS,11,109,11,37,5,17,6,20,5,7,32
2014,Luke Ridnour,PG,32,TOT,61,1141,126,327,37,108,89,219,17,26,306
2014,Luke Ridnour,PG,32,MIL,36,763,84,219,25,68,59,151,13,19,206
2014,Luke Ridnour,PG,32,CHA,25,378,42,108,12,40,30,68,4,7,100
2014,Austin Rivers,PG,21,NOP,69,1339,192,474,36,99,156,375,110,173,530
2014,Andre Roberson,SG,22,OKC,40,399,33,68,2,13,31,55,7,10,75
2014,Brian Roberts,PG,28,NOP,72,1667,244,581,64,178,180,403,125,133,677
2014,Nate Robinson,PG,29,DEN,44,866,164,383,58,154,106,229,71,85,457
2014,Thomas Robinson,PF,22,POR,70,873,141,293,0,1,141,292,57,101,339
2014,Rajon Rondo,PG,27,BOS,30,998,141,350,26,90,115,260,42,67,350
2014,Derrick Rose,PG,25,CHI,10,311,58,164,16,47,42,117,27,32,159
2014,Terrence Ross,SG,22,TOR,81,2159,318,751,161,408,157,343,82,98,879
2014,Ricky Rubio,PG,23,MIN,82,2638,255,670,44,133,211,537,227,283,781
2014,Brandon Rush,SG,28,UTA,38,418,30,90,16,47,14,43,3,5,79
2014,Robert Sacre,C,24,LAL,65,1089,143,300,0,0,143,300,64,94,350
2014,John Salmons,SG-SF,34,TOT,78,1726,150,413,63,163,87,250,40,52,403
2014,John Salmons,SF,34,SAC,18,445,41,117,16,42,25,75,7,7,105
2014,John Salmons,SG,34,TOR,60,1281,109,296,47,121,62,175,33,45,298
2014,Larry Sanders,C,25,MIL,23,584,76,162,0,1,76,161,26,55,178
2014,Dennis Schroder,PG,20,ATL,49,641,72,188,10,42,62,146,29,43,183
2014,Luis Scola,PF,33,IND,82,1399,263,560,1,7,262,553,99,136,626
2014,Mike Scott,PF,25,ATL,80,1482,301,628,62,200,239,428,103,132,767
2014,Thabo Sefolosha,SG,29,OKC,61,1584,141,340,48,152,93,188,53,69,383
2014,Kevin Seraphin,C,24,WAS,53,578,111,220,0,0,111,220,27,31,249
2014,Ramon Sessions,PG,27,TOT,83,2214,330,769,35,124,295,645,326,404,1021
2014,Ramon Sessions,PG,27,CHA,55,1305,190,465,15,68,175,397,183,234,578
2014,Ramon Sessions,PG,27,MIL,28,909,140,304,20,56,120,248,143,170,443
2014,Mustafa Shakur,PG,29,OKC,3,11,0,3,0,1,0,2,1,2,1
2014,Tornike Shengelia,SF,22,TOT,26,154,13,28,0,6,13,22,3,8,29
2014,Tornike Shengelia,SF,22,BRK,17,137,11,24,0,6,11,18,3,8,25
2014,Tornike Shengelia,SF,22,CHI,9,17,2,4,0,0,2,4,0,0,4
2014,Iman Shumpert,SG,23,NYK,74,1962,183,484,76,228,107,256,53,71,495
2014,Alexey Shved,SG,25,MIN,63,664,76,237,30,102,46,135,68,90,250
2014,Henry Sims,C,23,TOT,46,875,130,274,0,1,130,273,90,121,350
2014,Henry Sims,C,23,CLE,20,168,18,45,0,0,18,45,8,14,44
2014,Henry Sims,C,23,PHI,26,707,112,229,0,1,112,228,82,107,306
2014,Kyle Singler,SF,25,DET,82,2337,269,602,94,246,175,356,152,184,784
2014,Chris Singleton,SF,24,WAS,25,250,25,67,7,19,18,48,18,25,75
2014,Peyton Siva,SG,23,DET,24,224,18,57,7,25,11,32,11,15,54
2014,Donald Sloan,SG,26,IND,48,392,44,117,10,42,34,75,12,20,110
2014,Chris Smith,PG,26,NYK,2,2,0,0,0,0,0,0,0,0,0
2014,Greg Smith,C,23,HOU,11,100,18,28,0,0,18,28,2,5,38
2014,Ish Smith,PG,25,PHO,70,1006,119,281,1,23,118,258,22,39,261
2014,J.R. Smith,SF,28,NYK,74,2421,396,955,189,480,207,475,90,138,1071
2014,Jason Smith,PF,27,NOP,31,830,131,282,0,0,131,282,39,50,301
2014,Josh Smith,SF,28,DET,77,2730,517,1233,70,265,447,968,160,301,1264
2014,Tony Snell,SG,22,CHI,77,1231,129,336,57,178,72,158,31,41,346
2014,James Southerland,SF,23,TOT,4,30,5,15,3,6,2,9,1,2,14
2014,James Southerland,SF,23,CHA,1,3,0,3,0,1,0,2,0,0,0
2014,James Southerland,SF,23,NOP,3,27,5,12,3,5,2,7,1,2,14
2014,Marreese Speights,C,26,GSW,79,982,195,442,8,31,187,411,110,134,508
2014,Tiago Splitter,C,29,SAS,59,1271,181,346,0,3,181,343,121,173,483
2014,D.J. Stephens,SG,23,MIL,3,15,3,7,0,0,3,7,1,1,7
2014,Lance Stephenson,SG,23,IND,78,2752,427,870,86,244,341,626,140,197,1080
2014,Greg Stiemsma,C,28,NOP,55,1007,70,122,0,1,70,121,19,32,159
2014,Julyan Stone,SG,25,TOR,21,120,7,17,2,8,5,9,2,3,18
2014,Amar'e Stoudemire,C,31,NYK,65,1466,311,558,0,0,311,558,150,203,772
2014,Rodney Stuckey,SG,27,DET,73,1950,372,853,24,88,348,765,244,292,1012
2014,Jared Sullinger,PF,21,BOS,74,2041,384,899,56,208,328,691,158,203,982
2014,Jeffery Taylor,SF,24,CHA,26,629,82,218,18,67,64,151,26,47,208
2014,Tyshawn Taylor,PG,23,BRK,23,270,31,91,3,12,28,79,24,30,89
2014,Jeff Teague,PG,25,ATL,79,2542,456,1040,74,225,382,815,318,376,1304
2014,Marquis Teague,SG,20,TOT,40,443,38,119,5,18,33,101,26,35,107
2014,Marquis Teague,SG,20,CHI,19,242,16,66,2,10,14,56,11,16,45
2014,Marquis Teague,SG,20,BRK,21,201,22,53,3,8,19,45,15,19,62
2014,Mirza Teletovic,SF,28,BRK,72,1396,221,529,136,349,85,180,44,62,622
2014,Garrett Temple,SG,27,WAS,75,638,51,141,6,29,45,112,30,43,138
2014,Jason Terry,PG,36,BRK,35,570,55,152,39,103,16,49,10,15,159
2014,Hasheem Thabeet,C,26,OKC,23,192,13,23,0,0,13,23,1,5,27
2014,Adonis Thomas,SF,20,TOT,6,37,6,14,1,5,5,9,1,1,14
2014,Adonis Thomas,SF,20,ORL,4,24,3,9,0,3,3,6,1,1,7
2014,Adonis Thomas,SF,20,PHI,2,13,3,5,1,2,2,3,0,0,7
2014,Isaiah Thomas,PG,24,SAC,72,2497,496,1096,127,364,369,732,346,407,1465
2014,Lance Thomas,SF,25,NOP,5,42,2,9,0,0,2,9,2,4,6
2014,Malcolm Thomas,PF,25,TOT,8,63,7,16,1,4,6,12,0,2,15
2014,Malcolm Thomas,PF,25,SAS,1,15,1,4,0,0,1,4,0,2,2
2014,Malcolm Thomas,PF,25,UTA,7,48,6,12,1,4,5,8,0,0,13
2014,Hollis Thompson,SF,22,PHI,77,1742,171,372,67,167,104,205,52,73,461
2014,Jason Thompson,PF,27,SAC,82,2007,251,496,0,0,251,496,84,145,586
2014,Klay Thompson,SG,23,GSW,81,2868,559,1259,223,535,336,724,147,185,1488
2014,Tristan Thompson,PF,22,CLE,82,2594,363,761,0,1,363,760,235,339,961
2014,Marcus Thornton,SG,26,TOT,72,1741,252,639,109,316,143,323,90,112,703
2014,Marcus Thornton,SG,26,SAC,46,1121,142,373,57,179,85,194,42,52,383
2014,Marcus Thornton,SG,26,BRK,26,620,110,266,52,137,58,129,48,60,320
2014,Jamaal Tinsley,PG,35,UTA,8,110,4,20,1,15,3,5,0,0,9
2014,Anthony Tolliver,PF,28,CHA,64,1298,129,307,102,247,27,60,33,41,393
2014,P.J. Tucker,SF,28,PHO,81,2490,265,615,74,191,191,424,156,201,760
2014,Ronny Turiaf,C,31,MIN,31,606,64,107,0,0,64,107,21,50,149
2014,Hedo Turkoglu,SF,34,LAC,38,392,42,109,22,50,20,59,9,18,115
2014,Evan Turner,SF,25,TOT,81,2457,434,1021,50,156,384,865,213,262,1131
2014,Evan Turner,SF,25,PHI,54,1886,356,831,38,132,318,699,189,228,939
2014,Evan Turner,SF,25,IND,27,571,78,190,12,24,66,166,24,34,192
2014,Jeremy Tyler,C,22,NYK,41,398,60,116,0,0,60,116,26,48,146
2014,Ekpe Udoh,PF,26,MIL,42,804,57,143,0,0,57,143,30,47,144
2014,Beno Udrih,SG,31,TOT,41,643,78,178,19,42,59,136,25,30,200
2014,Beno Udrih,SG,31,NYK,31,588,68,160,17,40,51,120,20,24,173
2014,Beno Udrih,SG,31,MEM,10,55,10,18,2,2,8,16,5,6,27
2014,Jonas Valanciunas,C,21,TOR,81,2282,359,676,0,1,359,675,198,260,916
2014,Anderson Varejao,C,31,CLE,65,1800,227,459,0,7,227,452,92,135,546
2014,Jarvis Varnado,PF,25,TOT,24,339,36,60,0,0,36,60,27,52,99
2014,Jarvis Varnado,PF,25,CHI,1,2,0,0,0,0,0,0,0,0,0
2014,Jarvis Varnado,PF,25,PHI,23,337,36,60,0,0,36,60,27,52,99
2014,Greivis Vasquez,SG-PG,27,TOT,79,1779,277,658,109,289,168,369,95,108,758
2014,Greivis Vasquez,PG,27,SAC,18,465,65,150,16,50,49,100,30,32,176
2014,Greivis Vasquez,SG,27,TOR,61,1314,212,508,93,239,119,269,65,76,582
2014,Jan Vesely,PF,23,TOT,54,776,89,173,0,0,89,173,19,56,197
2014,Jan Vesely,PF,23,WAS,33,470,48,92,0,0,48,92,8,30,104
2014,Jan Vesely,PF,23,DEN,21,306,41,81,0,0,41,81,11,26,93
2014,Charlie Villanueva,PF,29,DET,20,180,35,92,14,56,21,36,8,14,92
2014,Nikola Vucevic,C,23,ORL,57,1812,353,696,0,0,353,696,105,137,811
2014,Sasha Vujacic,SG,29,LAC,2,10,2,5,1,2,1,3,0,0,5
2014,Dwyane Wade,SG,32,MIA,54,1775,415,761,9,32,406,729,189,258,1028
2014,Dion Waiters,SG,22,CLE,70,2072,430,993,92,250,338,743,161,235,1113
2014,Kemba Walker,PG,23,CHA,73,2614,449,1143,109,327,340,816,282,337,1289
2014,John Wall,PG,23,WAS,82,2980,579,1337,108,308,471,1029,317,394,1583
2014,Gerald Wallace,SF,31,BOS,58,1416,116,230,19,64,97,166,47,101,298
2014,Casper Ware,PG,24,PHI,9,116,18,42,7,21,11,21,5,6,48
2014,C.J. Watson,PG,29,IND,63,1193,146,334,53,145,93,189,69,88,414
2014,Earl Watson,PG,34,POR,24,161,3,11,2,7,1,4,4,4,12
2014,Maalik Wayns,PG,22,LAC,2,9,1,2,0,0,1,2,0,0,2
2014,Martell Webster,SF,27,WAS,78,2157,254,587,146,372,108,215,105,125,759
2014,David West,PF,33,IND,80,2472,458,939,4,15,454,924,198,251,1118
2014,Russell Westbrook,PG,25,OKC,46,1412,346,791,68,214,278,577,242,293,1002
2014,D.J. White,PF,27,CHA,2,10,0,1,0,0,0,1,0,0,0
2014,Royce White,PF,22,SAC,3,9,0,1,0,0,0,1,0,0,0
2014,Deron Williams,PG,29,BRK,64,2059,322,716,98,268,224,448,173,216,915
2014,Derrick Williams,SF-PF,22,TOT,78,1820,206,482,26,99,180,383,186,259,624
2014,Derrick Williams,PF,22,MIN,11,162,19,54,2,15,17,39,14,16,54
2014,Derrick Williams,SF,22,SAC,67,1658,187,428,24,84,163,344,172,243,570
2014,Elliot Williams,SG,24,PHI,67,1157,140,337,37,125,103,212,87,119,404
2014,Lou Williams,PG,27,ATL,60,1445,197,493,79,231,118,262,152,179,625
2014,Marvin Williams,PF,27,UTA,66,1674,231,526,84,234,147,292,57,73,603
2014,Mo Williams,PG,31,POR,74,1834,280,672,83,225,197,447,78,89,721
2014,Reggie Williams,SF,27,OKC,3,17,5,9,1,3,4,6,0,0,11
2014,Shawne Williams,PF,27,LAL,36,751,73,192,42,129,31,63,14,20,202
2014,Jeff Withey,C,23,NOP,58,684,69,129,0,1,69,128,52,73,190
2014,Nate Wolters,PG,22,MIL,58,1309,170,389,18,62,152,327,59,90,417
2014,Metta World,SF,34,NYK,29,388,56,141,17,54,39,87,10,16,139
2014,Brandan Wright,C,26,DAL,58,1077,224,331,0,0,224,331,77,106,525
2014,Chris Wright,SF,25,MIL,8,126,21,35,0,1,21,34,6,15,48
2014,Dorell Wright,SF,28,POR,68,984,111,297,69,202,42,95,52,69,343
2014,Tony Wroten,PG,20,PHI,72,1765,345,808,40,188,305,620,209,326,939
2014,Nick Young,SG,28,LAL,64,1810,387,889,135,350,252,539,235,285,1144
2014,Thaddeus Young,PF,25,PHI,79,2718,582,1283,90,292,492,991,163,229,1417
2014,Cody Zeller,C,21,CHA,82,1416,172,404,0,1,172,403,146,200,490
2014,Tyler Zeller,C,24,CLE,70,1049,156,290,0,1,156,289,87,121,399
,,,,,,,,,,,,,,,
2015,Quincy Acy,PF,24,NYK,68,1287,152,331,18,60,134,271,76,97,398
2015,Jordan Adams,SG,20,MEM,30,248,35,86,10,25,25,61,14,23,94
2015,Steven Adams,C,21,OKC,70,1771,217,399,0,2,217,397,103,205,537
2015,Jeff Adrien,PF,28,MIN,17,215,19,44,0,0,19,44,22,38,60
2015,Arron Afflalo,SG,29,TOT,78,2502,375,884,118,333,257,551,167,198,1035
2015,Arron Afflalo,SG,29,DEN,53,1750,281,657,82,243,199,414,127,151,771
2015,Arron Afflalo,SG,29,POR,25,752,94,227,36,90,58,137,40,47,264
2015,Alexis Ajinca,C,26,NOP,68,957,181,329,0,0,181,329,81,99,443
2015,Furkan Aldemir,PF,23,PHI,41,540,40,78,0,5,40,73,13,27,93
2015,Cole Aldrich,C,26,NYK,61,976,144,301,0,0,144,301,50,64,338
2015,LaMarcus Aldridge,PF,29,POR,71,2512,659,1415,37,105,622,1310,306,362,1661
2015,Lavoy Allen,C,25,IND,63,1070,141,299,0,0,141,299,33,47,315
2015,Tony Allen,SG,33,MEM,63,1648,225,455,10,29,215,426,79,126,539
2015,Al-Farouq Aminu,SF,24,DAL,74,1366,147,357,34,124,113,233,84,118,412
2015,Lou Amundson,PF,32,TOT,53,937,109,255,0,1,109,254,41,87,259
2015,Lou Amundson,PF,32,CLE,12,79,4,12,0,0,4,12,3,5,11
2015,Lou Amundson,PF,32,NYK,41,858,105,243,0,1,105,242,38,82,248
2015,Chris Andersen,C,36,MIA,60,1132,120,207,4,13,116,194,76,114,320
2015,Alan Anderson,SG,32,BRK,74,1744,195,440,73,210,122,230,82,101,545
2015,Kyle Anderson,SF,21,SAS,33,358,31,89,3,11,28,78,9,14,74
2015,Ryan Anderson,PF,26,NOP,61,1675,291,729,122,359,169,370,129,151,833
2015,Giannis Antetokounmpo,SG,20,MIL,81,2541,383,780,7,44,376,736,257,347,1030
2015,Carmelo Anthony,SF,30,NYK,40,1428,358,806,61,179,297,627,189,237,966
2015,Joel Anthony,C,32,DET,49,406,36,62,0,0,36,62,15,22,87
2015,Pero Antic,C,32,ATL,63,1037,108,296,52,173,56,123,88,123,356
2015,Trevor Ariza,SF,29,HOU,82,2930,366,910,194,555,172,355,122,143,1048
2015,Darrell Arthur,PF,26,DEN,58,988,155,384,26,110,129,274,46,59,382
2015,Omer Asik,C,28,NOP,76,1982,213,412,0,0,213,412,131,225,557
2015,D.J. Augustin,PG,27,TOT,82,1964,258,647,83,246,175,401,178,205,777
2015,D.J. Augustin,PG,27,DET,54,1287,189,461,49,150,140,311,147,169,574
2015,D.J. Augustin,PG,27,OKC,28,677,69,186,34,96,35,90,31,36,203
2015,Jeff Ayres,PF,27,SAS,51,383,55,95,0,0,55,95,27,36,137
2015,Luke Babbitt,SF,25,NOP,63,830,92,192,59,115,33,77,13,19,256
2015,Cameron Bairstow,PF,24,CHI,18,64,3,14,0,0,3,14,4,5,10
2015,Leandro Barbosa,SG,32,GSW,66,982,183,386,43,112,140,274,58,74,467
2015,J.J. Barea,PG,30,DAL,77,1362,225,536,54,167,171,369,76,94,580
2015,Andrea Bargnani,C,29,NYK,29,785,164,361,15,41,149,320,87,107,430
2015,Harrison Barnes,SF,22,GSW,82,2318,316,656,87,215,229,441,108,150,827
2015,Matt Barnes,SF,34,LAC,76,2271,277,624,136,376,141,248,74,95,764
2015,Earl Barron,C,33,PHO,16,143,12,39,2,4,10,35,6,12,32
2015,Will Barton,SG,24,TOT,58,983,150,353,23,85,127,268,74,94,397
2015,Will Barton,SG,24,POR,30,300,38,100,4,18,34,82,10,15,90
2015,Will Barton,SG,24,DEN,28,683,112,253,19,67,93,186,64,79,307
2015,Brandon Bass,PF,29,BOS,82,1929,344,683,9,32,335,651,169,214,866
2015,Nicolas Batum,SF,26,POR,71,2380,240,600,100,309,140,291,84,98,664
2015,Jerryd Bayless,PG,26,MIL,77,1717,220,516,37,120,183,396,121,137,598
2015,Aron Baynes,C,28,SAS,70,1122,185,327,1,4,184,323,90,104,461
2015,Kent Bazemore,SG,25,ATL,75,1324,141,331,48,132,93,199,60,100,390
2015,Bradley Beal,SG,21,WAS,63,2107,363,851,106,259,257,592,130,166,962
2015,Michael Beasley,PF,26,MIA,24,505,92,212,8,34,84,178,20,26,212
2015,Marco Belinelli,SG,28,SAS,62,1388,199,470,86,230,113,240,84,99,568
2015,Jerrelle Benimon,PF,23,UTA,2,3,0,0,0,0,0,0,0,0,0
2015,Anthony Bennett,PF,21,MIN,57,894,125,297,7,23,118,274,41,64,298
2015,Patrick Beverley,PG,26,HOU,56,1727,204,532,115,323,89,209,45,60,568
2015,Sim Bhullar,C,22,SAC,3,3,1,2,0,0,1,2,0,0,2
2015,Bismack Biyombo,C,22,CHO,64,1243,101,186,0,0,101,186,102,175,304
2015,Tarik Black,C,23,TOT,63,1196,157,273,0,1,157,272,65,118,379
2015,Tarik Black,C,23,HOU,25,393,45,83,0,1,45,82,15,29,105
2015,Tarik Black,C,23,LAL,38,803,112,190,0,0,112,190,50,89,274
2015,DeJuan Blair,PF,25,WAS,29,180,26,57,0,0,26,57,4,6,56
2015,Steve Blake,PG,34,POR,81,1529,122,327,77,219,45,108,29,41,350
2015,Eric Bledsoe,PG,25,PHO,81,2800,468,1046,88,272,380,774,353,441,1377
2015,Vander Blue,SG,22,LAL,2,74,9,30,2,10,7,20,2,5,22
2015,Bojan Bogdanovic,SF,25,BRK,78,1854,261,576,91,256,170,320,87,106,700
2015,Andrew Bogut,C,30,GSW,67,1583,200,355,0,0,200,355,22,42,422
2015,Matt Bonner,PF,34,SAS,72,935,94,230,46,126,48,104,30,37,264
2015,Trevor Booker,PF,27,UTA,79,1564,226,464,29,84,197,380,86,148,567
2015,Carlos Boozer,PF,33,LAL,71,1692,371,743,0,0,371,743,94,150,836
2015,Chris Bosh,C,30,MIA,44,1556,343,745,63,168,280,577,179,232,928
2015,Avery Bradley,SG,24,BOS,77,2428,434,1012,124,352,310,660,79,100,1071
2015,Elton Brand,C,35,ATL,36,486,42,95,0,1,42,94,12,23,96
2015,Corey Brewer,SF,28,TOT,80,2087,343,805,63,235,280,570,168,226,917
2015,Corey Brewer,SF,28,MIN,24,680,94,225,8,41,86,184,55,78,251
2015,Corey Brewer,SF,28,HOU,56,1407,249,580,55,194,194,386,113,148,666
2015,Aaron Brooks,PG,30,CHI,82,1885,344,817,121,313,223,504,145,174,954
2015,Jabari Brown,SG,22,LAL,19,568,70,170,23,62,47,108,64,85,227
2015,Lorenzo Brown,PG,24,MIN,29,549,52,122,6,28,46,94,12,19,122
2015,Markel Brown,SG,23,BRK,47,781,76,210,17,64,59,146,47,57,216
2015,Shannon Brown,SG,29,MIA,5,89,7,19,3,7,4,12,3,4,20
2015,Kobe Bryant,SG,36,LAL,35,1207,266,713,54,184,212,529,196,241,782
2015,Chase Budinger,SF,26,MIN,67,1286,169,390,52,143,117,247,67,81,457
2015,Reggie Bullock,SF,23,TOT,36,338,24,70,15,46,9,24,6,9,69
2015,Reggie Bullock,SF,23,LAC,25,263,23,54,15,39,8,15,4,5,65
2015,Reggie Bullock,SF,23,PHO,11,75,1,16,0,7,1,9,2,4,4
2015,Trey Burke,PG,22,UTA,76,2288,370,1005,124,390,246,615,109,145,973
2015,Alec Burks,SG,23,UTA,27,899,121,300,26,68,95,232,106,129,374
2015,Caron Butler,SF,34,DET,78,1623,161,396,83,219,78,177,55,61,460
2015,Jimmy Butler,SG,25,CHI,65,2513,421,912,73,193,348,719,386,463,1301
2015,Rasual Butler,SF,35,WAS,75,1505,218,517,91,235,127,282,53,67,580
2015,Dwight Buycks,PG,25,LAL,6,123,18,40,7,11,11,29,9,10,52
2015,Will Bynum,SG,32,WAS,7,67,10,31,0,9,10,22,2,4,22
2015,Bruno Caboclo,SF,19,TOR,8,23,4,12,2,3,2,9,0,0,10
2015,Nick Calathes,SG,25,MEM,58,838,104,247,11,43,93,204,24,45,243
2015,Jose Calderon,PG,33,NYK,42,1270,147,354,59,142,88,212,29,32,382
2015,Kentavious Caldwell-Pope,SG,21,DET,82,2587,390,972,153,444,237,528,110,158,1043
2015,Isaiah Canaan,PG,23,TOT,47,938,146,378,91,246,55,132,49,60,432
2015,Isaiah Canaan,PG,23,HOU,25,369,53,131,32,84,21,47,16,21,154
2015,Isaiah Canaan,PG,23,PHI,22,569,93,247,59,162,34,85,33,39,278
2015,Clint Capela,C,20,HOU,12,90,14,29,0,0,14,29,4,23,32
2015,DeMarre Carroll,SF,28,ATL,70,2189,318,653,120,304,198,349,127,181,883
2015,Vince Carter,SG,38,MEM,66,1091,135,406,69,232,66,174,45,57,384
2015,Michael Carter-Williams,PG,23,TOT,66,2149,364,919,36,153,328,766,202,291,966
2015,Michael Carter-Williams,PG,23,PHI,41,1391,232,611,32,125,200,486,117,182,613
2015,Michael Carter-Williams,PG,23,MIL,25,758,132,308,4,28,128,280,85,109,353
2015,Omri Casspi,SF,26,SAC,67,1416,209,427,35,87,174,340,140,191,593
2015,Mario Chalmers,PG,28,MIA,80,2368,267,663,73,248,194,415,206,266,813
2015,Tyson Chandler,C,32,DAL,75,2286,293,440,0,0,293,440,185,257,771
2015,Wilson Chandler,SF,27,DEN,78,2471,418,975,139,406,279,569,110,142,1085
2015,Will Cherry,PG,23,CLE,8,69,5,19,2,9,3,10,3,6,15
2015,Patrick Christopher,SG,26,UTA,4,29,3,12,0,4,3,8,0,0,6
2015,Earl Clark,PF,27,BRK,10,93,11,30,4,14,7,16,1,4,27
2015,Ian Clark,SG,23,TOT,30,192,19,55,10,30,9,25,9,9,57
2015,Ian Clark,SG,23,UTA,23,161,15,44,9,25,6,19,5,5,44
2015,Ian Clark,SG,23,DEN,7,31,4,11,1,5,3,6,4,4,13
2015,Jordan Clarkson,PG,22,LAL,59,1476,267,596,38,121,229,475,131,158,703
2015,Victor Claver,SF,26,POR,10,76,9,20,6,11,3,9,0,0,24
2015,Norris Cole,PG,26,TOT,75,1831,230,558,55,176,175,382,58,81,573
2015,Norris Cole,PG,26,MIA,47,1148,118,306,27,102,91,204,32,46,295
2015,Norris Cole,PG,26,NOP,28,683,112,252,28,74,84,178,26,35,278
2015,Darren Collison,PG,27,SAC,45,1565,260,550,60,161,200,389,145,184,725
2015,Nick Collison,PF,34,OKC,66,1101,106,253,16,60,90,193,45,65,273
2015,Mike Conley,PG,27,MEM,70,2225,393,882,107,277,286,605,214,249,1107
2015,Jack Cooley,PF,23,UTA,16,87,9,22,0,0,9,22,9,21,27
2015,Chris Copeland,SF,30,IND,50,828,112,310,52,167,60,143,33,45,309
2015,Bryce Cotton,PG,22,UTA,15,159,29,69,7,20,22,49,15,18,80
2015,DeMarcus Cousins,C,24,SAC,59,2013,498,1066,2,8,496,1058,423,541,1421
2015,Robert Covington,SF,24,PHI,70,1956,299,756,167,446,132,310,178,217,943
2015,Allen Crabbe,SG,22,POR,51,683,63,153,30,85,33,68,12,16,168
2015,Jamal Crawford,SG,34,LAC,64,1703,332,839,119,364,213,475,227,252,1010
2015,Jae Crowder,SF,24,TOT,82,1647,229,545,61,208,168,337,109,141,628
2015,Jae Crowder,SF,24,DAL,25,265,33,76,13,38,20,38,10,11,89
2015,Jae Crowder,SF,24,BOS,57,1382,196,469,48,170,148,299,99,130,539
2015,Dante Cunningham,PF,27,NOP,66,1652,155,339,1,10,154,329,29,47,340
2015,Jared Cunningham,SG,23,LAC,19,89,12,33,4,13,8,20,7,13,35
2015,Seth Curry,PG,24,PHO,2,8,0,3,0,1,0,2,0,0,0
2015,Stephen Curry,PG,26,GSW,80,2613,653,1341,286,646,367,695,308,337,1900
2015,Samuel Dalembert,C,33,NYK,32,544,57,130,0,0,57,130,14,20,128
2015,Troy Daniels,SG,23,TOT,47,397,61,165,43,118,18,47,11,13,176
2015,Troy Daniels,SG,23,HOU,17,108,15,47,13,43,2,4,3,4,46
2015,Troy Daniels,SG,23,MIN,19,154,19,59,13,39,6,20,2,2,53
2015,Troy Daniels,SG,23,CHO,11,135,27,59,17,36,10,23,6,7,77
2015,Luigi Datome,SF,27,TOT,21,209,43,89,18,40,25,49,1,1,105
2015,Luigi Datome,SF,27,DET,3,17,5,12,1,4,4,8,0,0,11
2015,Luigi Datome,SF,27,BOS,18,192,38,77,17,36,21,41,1,1,94
2015,Brandon Davies,PF,23,TOT,27,423,55,137,8,34,47,103,24,37,142
2015,Brandon Davies,PF,23,PHI,20,379,49,119,7,30,42,89,21,33,126
2015,Brandon Davies,PF,23,BRK,7,44,6,18,1,4,5,14,3,4,16
2015,Anthony Davis,PF,21,NOP,68,2455,642,1199,1,12,641,1187,371,461,1656
2015,Ed Davis,PF,25,LAL,79,1840,282,469,0,0,282,469,92,189,656
2015,Glen Davis,PF,29,LAC,74,904,117,255,0,4,117,251,60,95,294
2015,Andre Dawkins,SG,23,MIA,4,22,1,6,1,6,0,0,0,0,3
2015,Austin Daye,SF,26,TOT,34,344,50,141,24,71,26,70,5,6,129
2015,Austin Daye,SF,26,SAS,26,268,40,115,19,57,21,58,4,4,103
2015,Austin Daye,SF,26,ATL,8,76,10,26,5,14,5,12,1,2,26
2015,Dewayne Dedmon,C,25,ORL,59,845,91,162,0,1,91,161,34,64,216
2015,Matthew Dellavedova,SG,24,CLE,67,1380,111,307,68,167,43,140,29,38,319
2015,Luol Deng,SF,29,MIA,72,2421,369,787,78,220,291,567,191,251,1007
2015,DeMar DeRozan,SG,25,TOR,60,2100,409,990,25,88,384,902,361,434,1204
2015,Boris Diaw,PF,32,SAS,81,1984,291,632,54,169,237,463,72,93,708
2015,Gorgui Dieng,C,25,MIN,73,2193,259,512,1,6,258,506,191,244,710
2015,Spencer Dinwiddie,PG,21,DET,34,455,51,169,12,65,39,104,31,34,145
2015,Joey Dorsey,PF,31,HOU,69,854,80,145,0,1,80,144,24,83,184
2015,Toney Douglas,SG,28,NOP,12,177,19,51,5,18,14,33,8,13,51
2015,Chris Douglas-Roberts,SG,28,LAC,12,103,5,21,1,7,4,14,8,8,19
2015,Goran Dragic,SG-PG,28,TOT,78,2640,502,1002,90,259,412,743,181,234,1275
2015,Goran Dragic,SG,28,PHO,52,1735,340,679,66,186,274,493,97,130,843
2015,Goran Dragic,PG,28,MIA,26,905,162,323,24,73,138,250,84,104,432
2015,Zoran Dragic,SG,25,TOT,16,75,11,30,3,14,8,16,3,5,28
2015,Zoran Dragic,SG,25,PHO,6,13,2,8,0,5,2,3,2,3,6
2015,Zoran Dragic,SG,25,MIA,10,62,9,22,3,9,6,13,1,2,22
2015,Larry Drew,PG,24,PHI,12,219,20,58,4,26,16,32,2,3,46
2015,Andre Drummond,C,21,DET,82,2502,494,961,0,2,494,959,142,365,1130
2015,Jared Dudley,SG,29,MIL,72,1717,198,423,74,192,124,231,48,67,518
2015,Tim Duncan,C,38,SAS,77,2227,419,819,2,7,417,812,230,311,1070
2015,Mike Dunleavy,SF,34,CHI,63,1838,209,481,107,263,102,218,70,87,595
2015,Kevin Durant,SF,26,OKC,27,913,238,467,64,159,174,308,146,171,686
2015,Cleanthony Early,SF,23,NYK,39,647,76,214,22,84,54,130,36,48,210
2015,Wayne Ellington,SG,27,LAL,65,1675,254,617,90,243,164,374,52,64,650
2015,Monta Ellis,SG,29,DAL,80,2699,602,1354,81,284,521,1070,228,303,1513
2015,James Ennis,SF,24,MIA,62,1051,101,247,31,95,70,152,79,94,312
2015,Tyler Ennis,PG,20,TOT,33,411,52,144,12,43,40,101,5,7,121
2015,Tyler Ennis,PG,20,PHO,8,58,9,21,2,6,7,15,2,2,22
2015,Tyler Ennis,PG,20,MIL,25,353,43,123,10,37,33,86,3,5,99
2015,Jeremy Evans,SF,27,UTA,38,266,32,58,2,5,30,53,24,29,90
2015,Reggie Evans,PF,34,SAC,47,764,58,137,0,2,58,135,60,97,176
2015,Tyreke Evans,SG,25,NOP,79,2690,521,1165,69,227,452,938,202,291,1313
2015,Dante Exum,PG,19,UTA,82,1817,145,416,83,264,62,152,20,32,393
2015,Festus Ezeli,C,25,GSW,46,504,76,139,0,0,76,139,49,78,201
2015,Kenneth Faried,PF,25,DEN,75,2086,373,736,1,8,372,728,199,288,946
2015,Jordan Farmar,PG,28,LAC,36,529,61,158,35,97,26,61,10,11,167
2015,Derrick Favors,PF,23,UTA,74,2280,482,918,1,6,481,912,222,332,1187
2015,Raymond Felton,PG,30,DAL,29,281,43,106,10,34,33,72,12,15,108
2015,Landry Fields,SF,26,TOR,26,216,20,41,1,2,19,39,5,6,46
2015,Evan Fournier,SG,22,ORL,58,1661,253,575,85,225,168,350,107,147,698
2015,Randy Foye,SG,31,DEN,50,1087,148,402,94,263,54,139,45,55,435
2015,Jamaal Franklin,SG,23,DEN,3,13,1,2,1,2,0,0,0,0,3
2015,Tim Frazier,PG,24,TOT,11,239,21,61,5,17,16,44,10,21,57
2015,Tim Frazier,PG,24,PHI,6,171,13,43,3,11,10,32,5,15,34
2015,Tim Frazier,PG,24,POR,5,68,8,18,2,6,6,12,5,6,23
2015,Jimmer Fredette,PG,25,NOP,50,509,63,166,9,48,54,118,43,45,178
2015,Joel Freeland,C,27,POR,48,617,74,151,0,0,74,151,21,25,169
2015,Channing Frye,PF,31,ORL,75,1870,191,487,136,346,55,141,31,35,549
2015,Danilo Gallinari,SF,26,DEN,59,1426,228,568,107,301,121,267,171,191,734
2015,Langston Galloway,PG,23,NYK,45,1457,204,511,62,176,142,335,63,78,533
2015,Francisco Garcia,SF,33,HOU,14,200,17,63,10,45,7,18,1,4,45
2015,Kevin Garnett,PF,38,TOT,47,952,143,306,1,7,142,299,36,45,323
2015,Kevin Garnett,PF,38,BRK,42,854,125,275,1,6,124,269,34,41,285
2015,Kevin Garnett,PF,38,MIN,5,98,18,31,0,1,18,30,2,4,38
2015,Marc Gasol,C,30,MEM,81,2687,530,1072,3,17,527,1055,350,440,1413
2015,Pau Gasol,PF,34,CHI,78,2681,570,1153,12,26,558,1127,294,366,1446
2015,Rudy Gay,SF,28,SAC,68,2408,508,1116,79,220,429,896,337,393,1432
2015,Alonzo Gee,SF,27,TOT,54,662,87,186,13,35,74,151,54,77,241
2015,Alonzo Gee,SF,27,DEN,39,511,66,137,10,24,56,113,48,65,190
2015,Alonzo Gee,SF,27,POR,15,151,21,49,3,11,18,38,6,12,51
2015,Paul George,SF,24,IND,6,91,18,49,9,22,9,27,8,11,53
2015,Taj Gibson,PF,29,CHI,62,1692,254,506,0,0,254,506,132,184,640
2015,Manu Ginobili,SG,37,SAS,70,1587,251,589,89,258,162,331,147,204,738
2015,Rudy Gobert,C,22,UTA,82,2158,258,427,0,2,258,425,170,273,686
2015,Drew Gooden,PF,33,WAS,51,864,110,276,23,59,87,217,34,44,277
2015,Archie Goodwin,SG,20,PHO,41,535,79,201,12,41,67,160,61,83,231
2015,Aaron Gordon,PF,19,ORL,47,797,93,208,13,48,80,160,44,61,243
2015,Ben Gordon,SG,31,ORL,56,790,129,295,35,97,94,198,56,67,349
2015,Drew Gordon,PF,24,PHI,9,71,8,19,0,3,8,16,1,2,17
2015,Eric Gordon,SG,26,NOP,61,2018,285,694,141,315,144,379,107,133,818
2015,Marcin Gortat,C,30,WAS,82,2453,439,775,0,3,439,772,123,175,1001
2015,Danny Granger,SF,31,MIA,30,613,65,162,30,84,35,78,28,37,188
2015,Jerami Grant,SF,20,PHI,65,1377,124,352,49,156,75,196,114,193,411
2015,Danny Green,SG,27,SAS,81,2312,322,738,191,457,131,281,111,127,946
2015,Draymond Green,PF,24,GSW,79,2490,339,765,111,329,228,436,132,200,921
2015,Erick Green,PG,23,DEN,43,410,61,162,14,47,47,115,10,12,146
2015,Gerald Green,SG,29,PHO,74,1446,324,778,137,387,187,391,99,120,884
2015,JaMychal Green,PF,24,TOT,24,164,27,47,0,6,27,41,8,10,62
2015,JaMychal Green,PF,24,SAS,4,25,4,7,0,2,4,5,0,0,8
2015,JaMychal Green,PF,24,MEM,20,139,23,40,0,4,23,36,8,10,54
2015,Jeff Green,SF,28,TOT,78,2454,416,967,97,292,319,675,239,287,1168
2015,Jeff Green,SF,28,BOS,33,1093,206,475,47,154,159,321,121,144,580
2015,Jeff Green,SF,28,MEM,45,1361,210,492,50,138,160,354,118,143,588
2015,Willie Green,SG,33,ORL,52,951,118,306,42,121,76,185,28,34,306
2015,Blake Griffin,PF,25,LAC,67,2356,574,1144,10,25,564,1119,311,427,1469
2015,Jorge Gutierrez,PG,26,TOT,20,175,22,41,0,3,22,38,9,13,53
2015,Jorge Gutierrez,PG,26,BRK,10,44,7,14,0,1,7,13,2,3,16
2015,Jorge Gutierrez,PG,26,MIL,10,131,15,27,0,2,15,25,7,10,37
2015,P.J. Hairston,SG,22,CHO,45,687,87,269,49,163,38,106,31,36,254
2015,Jordan Hamilton,SF,24,LAC,14,122,14,35,10,21,4,14,0,0,38
2015,Justin Hamilton,C,24,TOT,41,712,85,178,10,31,75,147,39,47,219
2015,Justin Hamilton,C,24,MIA,24,289,27,65,6,19,21,46,6,7,66
2015,Justin Hamilton,C,24,MIN,17,423,58,113,4,12,54,101,33,40,153
2015,Tyler Hansbrough,PF,29,TOR,74,1058,86,165,1,7,85,158,97,139,270
2015,Tim Hardaway,SG,22,NYK,70,1681,279,717,121,354,158,363,125,156,804
2015,James Harden,SG,25,HOU,81,2981,647,1470,208,555,439,915,715,824,2217
2015,Maurice Harkless,SF,21,ORL,45,674,63,158,10,56,53,102,22,41,158
2015,Devin Harris,PG,31,DAL,76,1685,219,524,95,266,124,258,132,162,665
2015,Gary Harris,SG,20,DEN,55,719,66,217,21,103,45,114,35,47,188
2015,Joe Harris,SG,23,CLE,51,493,48,120,31,84,17,36,9,15,136
2015,Tobias Harris,SF,22,ORL,68,2369,442,949,87,239,355,710,193,245,1164
2015,Udonis Haslem,PF,34,MIA,62,995,107,239,2,10,105,229,45,64,261
2015,Spencer Hawes,PF,26,LAC,73,1274,163,415,55,176,108,239,44,68,425
2015,Chuck Hayes,C,31,TOR,29,255,22,46,0,0,22,46,6,11,50
2015,Gordon Hayward,SF,24,UTA,76,2618,484,1087,120,330,364,757,375,462,1463
2015,Brendan Haywood,C,35,CLE,22,119,14,30,0,0,14,30,7,13,35
2015,Gerald Henderson,SG,27,CHO,80,2315,370,847,45,136,325,711,184,217,969
2015,Xavier Henry,SF,23,LAL,9,86,3,13,0,0,3,13,14,24,20
2015,John Henson,C,24,MIL,67,1228,196,346,0,0,196,346,78,137,470
2015,Roy Hibbert,C,28,IND,76,1926,317,710,0,2,317,708,168,204,802
2015,J.J. Hickson,C,26,DEN,73,1411,218,459,0,2,218,457,116,201,552
2015,Nene Hilario,PF,32,WAS,67,1693,307,601,1,5,306,596,122,202,737
2015,George Hill,PG,28,IND,43,1267,255,535,69,193,186,342,113,143,692
2015,Jordan Hill,C,27,LAL,70,1874,357,777,3,11,354,766,124,168,841
2015,Solomon Hill,SF,23,IND,82,2381,251,634,68,208,183,426,159,193,729
2015,Kirk Hinrich,SG,34,CHI,66,1610,142,381,58,168,84,213,35,50,377
2015,Jrue Holiday,PG,24,NOP,40,1303,238,534,51,135,187,399,65,76,592
2015,Justin Holiday,SG,25,GSW,59,657,91,235,35,109,56,126,37,45,254
2015,Ryan Hollins,C,30,SAC,46,441,53,82,0,0,53,82,31,54,137
2015,Rodney Hood,SG,22,UTA,50,1064,155,374,62,170,93,204,61,80,433
2015,Al Horford,C,28,ATL,76,2318,519,965,11,36,508,929,107,141,1156
2015,Dwight Howard,C,29,HOU,41,1223,251,423,1,2,250,421,143,271,646
2015,Lester Hudson,SG,30,LAC,5,56,6,14,3,6,3,8,3,4,18
2015,Robbie Hummel,SF,25,MIN,45,742,79,172,16,51,63,121,24,29,198
2015,Kris Humphries,PF,29,WAS,64,1345,211,446,0,7,211,439,87,117,509
2015,Serge Ibaka,PF,25,OKC,64,2116,374,786,77,205,297,581,92,110,917
2015,Andre Iguodala,SF,31,GSW,77,2069,231,496,74,212,157,284,68,114,604
2015,Ersan Ilyasova,PF,27,MIL,58,1319,263,557,74,190,189,367,69,107,669
2015,Joe Ingles,SF,27,UTA,79,1673,147,354,72,202,75,152,30,40,396
2015,Kyrie Irving,PG,22,CLE,75,2730,578,1235,157,378,421,857,315,365,1628
2015,Jarrett Jack,PG,31,BRK,80,2241,359,817,39,146,320,671,200,227,957
2015,Reggie Jackson,PG,24,TOT,77,2268,432,996,72,241,360,755,181,218,1117
2015,Reggie Jackson,PG,24,OKC,50,1398,249,576,44,158,205,418,99,115,641
2015,Reggie Jackson,PG,24,DET,27,870,183,420,28,83,155,337,82,103,476
2015,Bernard James,C,29,DAL,16,158,12,27,0,0,12,27,20,23,44
2015,LeBron James,SF,30,CLE,69,2493,624,1279,120,339,504,940,375,528,1743
2015,Al Jefferson,C,30,CHO,65,1992,486,1010,2,5,484,1005,108,165,1082
2015,Cory Jefferson,PF,24,BRK,50,531,75,167,2,15,73,152,31,54,183
2015,Richard Jefferson,SF,34,DAL,74,1244,144,324,66,155,78,169,78,114,432
2015,John Jenkins,SG,23,ATL,24,297,49,99,21,52,28,47,16,19,135
2015,Brandon Jennings,PG,25,DET,41,1173,218,543,76,211,142,332,120,143,632
2015,Jonas Jerebko,PF,27,TOT,75,1230,169,379,54,140,115,239,56,66,448
2015,Jonas Jerebko,PF,27,DET,46,703,91,198,28,76,63,122,31,36,241
2015,Jonas Jerebko,PF,27,BOS,29,527,78,181,26,64,52,117,25,30,207
2015,Grant Jerrett,PF,21,TOT,8,51,7,26,1,15,6,11,1,1,16
2015,Grant Jerrett,PF,21,OKC,5,25,3,17,1,13,2,4,0,0,7
2015,Grant Jerrett,PF,21,UTA,3,26,4,9,0,2,4,7,1,1,9
2015,Amir Johnson,PF,27,TOR,75,1979,298,519,19,46,279,473,79,129,694
2015,Chris Johnson,SF,24,TOT,29,526,62,154,28,95,34,59,14,16,166
2015,Chris Johnson,SF,24,PHI,9,187,19,60,10,39,9,21,6,8,54
2015,Chris Johnson,SF,24,UTA,12,211,31,64,13,38,18,26,6,6,81
2015,Chris Johnson,SF,24,MIL,8,128,12,30,5,18,7,12,2,2,31
2015,James Johnson,PF,27,TOR,70,1370,238,404,11,51,227,353,67,102,554
2015,Joe Johnson,SG,33,BRK,80,2791,446,1025,121,337,325,688,141,176,1154
2015,Nick Johnson,SG,22,HOU,28,262,26,75,5,21,21,54,17,25,74
2015,Tyler Johnson,SG,22,MIA,32,603,70,167,18,48,52,119,32,47,190
2015,Wesley Johnson,SF,27,LAL,76,2245,286,691,91,259,195,432,90,112,753
2015,Dahntay Jones,SF,34,LAC,33,123,6,21,0,4,6,17,9,11,21
2015,James Jones,SF,34,CLE,57,669,74,201,63,175,11,26,39,46,250
2015,Perry Jones,SF,23,OKC,43,631,73,184,14,60,59,124,24,37,184
2015,Terrence Jones,PF,23,HOU,33,889,158,299,13,37,145,262,57,94,386
2015,DeAndre Jordan,C,26,LAC,82,2820,379,534,1,4,378,530,187,471,946
2015,Jerome Jordan,C,28,BRK,44,383,50,94,0,0,50,94,38,44,138
2015,Cory Joseph,PG,23,SAS,79,1444,207,411,16,44,191,367,105,143,535
2015,Chris Kaman,C,32,POR,74,1398,283,549,0,0,283,549,72,102,638
2015,Enes Kanter,C,22,TOT,75,2135,482,928,16,45,466,883,183,234,1163
2015,Enes Kanter,C,22,UTA,49,1326,286,582,13,41,273,541,93,118,678
2015,Enes Kanter,C,22,OKC,26,809,196,346,3,4,193,342,90,116,485
2015,Sergey Karasev,SG,21,BRK,33,555,54,134,16,54,38,80,29,38,153
2015,Ryan Kelly,PF,23,LAL,52,1233,104,309,45,134,59,175,79,95,332
2015,Michael Kidd-Gilchrist,SF,21,CHO,55,1587,224,482,0,0,224,482,150,214,598
2015,Sean Kilpatrick,SG,25,MIN,4,72,7,20,4,13,3,7,4,4,22
2015,Andrei Kirilenko,SF,33,BRK,7,36,0,5,0,0,0,5,3,4,3
2015,Alex Kirk,C,23,CLE,5,14,1,4,0,0,1,4,2,2,4
2015,Brandon Knight,PG-SG,23,TOT,63,2035,375,888,125,321,250,567,195,223,1070
2015,Brandon Knight,PG,23,MIL,52,1688,324,745,104,254,220,491,171,194,923
2015,Brandon Knight,SG,23,PHO,11,347,51,143,21,67,30,76,24,29,147
2015,Kyle Korver,SG,33,ATL,75,2418,292,600,221,449,71,151,106,118,911
2015,Kosta Koufos,C,25,MEM,81,1348,182,358,0,0,182,358,55,85,419
2015,Ognjen Kuzmic,C,24,GSW,16,72,8,12,0,0,8,12,4,4,20
2015,Jeremy Lamb,SG,22,OKC,47,633,104,250,38,111,66,139,49,55,295
2015,Carl Landry,PF,31,SAC,70,1192,190,369,0,0,190,369,123,150,503
2015,Shane Larkin,PG,22,NYK,76,1865,187,432,35,116,152,316,61,78,470
2015,Joffrey Lauvergne,C,23,DEN,24,268,36,89,3,16,33,73,18,28,93
2015,Zach LaVine,PG,19,MIN,77,1902,286,677,57,167,229,510,149,177,778
2015,Ty Lawson,PG,27,DEN,75,2665,404,926,70,205,334,721,265,363,1143
2015,Ricky Ledo,SG,22,TOT,17,244,32,96,10,27,22,69,16,22,90
2015,Ricky Ledo,SG,22,DAL,5,11,0,6,0,3,0,3,1,2,1
2015,Ricky Ledo,SG,22,NYK,12,233,32,90,10,24,22,66,15,20,89
2015,Courtney Lee,SG,29,MEM,77,2354,288,643,90,224,198,419,111,129,777
2015,David Lee,PF,31,GSW,49,904,160,313,0,2,160,311,68,104,388
2015,Malcolm Lee,SG,24,PHI,1,2,0,1,0,0,0,1,0,0,0
2015,Alex Len,C,21,PHO,69,1518,179,353,1,3,178,350,73,104,432
2015,Kawhi Leonard,SF,23,SAS,64,2033,394,822,67,192,327,630,202,252,1057
2015,Meyers Leonard,C,22,POR,55,847,125,245,47,112,78,133,30,32,327
2015,Jon Leuer,PF,25,MEM,63,824,121,273,7,29,114,244,37,59,286
2015,Damian Lillard,PG,24,POR,82,2925,590,1360,196,572,394,788,344,398,1720
2015,Jeremy Lin,PG,26,LAL,74,1907,277,654,65,176,212,478,213,268,832
2015,Shaun Livingston,PG,29,GSW,78,1468,198,396,0,2,198,394,65,91,461
2015,Brook Lopez,C,26,BRK,72,2100,506,987,1,10,505,977,223,274,1236
2015,Robin Lopez,C,26,POR,59,1638,234,437,0,1,234,436,98,127,566
2015,Kevin Love,PF,26,CLE,75,2532,413,952,144,392,269,560,258,321,1228
2015,Kyle Lowry,PG,28,TOR,70,2414,430,1043,132,391,298,652,252,312,1244
2015,Kalin Lucas,PG,25,MEM,1,6,0,1,0,0,0,1,0,0,0
2015,John Lucas,PG,32,DET,21,272,42,104,9,29,33,75,5,5,98
2015,Shelvin Mack,PG,24,ATL,55,833,117,292,40,127,77,165,25,31,299
2015,Ian Mahinmi,C,28,IND,61,1146,117,212,0,0,117,212,31,102,265
2015,Devyn Marble,SG,22,ORL,16,208,14,44,4,22,10,22,5,16,37
2015,Shawn Marion,SF,36,CLE,57,1101,119,267,12,46,107,221,26,34,276
2015,Kendall Marshall,PG,23,MIL,28,417,46,101,18,46,28,55,8,9,118
2015,Cartier Martin,SF,30,DET,23,198,15,53,6,33,9,20,0,0,36
2015,Kenyon Martin,PF,37,MIL,11,104,9,22,0,0,9,22,2,2,20
2015,Kevin Martin,SG,31,MIN,39,1302,267,625,75,191,192,434,170,193,779
2015,Wesley Matthews,SG,28,POR,60,2024,337,752,173,445,164,307,109,145,956
2015,Jason Maxiell,PF,31,CHO,61,878,81,192,0,0,81,192,41,71,203
2015,O.J. Mayo,SG,27,MIL,71,1697,296,701,99,277,197,424,115,139,806
2015,Luc Mbah,PF,28,PHI,67,1916,251,636,62,202,189,434,96,163,660
2015,James Michael,PF,22,GSW,15,137,24,44,0,0,24,44,14,25,62
2015,Ray McCallum,PG,23,SAC,68,1436,206,470,34,111,172,359,57,84,503
2015,C.J. McCollum,SG,23,POR,62,973,159,365,55,139,104,226,51,73,424
2015,K.J. McDaniels,SG,21,TOT,62,1352,172,434,43,150,129,284,100,133,487
2015,K.J. McDaniels,SG,21,PHI,52,1319,167,419,43,147,124,272,99,131,476
2015,K.J. McDaniels,SG,21,HOU,10,33,5,15,0,3,5,12,1,2,11
2015,Doug McDermott,SF,23,CHI,36,321,43,107,13,41,30,66,10,15,109
2015,Mitch McGary,PF,22,OKC,32,485,88,165,0,2,88,163,25,40,201
2015,JaVale McGee,C,27,TOT,23,256,42,79,0,0,42,79,22,33,106
2015,JaVale McGee,C,27,DEN,17,195,34,61,0,0,34,61,20,29,88
2015,JaVale McGee,C,27,PHI,6,61,8,18,0,0,8,18,2,4,18
2015,Ben McLemore,SG,21,SAC,82,2670,363,831,140,391,223,440,130,160,996
2015,Jerel McNeal,PG,27,PHO,6,36,3,11,1,2,2,9,2,2,9
2015,Josh McRoberts,PF,27,MIA,17,296,28,53,8,19,20,34,8,13,72
2015,Jodie Meeks,SG,27,DET,60,1462,222,534,74,212,148,322,145,160,663
2015,Gal Mekel,PG,26,NOP,4,43,3,20,0,3,3,17,0,0,6
2015,Khris Middleton,SF,23,MIL,79,2378,406,869,109,268,297,601,134,156,1055
2015,C.J. Miles,SG,27,IND,70,1841,329,827,154,446,175,381,130,161,942
2015,Andre Miller,PG,38,TOT,81,1253,145,290,7,34,138,256,58,77,355
2015,Andre Miller,PG,38,WAS,51,631,77,142,1,8,76,134,28,39,183
2015,Andre Miller,PG,38,SAC,30,622,68,148,6,26,62,122,30,38,172
2015,Darius Miller,SF,24,NOP,5,43,1,7,0,1,1,6,0,0,2
2015,Mike Miller,SF,34,CLE,52,701,37,114,32,98,5,16,3,4,109
2015,Quincy Miller,PF,22,TOT,10,119,9,38,3,18,6,20,8,11,29
2015,Quincy Miller,PF,22,SAC,6,61,4,18,1,7,3,11,8,11,17
2015,Quincy Miller,PF,22,DET,4,58,5,20,2,11,3,9,0,0,12
2015,Patty Mills,PG,26,SAS,51,801,128,336,62,182,66,154,33,40,351
2015,Elijah Millsap,SG,27,UTA,47,924,81,238,28,90,53,148,58,86,248
2015,Paul Millsap,PF,29,ATL,73,2390,443,930,77,216,366,714,255,337,1218
2015,Nikola Mirotic,PF,23,CHI,82,1654,253,624,99,313,154,311,228,284,833
2015,Nazr Mohammed,C,37,CHI,23,128,13,30,0,0,13,30,1,3,27
2015,Greg Monroe,PF,24,DET,69,2137,423,853,0,0,423,853,252,336,1098
2015,E'Twaun Moore,SG,25,CHI,56,504,62,139,13,38,49,101,12,20,149
2015,Eric Moreland,PF,23,SAC,3,2,1,1,0,0,1,1,0,0,2
2015,Darius Morris,PG,24,BRK,38,299,36,106,7,33,29,73,4,9,83
2015,Marcus Morris,PF,25,PHO,81,2045,331,763,112,313,219,450,71,113,845
2015,Markieff Morris,PF,25,PHO,82,2581,512,1100,57,179,455,921,177,232,1258
2015,Anthony Morrow,SG,29,OKC,74,1806,285,615,141,325,144,290,79,89,790
2015,Donatas Motiejunas,PF,24,HOU,71,2037,353,700,49,133,304,567,100,166,855
2015,Timofey Mozgov,C,28,TOT,81,2045,314,566,2,6,312,560,155,216,785
2015,Timofey Mozgov,C,28,DEN,35,897,117,232,2,6,115,226,63,86,299
2015,Timofey Mozgov,C,28,CLE,46,1148,197,334,0,0,197,334,92,130,486
2015,Shabazz Muhammad,SG,22,MIN,38,866,194,397,20,51,174,346,104,145,512
2015,Toure' Murry,SG-PG,25,TOT,5,18,2,5,0,0,2,5,2,2,6
2015,Toure' Murry,PG,25,UTA,1,1,0,1,0,0,0,1,0,0,0
2015,Toure' Murry,SG,25,WAS,4,17,2,4,0,0,2,4,2,2,6
2015,Mike Muscala,PF,23,ATL,40,502,83,151,9,22,74,129,22,25,197
2015,Shabazz Napier,PG,23,MIA,51,1012,87,228,43,118,44,110,44,56,261
2015,Gary Neal,SG,30,TOT,54,1193,188,503,50,164,138,339,117,135,543
2015,Gary Neal,SG,30,CHO,43,931,143,398,39,133,104,265,88,102,413
2015,Gary Neal,SG,30,MIN,11,262,45,105,11,31,34,74,29,33,130
2015,Jameer Nelson,PG,32,TOT,63,1407,205,504,89,258,116,246,24,36,523
2015,Jameer Nelson,PG,32,DAL,23,584,61,163,38,103,23,60,7,8,167
2015,Jameer Nelson,PG,32,BOS,6,121,9,41,5,25,4,16,6,9,29
2015,Jameer Nelson,PG,32,DEN,34,702,135,300,46,130,89,170,11,19,327
2015,Andrew Nicholson,PF,25,ORL,40,492,83,190,13,41,70,149,15,25,194
2015,Joakim Noah,C,29,CHI,67,2049,190,427,0,2,190,425,105,174,485
2015,Nerlens Noel,C,20,PHI,75,2311,302,653,0,0,302,653,140,230,744
2015,Lucas Nogueira,C,22,TOR,6,23,2,8,0,0,2,8,2,4,6
2015,Steve Novak,SF-PF,31,TOT,35,197,22,56,19,48,3,8,0,2,63
2015,Steve Novak,SF,31,UTA,22,109,16,35,16,33,0,2,0,2,48
2015,Steve Novak,PF,31,OKC,13,88,6,21,3,15,3,6,0,0,15
2015,Dirk Nowitzki,PF,36,DAL,77,2282,487,1062,104,274,383,788,255,289,1333
2015,Jusuf Nurkic,C,20,DEN,62,1103,171,383,0,2,171,381,84,132,426
2015,Johnny O'Bryant,PF,21,MIL,34,368,44,120,0,0,44,120,12,27,100
2015,Kyle O'Quinn,PF,24,ORL,51,824,119,242,12,43,107,199,44,57,294
2015,Victor Oladipo,SG,22,ORL,72,2573,473,1086,84,248,389,838,262,320,1292
2015,Kelly Olynyk,C,23,BOS,64,1423,251,528,61,175,190,353,93,136,656
2015,Arinze Onuaku,C,27,MIN,6,68,12,14,0,0,12,14,3,8,27
2015,Zaza Pachulia,C,30,MIL,73,1730,240,529,0,3,240,526,126,160,606
2015,Kostas Papanikolaou,SF,24,HOU,43,795,69,197,31,106,38,91,13,18,182
2015,Jannero Pargo,PG,35,CHO,9,73,15,35,9,22,6,13,2,2,41
2015,Jabari Parker,PF,19,MIL,25,738,129,263,4,16,125,247,46,66,308
2015,Tony Parker,PG,32,SAS,68,1953,404,832,38,89,366,743,130,166,976
2015,Chandler Parsons,SF,26,DAL,66,2186,383,829,132,347,251,482,139,193,1037
2015,Patrick Patterson,PF,25,TOR,81,2156,240,535,105,283,135,252,63,80,648
2015,Chris Paul,PG,29,LAC,82,2857,568,1170,139,349,429,821,289,321,1564
2015,Adreian Payne,PF,23,TOT,32,739,91,220,1,9,90,211,30,46,213
2015,Adreian Payne,PF,23,ATL,3,19,2,7,0,1,2,6,1,2,5
2015,Adreian Payne,PF,23,MIN,29,720,89,213,1,8,88,205,29,44,208
2015,Elfrid Payton,PG,20,ORL,82,2489,301,708,11,42,290,666,118,214,731
2015,Nikola Pekovic,C,29,MIN,31,815,139,328,0,0,139,328,108,129,386
2015,Kendrick Perkins,C,30,TOT,68,1148,102,227,0,1,102,226,42,83,246
2015,Kendrick Perkins,C,30,OKC,51,981,82,186,0,1,82,185,38,75,202
2015,Kendrick Perkins,C,30,CLE,17,167,20,41,0,0,20,41,4,8,44
2015,Paul Pierce,SF,37,WAS,73,1914,293,656,118,303,175,353,164,210,868
2015,Mason Plumlee,C,24,BRK,82,1743,280,489,0,3,280,486,157,317,717
2015,Miles Plumlee,C,26,TOT,73,1194,136,254,0,0,136,254,22,46,294
2015,Miles Plumlee,C,26,PHO,54,1005,107,195,0,0,107,195,19,38,233
2015,Miles Plumlee,C,26,MIL,19,189,29,59,0,0,29,59,3,8,61
2015,Quincy Pondexter,SF-SG,26,TOT,75,1793,188,447,91,244,97,203,71,96,538
2015,Quincy Pondexter,SG,26,MEM,30,540,48,135,17,73,31,62,21,30,134
2015,Quincy Pondexter,SF,26,NOP,45,1253,140,312,74,171,66,141,50,66,404
2015,Otto Porter,SF,21,WAS,74,1432,176,391,35,104,141,287,58,79,445
2015,Dwight Powell,PF,23,TOT,29,236,31,67,3,11,28,56,25,33,90
2015,Dwight Powell,PF,23,BOS,5,9,4,5,0,0,4,5,1,2,9
2015,Dwight Powell,PF,23,DAL,24,227,27,62,3,11,24,51,24,31,81
2015,Phil Pressey,PG,23,BOS,50,600,64,174,16,65,48,109,33,49,177
2015,A.J. Price,PG,28,TOT,26,324,51,137,15,57,36,80,16,24,133
2015,A.J. Price,PG,28,IND,10,193,39,89,15,39,24,50,12,18,105
2015,A.J. Price,PG,28,CLE,11,87,9,34,0,11,9,23,4,6,22
2015,A.J. Price,PG,28,PHO,5,44,3,14,0,7,3,7,0,0,6
2015,Ronnie Price,PG,31,LAL,43,982,77,223,31,109,46,114,36,45,221
2015,Pablo Prigioni,PG,37,TOT,67,1197,91,228,57,166,34,62,35,41,274
2015,Pablo Prigioni,PG,37,NYK,43,795,68,161,43,115,25,46,22,26,201
2015,Pablo Prigioni,PG,37,HOU,24,402,23,67,14,51,9,16,13,15,73
2015,Tayshaun Prince,SF,34,TOT,58,1397,177,402,31,67,146,335,49,65,434
2015,Tayshaun Prince,SF,34,MEM,26,628,75,183,15,33,60,150,25,30,190
2015,Tayshaun Prince,SF,34,BOS,9,198,33,59,5,8,28,51,5,6,76
2015,Tayshaun Prince,SF,34,DET,23,571,69,160,11,26,58,134,19,29,168
2015,Miroslav Raduljica,C,27,MIN,5,23,3,8,0,0,3,8,2,2,8
2015,Julius Randle,PF,20,LAL,1,14,1,3,0,0,1,3,0,2,2
2015,Shavlik Randolph,PF,31,TOT,21,126,9,35,0,5,9,30,6,12,24
2015,Shavlik Randolph,PF,31,PHO,16,101,6,25,0,4,6,21,5,10,17
2015,Shavlik Randolph,PF,31,BOS,5,25,3,10,0,1,3,9,1,2,7
2015,Zach Randolph,PF,33,MEM,71,2304,454,932,7,20,447,912,228,298,1143
2015,J.J. Redick,SG,30,LAC,78,2409,447,938,200,458,247,480,183,203,1277
2015,Glen Rice,SG,24,WAS,5,43,3,15,1,7,2,8,4,6,11
2015,Jason Richardson,SG,34,PHI,19,416,62,178,31,96,31,82,17,22,172
2015,Luke Ridnour,PG,33,ORL,47,683,75,176,20,63,55,113,18,21,188
2015,Austin Rivers,PG-SG,22,TOT,76,1563,203,496,39,131,164,365,85,126,530
2015,Austin Rivers,SG,22,NOP,35,772,86,222,14,50,72,172,53,71,239
2015,Austin Rivers,PG,22,LAC,41,791,117,274,25,81,92,193,32,55,291
2015,Andre Roberson,SG,23,OKC,67,1286,92,201,21,85,71,116,23,48,228
2015,Brian Roberts,PG,29,CHO,72,1330,176,452,62,193,114,259,66,74,480
2015,Glenn Robinson,SG-SF,21,TOT,35,261,26,67,5,19,21,48,16,24,73
2015,Glenn Robinson,SG,21,MIN,25,108,8,24,1,6,7,18,12,16,29
2015,Glenn Robinson,SF,21,PHI,10,153,18,43,4,13,14,30,4,8,44
2015,Nate Robinson,PG,30,TOT,42,591,88,255,31,112,57,143,31,46,238
2015,Nate Robinson,PG,30,DEN,33,465,71,204,24,92,47,112,26,40,192
2015,Nate Robinson,PG,30,LAC,9,126,17,51,7,20,10,31,5,6,46
2015,Thomas Robinson,PF,23,TOT,54,798,126,260,0,2,126,258,56,106,308
2015,Thomas Robinson,PF,23,POR,32,391,47,91,0,0,47,91,21,48,115
2015,Thomas Robinson,PF,23,PHI,22,407,79,169,0,2,79,167,35,58,193
2015,Rajon Rondo,PG,28,TOT,68,2018,275,645,27,86,248,559,31,78,608
2015,Rajon Rondo,PG,28,BOS,22,699,81,200,8,32,73,168,12,36,182
2015,Rajon Rondo,PG,28,DAL,46,1319,194,445,19,54,175,391,19,42,426
2015,Derrick Rose,PG,26,CHI,51,1530,338,835,76,271,262,564,152,187,904
2015,Terrence Ross,SF,23,TOR,82,2092,309,753,145,390,164,363,44,56,807
2015,Ricky Rubio,PG,24,MIN,22,692,78,219,13,51,65,168,57,71,226
2015,Damjan Rudez,SF,28,IND,68,1047,119,263,69,170,50,93,16,23,323
2015,Brandon Rush,SG,29,GSW,33,271,11,54,3,27,8,27,5,11,30
2015,Robert Sacre,C,25,LAL,67,1133,126,306,0,1,126,305,55,82,307
2015,John Salmons,SF,35,NOP,21,270,16,48,8,26,8,22,2,4,42
2015,JaKarr Sampson,SF,21,PHI,74,1131,146,346,31,127,115,219,63,94,386
2015,Larry Sanders,C,26,MIL,27,586,86,172,0,0,86,172,24,48,196
2015,Dennis Schroder,PG,21,ATL,77,1516,284,665,52,148,232,517,148,179,768
2015,Luis Scola,PF,34,IND,81,1659,300,642,5,20,295,622,158,226,763
2015,Mike Scott,PF,26,ATL,68,1123,201,453,66,192,135,261,61,77,529
2015,Thabo Sefolosha,SF,30,ATL,52,976,104,249,25,78,79,171,45,58,278
2015,Kevin Seraphin,C,25,WAS,79,1235,231,450,0,2,231,448,58,82,520
2015,Ramon Sessions,PG,28,TOT,64,1188,125,334,19,60,106,274,133,173,402
2015,Ramon Sessions,PG,28,SAC,36,642,63,183,6,28,57,155,64,88,196
2015,Ramon Sessions,PG,28,WAS,28,546,62,151,13,32,49,119,69,85,206
2015,Iman Shumpert,SG,24,TOT,62,1545,193,471,67,196,126,275,43,64,496
2015,Iman Shumpert,SG,24,NYK,24,625,88,215,23,66,65,149,25,37,224
2015,Iman Shumpert,SG,24,CLE,38,920,105,256,44,130,61,126,18,27,272
2015,Alexey Shved,SG,26,TOT,42,767,133,335,47,139,86,196,121,150,434
2015,Alexey Shved,SG,26,PHI,17,285,52,130,17,57,35,73,48,57,169
2015,Alexey Shved,SG,26,HOU,9,59,8,24,4,12,4,12,9,11,29
2015,Alexey Shved,SG,26,NYK,16,423,73,181,26,70,47,111,64,82,236
2015,Henry Sims,C,24,PHI,73,1399,238,502,4,22,234,480,106,137,586
2015,Kyle Singler,SF,26,TOT,80,1743,172,446,96,241,76,205,40,52,480
2015,Kyle Singler,SF,26,DET,54,1287,140,350,76,187,64,163,29,36,385
2015,Kyle Singler,SF,26,OKC,26,456,32,96,20,54,12,42,11,16,95
2015,Donald Sloan,PG,27,IND,53,1107,145,355,41,131,104,224,60,77,391
2015,Marcus Smart,PG,20,BOS,67,1808,175,477,91,272,84,205,82,127,523
2015,Greg Smith,PF,24,DAL,42,363,30,49,0,0,30,49,20,39,80
2015,Ish Smith,PG,26,TOT,55,832,143,367,18,60,125,307,34,57,338
2015,Ish Smith,PG,26,OKC,30,155,15,45,1,5,14,40,6,9,37
2015,Ish Smith,PG,26,PHI,25,677,128,322,17,55,111,267,28,48,301
2015,J.R. Smith,SG,29,TOT,70,2080,315,755,163,426,152,329,54,72,847
2015,J.R. Smith,SG,29,NYK,24,619,101,251,32,90,69,161,27,39,261
2015,J.R. Smith,SG,29,CLE,46,1461,214,504,131,336,83,168,27,33,586
2015,Jason Smith,C,28,NYK,82,1785,257,592,15,42,242,550,127,153,656
2015,Josh Smith,PF,29,TOT,83,2300,414,987,72,228,342,759,127,255,1027
2015,Josh Smith,PF,29,DET,28,896,153,391,9,37,144,354,52,111,367
2015,Josh Smith,PF,29,HOU,55,1404,261,596,63,191,198,405,75,144,660
2015,Russ Smith,PG,23,TOT,12,65,8,25,2,11,6,14,12,13,30
2015,Russ Smith,PG,23,NOP,6,29,2,10,1,6,1,4,0,0,5
2015,Russ Smith,PG,23,MEM,6,36,6,15,1,5,5,10,12,13,25
2015,Tony Snell,SF,23,CHI,72,1412,159,371,73,197,86,174,44,55,435
2015,Marreese Speights,C,27,GSW,76,1207,318,646,5,18,313,628,150,178,791
2015,Tiago Splitter,C,30,SAS,52,1030,169,303,0,0,169,303,90,120,428
2015,Nik Stauskas,SG,21,SAC,73,1127,108,296,48,149,60,147,55,64,319
2015,Lance Stephenson,SG,24,CHO,61,1573,207,550,18,105,189,445,69,110,501
2015,Greg Stiemsma,C,29,TOR,17,66,6,8,0,0,6,8,2,4,14
2015,David Stockton,PG,23,SAC,3,33,2,6,1,2,1,4,3,6,8
2015,Jarnell Stokes,PF,21,MEM,19,126,21,37,0,0,21,37,15,28,57
2015,Amar'e Stoudemire,PF,32,TOT,59,1245,273,490,0,4,273,486,134,186,680
2015,Amar'e Stoudemire,PF,32,NYK,36,865,169,311,0,3,169,308,94,127,432
2015,Amar'e Stoudemire,PF,32,DAL,23,380,104,179,0,1,104,178,40,59,248
2015,Rodney Stuckey,PG,28,IND,71,1874,332,754,55,141,277,613,177,216,896
2015,Jared Sullinger,PF,22,BOS,58,1566,311,708,52,184,259,524,96,129,770
2015,Jeffery Taylor,SF,25,CHO,29,430,45,114,11,36,34,78,26,41,127
2015,Jeff Teague,PG,26,ATL,73,2228,408,887,71,207,337,680,275,319,1162
2015,Mirza Teletovic,PF,29,BRK,40,892,122,319,62,193,60,126,33,46,339
2015,Sebastian Telfair,PG,29,OKC,16,327,46,125,18,60,28,65,24,34,134
2015,Garrett Temple,SG,28,WAS,52,735,68,170,33,88,35,82,35,48,204
2015,Jason Terry,SG,37,HOU,77,1641,188,446,126,323,62,123,39,48,541
2015,Isaiah Thomas,PG,25,TOT,67,1726,335,797,129,346,206,451,302,348,1101
2015,Isaiah Thomas,PG,25,PHO,46,1181,218,512,81,207,137,305,184,211,701
2015,Isaiah Thomas,PG,25,BOS,21,545,117,285,48,139,69,146,118,137,400
2015,Lance Thomas,PF-SF,26,TOT,62,1490,182,442,7,22,175,420,72,99,443
2015,Lance Thomas,SF,26,OKC,22,450,45,126,0,1,45,125,23,33,113
2015,Lance Thomas,PF,26,NYK,40,1040,137,316,7,21,130,295,49,66,330
2015,Malcolm Thomas,PF,26,PHI,17,194,18,40,0,7,18,33,9,13,45
2015,Tyrus Thomas,PF,28,MEM,2,7,1,1,0,0,1,1,2,2,4
2015,Hollis Thompson,SG,23,PHI,71,1776,224,543,115,287,109,256,63,89,626
2015,Jason Thompson,PF,28,SAC,81,1991,201,428,0,1,201,427,89,143,491
2015,Klay Thompson,SG,24,GSW,77,2455,602,1299,239,545,363,754,225,256,1668
2015,Tristan Thompson,PF,23,CLE,82,2194,267,488,0,0,267,488,159,248,693
2015,Marcus Thornton,SG,27,TOT,48,721,140,345,54,143,86,202,46,56,380
2015,Marcus Thornton,SG,27,BOS,39,640,127,305,52,124,75,181,42,51,348
2015,Marcus Thornton,SG,27,PHO,9,81,13,40,2,19,11,21,4,5,32
2015,Anthony Tolliver,PF,29,TOT,76,1432,161,393,106,290,55,103,54,69,482
2015,Anthony Tolliver,PF,29,PHO,24,272,26,74,24,62,2,12,4,6,80
2015,Anthony Tolliver,PF,29,DET,52,1160,135,319,82,228,53,91,50,63,402
2015,P.J. Tucker,SF,29,PHO,78,2383,261,596,87,252,174,344,104,143,713
2015,Ronny Turiaf,C,32,MIN,2,19,0,0,0,0,0,0,0,0,0
2015,Hedo Turkoglu,SF,35,LAC,62,705,83,188,60,139,23,49,6,11,232
2015,Evan Turner,SG,26,BOS,82,2260,320,746,33,119,287,627,106,141,779
2015,Ekpe Udoh,PF,27,LAC,33,128,11,24,0,0,11,24,7,9,29
2015,Beno Udrih,PG,32,MEM,79,1494,246,505,26,97,220,408,87,102,605
2015,Jonas Valanciunas,C,22,TOR,80,2096,373,652,0,1,373,651,217,276,963
2015,Anderson Varejao,C,32,CLE,26,636,111,200,0,2,111,198,33,45,255
2015,Greivis Vasquez,PG,28,TOR,82,1991,296,725,133,351,163,374,50,66,775
2015,Charlie Villanueva,PF,30,DAL,64,678,150,362,83,221,67,141,20,35,403
2015,Noah Vonleh,PF,19,CHO,25,259,30,76,5,13,25,63,18,26,83
2015,Nikola Vucevic,C,24,ORL,74,2529,631,1206,2,6,629,1200,164,218,1428
2015,Dwyane Wade,SG,33,MIA,62,1971,509,1084,29,102,480,982,284,370,1331
2015,Dion Waiters,SG,23,TOT,80,2208,375,946,73,246,302,700,117,172,940
2015,Dion Waiters,SG,23,CLE,33,786,138,342,22,86,116,256,47,60,345
2015,Dion Waiters,SG,23,OKC,47,1422,237,604,51,160,186,444,70,112,595
2015,Henry Walker,SF,27,MIA,24,628,58,168,45,132,13,36,14,18,175
2015,Kemba Walker,PG,24,CHO,62,2119,378,981,85,280,293,701,234,283,1075
2015,John Wall,PG,24,WAS,79,2837,519,1166,65,217,454,949,284,362,1387
2015,Gerald Wallace,SF,32,BOS,32,286,14,34,1,3,13,31,6,15,35
2015,T.J. Warren,SF,21,PHO,40,614,113,214,5,21,108,193,14,19,245
2015,C.J. Watson,PG,30,IND,57,1422,181,417,70,175,111,242,138,167,570
2015,David Wear,PF,24,SAC,2,7,0,2,0,1,0,1,0,0,0
2015,Travis Wear,SF,24,NYK,51,672,84,209,11,30,73,179,20,26,199
2015,Martell Webster,SF,28,WAS,32,352,24,91,10,43,14,48,48,64,106
2015,David West,PF,34,IND,66,1895,323,686,4,20,319,666,119,161,769
2015,Russell Westbrook,PG,26,OKC,67,2302,627,1471,86,288,541,1183,546,654,1886
2015,Hassan Whiteside,C,25,MIA,48,1142,243,387,0,0,243,387,78,156,564
2015,Shayne Whittington,PF,23,IND,20,108,19,42,1,6,18,36,18,23,57
2015,Andrew Wiggins,SF,19,MIN,82,2969,497,1137,39,126,458,1011,354,466,1387
2015,C.J. Wilcox,SG,24,LAC,21,101,16,38,7,19,9,19,2,2,41
2015,Deron Williams,PG,30,BRK,68,2114,298,771,87,237,211,534,201,241,884
2015,Derrick Williams,PF,23,SAC,74,1462,217,485,49,156,168,329,134,196,617
2015,Elliot Williams,SG,25,TOT,13,119,14,37,8,18,6,19,1,4,37
2015,Elliot Williams,SG,25,UTA,5,42,6,13,5,7,1,6,1,2,18
2015,Elliot Williams,SG,25,NOP,8,77,8,24,3,11,5,13,0,2,19
2015,Lou Williams,SG,28,TOR,80,2016,375,928,152,447,223,481,340,395,1242
2015,Marvin Williams,PF,28,CHO,78,2035,210,495,95,265,115,230,62,87,577
2015,Mo Williams,PG,32,TOT,68,1980,341,860,119,348,222,512,163,187,964
2015,Mo Williams,PG,32,MIN,41,1149,180,447,59,170,121,277,80,94,499
2015,Mo Williams,PG,32,CHO,27,831,161,413,60,178,101,235,83,93,465
2015,Reggie Williams,SF,28,SAS,20,105,15,39,3,19,12,20,4,4,37
2015,Shawne Williams,SF,28,TOT,63,1087,121,300,64,178,57,122,35,40,341
2015,Shawne Williams,SF,28,MIA,44,924,102,240,60,152,42,88,28,33,292
2015,Shawne Williams,SF,28,DET,19,163,19,60,4,26,15,34,7,7,49
2015,Jeff Withey,C,24,NOP,37,259,32,64,0,0,32,64,34,50,98
2015,Nate Wolters,PG,23,TOT,21,247,20,57,0,7,20,50,2,6,42
2015,Nate Wolters,PG,23,MIL,11,142,12,31,0,5,12,26,1,4,25
2015,Nate Wolters,PG,23,NOP,10,105,8,26,0,2,8,24,1,2,17
2015,Brandan Wright,PF,27,TOT,75,1449,233,363,0,3,233,360,78,112,544
2015,Brandan Wright,PF,27,DAL,27,505,101,135,0,0,101,135,36,48,238
2015,Brandan Wright,PF,27,BOS,8,86,12,21,0,0,12,21,2,4,26
2015,Brandan Wright,PF,27,PHO,40,858,120,207,0,3,120,204,40,60,280
2015,Dorell Wright,SF,29,POR,48,592,72,190,41,108,31,82,34,42,219
2015,Tony Wroten,PG,21,PHI,30,895,175,434,37,142,138,292,120,180,507
2015,James Young,SG,19,BOS,31,332,36,102,17,66,19,36,16,29,105
2015,Nick Young,SG,29,LAL,42,1000,174,476,83,225,91,251,132,148,563
2015,Thaddeus Young,PF,26,TOT,76,2434,451,968,38,115,413,853,131,200,1071
2015,Thaddeus Young,PF,26,MIN,48,1605,289,641,19,65,270,576,88,129,685
2015,Thaddeus Young,PF,26,BRK,28,829,162,327,19,50,143,277,43,71,386
2015,Cody Zeller,C,22,CHO,62,1487,172,373,1,1,171,372,127,164,472
2015,Tyler Zeller,C,25,BOS,82,1731,340,619,0,0,340,619,153,186,833
,,,,,,,,,,,,,,,
2016,Quincy Acy,PF,25,SAC,59,876,119,214,19,49,100,165,50,68,307
2016,Jordan Adams,SG,21,MEM,2,15,2,6,0,1,2,5,3,5,7
2016,Steven Adams,C,22,OKC,80,2014,261,426,0,0,261,426,114,196,636
2016,Arron Afflalo,SG,30,NYK,71,2371,354,799,91,238,263,561,110,131,909
2016,Alexis Ajinca,C,27,NOP,59,861,150,315,0,1,150,314,52,62,352
2016,Cole Aldrich,C,27,LAC,60,800,134,225,0,0,134,225,60,84,328
2016,LaMarcus Aldridge,PF,30,SAS,74,2261,536,1045,0,16,536,1029,259,302,1331
2016,Cliff Alexander,PF,20,POR,8,36,5,10,0,0,5,10,0,0,10
2016,Lavoy Allen,PF,26,IND,79,1599,191,370,0,0,191,370,46,73,428
2016,Tony Allen,SG,34,MEM,64,1620,215,469,15,42,200,427,90,138,535
2016,Al-Farouq Aminu,SF,25,POR,82,2341,299,719,126,349,173,370,115,156,839
2016,Lou Amundson,PF,33,NYK,29,204,19,53,0,0,19,53,14,27,52
2016,Chris Andersen,C,37,TOT,27,402,38,72,4,14,34,58,25,36,105
2016,Chris Andersen,C,37,MIA,7,36,4,10,2,5,2,5,3,4,13
2016,Chris Andersen,C,37,MEM,20,366,34,62,2,9,32,53,22,32,92
2016,Alan Anderson,SG,33,WAS,13,192,21,59,12,37,9,22,11,15,65
2016,James Anderson,SG,26,SAC,51,721,67,178,23,86,44,92,22,29,179
2016,Justin Anderson,SF,22,DAL,55,647,71,175,22,83,49,92,44,55,208
2016,Kyle Anderson,SF,22,SAS,78,1245,138,295,12,37,126,258,62,83,350
2016,Ryan Anderson,PF,27,NOP,66,2008,397,929,131,358,266,571,199,228,1124
2016,Giannis Antetokounmpo,PG,21,MIL,80,2823,513,1013,28,109,485,904,296,409,1350
2016,Thanasis Antetokounmpo,SF,23,NYK,2,6,3,4,0,1,3,3,0,0,6
2016,Carmelo Anthony,SF,31,NYK,72,2530,567,1307,105,310,462,997,334,403,1573
2016,Joel Anthony,C,33,DET,19,96,6,10,0,0,6,10,6,8,18
2016,Keith Appling,PG,23,ORL,5,27,2,8,0,3,2,5,2,2,6
2016,Trevor Ariza,SF,30,HOU,81,2859,357,859,185,499,172,360,126,161,1025
2016,Darrell Arthur,PF,27,DEN,70,1516,221,489,45,117,176,372,40,53,527
2016,Omer Asik,C,29,NOP,68,1178,104,195,0,0,104,195,61,112,269
2016,D.J. Augustin,PG,28,TOT,62,1178,148,350,68,168,80,182,103,128,467
2016,D.J. Augustin,PG,28,OKC,34,519,46,121,24,61,22,60,26,34,142
2016,D.J. Augustin,PG,28,DEN,28,659,102,229,44,107,58,122,77,94,325
2016,Jeff Ayres,C,28,LAC,17,107,12,23,0,1,12,22,6,6,30
2016,Luke Babbitt,SF,26,NOP,47,845,122,289,44,109,78,180,39,50,327
2016,Cameron Bairstow,C,25,CHI,18,103,13,40,1,5,12,35,7,8,34
2016,Leandro Barbosa,SG,33,GSW,68,1079,171,370,39,110,132,260,52,62,433
2016,J.J. Barea,PG,31,DAL,74,1667,317,711,100,260,217,451,74,96,808
2016,Andrea Bargnani,C,30,BRK,46,634,127,279,3,16,124,263,47,57,304
2016,Harrison Barnes,SF,23,GSW,66,2042,295,633,82,214,213,419,102,134,774
2016,Matt Barnes,SF,35,MEM,76,2190,264,693,119,370,145,323,111,138,758
2016,Will Barton,SG,25,DEN,82,2353,425,983,112,325,313,658,216,268,1178
2016,Brandon Bass,PF,30,LAL,66,1342,174,317,0,2,174,315,125,148,473
2016,Nicolas Batum,SF,27,CHO,70,2448,372,873,139,399,233,474,163,192,1046
2016,Jerryd Bayless,SG,27,MIL,52,1505,185,437,101,231,84,206,70,90,541
2016,Aron Baynes,C,29,DET,81,1233,194,384,0,2,194,382,126,165,514
2016,Kent Bazemore,SF,26,ATL,75,2083,320,725,109,305,211,420,123,151,872
2016,Bradley Beal,SG,22,WAS,55,1708,359,799,105,271,254,528,135,176,958
2016,Michael Beasley,PF,27,HOU,20,363,107,205,3,9,104,196,38,49,255
2016,Marco Belinelli,SG,29,SAC,68,1672,245,635,91,297,154,338,115,138,696
2016,Anthony Bennett,PF,22,TOR,19,84,8,27,3,14,5,13,9,10,28
2016,Patrick Beverley,PG,27,HOU,71,2041,258,594,124,310,134,284,60,88,700
2016,Bismack Biyombo,C,23,TOR,82,1808,156,288,0,1,156,287,142,226,454
2016,Nemanja Bjelica,PF,27,MIN,60,1075,110,235,48,125,62,110,40,55,308
2016,Tarik Black,C,24,LAL,39,496,57,104,0,0,57,104,19,45,133
2016,DeJuan Blair,C,26,WAS,29,218,28,68,0,1,28,67,5,13,61
2016,Steve Blake,PG,35,DET,58,986,93,240,52,151,41,89,16,20,254
2016,Eric Bledsoe,PG,26,PHO,31,1059,223,492,48,129,175,363,138,172,632
2016,Bojan Bogdanovic,SF,26,BRK,79,2115,324,749,129,338,195,411,110,132,887
2016,Andrew Bogut,C,31,GSW,70,1451,175,279,1,1,174,278,24,50,375
2016,Matt Bonner,C,35,SAS,30,206,29,57,15,34,14,23,3,4,76
2016,Devin Booker,SG,19,PHO,76,2108,367,867,99,289,268,578,215,256,1048
2016,Trevor Booker,PF,28,UTA,79,1632,190,388,12,41,178,347,71,106,463
2016,Chris Bosh,PF,31,MIA,53,1778,358,767,81,222,277,545,213,268,1010
2016,Avery Bradley,SG,25,BOS,76,2536,456,1019,147,407,309,612,96,123,1155
2016,Elton Brand,C,36,PHI,17,225,31,72,0,1,31,71,8,9,70
2016,Corey Brewer,SF,29,HOU,82,1669,212,552,61,224,151,328,105,140,590
2016,Aaron Brooks,PG,31,CHI,69,1108,188,469,66,185,122,284,49,64,491
2016,Anthony Brown,SF,23,LAL,29,599,39,126,20,70,19,56,17,20,115
2016,Lorenzo Brown,PG,25,PHO,8,61,8,25,1,8,7,17,3,4,20
2016,Markel Brown,SG,24,BRK,62,982,127,322,38,121,89,201,71,94,363
2016,Kobe Bryant,SF,37,LAL,66,1863,398,1113,133,467,265,646,232,281,1161
2016,Chase Budinger,SF,27,TOT,66,929,104,239,24,86,80,153,39,56,271
2016,Chase Budinger,SF,27,IND,49,729,81,194,20,69,61,125,34,48,216
2016,Chase Budinger,SF,27,PHO,17,200,23,45,4,17,19,28,5,8,55
2016,Reggie Bullock,SF,24,DET,37,429,43,98,22,53,21,45,14,15,122
2016,Trey Burke,PG,23,UTA,64,1366,262,634,88,256,174,378,67,82,679
2016,Alec Burks,SG,24,UTA,31,797,137,334,32,79,105,255,106,141,412
2016,Caron Butler,SF,35,SAC,17,176,25,59,3,18,22,41,10,12,63
2016,Jimmy Butler,SG,26,CHI,67,2474,470,1035,64,205,406,830,395,475,1399
2016,Rasual Butler,SF,36,SAS,46,432,49,104,15,49,34,55,11,16,124
2016,Bruno Caboclo,SF,20,TOR,6,43,1,12,1,7,0,5,0,0,3
2016,Jose Calderon,PG,34,NYK,72,2024,209,455,84,203,125,252,42,48,544
2016,Kentavious Caldwell-Pope,SG,22,DET,76,2789,403,960,114,369,289,591,185,228,1105
2016,Isaiah Canaan,SG,24,PHI,77,1966,260,722,176,485,84,237,150,180,846
2016,Clint Capela,C,21,HOU,77,1471,231,397,0,1,231,396,80,211,542
2016,DeMarre Carroll,SF,29,TOR,26,786,105,270,46,118,59,152,30,50,286
2016,Vince Carter,SG,39,MEM,60,1005,133,343,59,169,74,174,70,84,395
2016,Michael Carter-Williams,PG,24,MIL,54,1649,251,555,15,55,236,500,106,162,623
2016,Omri Casspi,SF,27,SAC,69,1880,299,622,112,274,187,348,103,159,813
2016,Willie Cauley-Stein,C,22,SAC,66,1412,191,339,0,2,191,337,81,125,463
2016,Mario Chalmers,PG,29,TOT,61,1373,182,444,46,149,136,295,218,262,628
2016,Mario Chalmers,PG,29,MIA,6,120,10,32,1,11,9,21,12,13,33
2016,Mario Chalmers,PG,29,MEM,55,1253,172,412,45,138,127,274,206,249,595
2016,Tyson Chandler,C,33,PHO,66,1618,183,314,0,1,183,313,106,171,472
2016,Rakeem Christmas,PF,24,IND,1,6,2,2,0,0,2,2,0,0,4
2016,Ian Clark,SG,24,GSW,66,578,89,202,30,84,59,118,28,34,236
2016,Coty Clarke,SF,23,BOS,3,6,2,4,2,2,0,2,0,0,6
2016,Jordan Clarkson,SG,23,LAL,79,2552,475,1098,111,320,364,778,164,204,1225
2016,Norris Cole,PG,27,NOP,45,1198,196,484,33,102,163,382,52,65,477
2016,Darren Collison,PG,28,SAC,74,2219,377,776,87,217,290,559,194,226,1035
2016,Nick Collison,PF,35,OKC,59,699,50,109,0,2,50,107,23,33,123
2016,Mike Conley,PG,28,MEM,56,1761,294,696,78,215,216,481,191,229,857
2016,Pat Connaughton,SG,23,POR,34,143,13,49,5,21,8,28,5,5,36
2016,Chris Copeland,PF,31,MIL,24,156,17,51,10,36,7,15,6,7,50
2016,Bryce Cotton,PG,23,TOT,8,39,4,10,0,3,4,7,0,0,8
2016,Bryce Cotton,PG,23,PHO,3,33,2,8,0,3,2,5,0,0,4
2016,Bryce Cotton,PG,23,MEM,5,6,2,2,0,0,2,2,0,0,4
2016,DeMarcus Cousins,C,25,SAC,65,2246,601,1332,70,210,531,1122,476,663,1748
2016,Robert Covington,SF,25,PHI,67,1903,274,712,170,482,104,230,140,177,858
2016,Allen Crabbe,SG,23,POR,81,2105,311,678,112,285,199,393,98,113,832
2016,Jamal Crawford,SG,35,LAC,79,2126,379,939,117,344,262,595,245,271,1120
2016,Jae Crowder,SF,25,BOS,73,2308,360,813,122,363,238,450,196,239,1038
2016,Dante Cunningham,SF,28,NOP,80,1971,186,412,55,174,131,238,57,82,484
2016,Jared Cunningham,SG,24,TOT,44,410,36,105,12,39,24,66,36,55,120
2016,Jared Cunningham,SG,24,CLE,40,355,32,91,10,32,22,59,30,48,104
2016,Jared Cunningham,SG,24,MIL,4,55,4,14,2,7,2,7,6,7,16
2016,Seth Curry,PG,25,SAC,44,692,102,224,50,111,52,113,45,54,299
2016,Stephen Curry,PG,27,GSW,79,2700,805,1598,402,886,403,712,363,400,2375
2016,Troy Daniels,SG,24,CHO,43,476,89,187,59,122,30,65,5,9,242
2016,Anthony Davis,C,22,NOP,61,2164,560,1136,35,108,525,1028,326,430,1481
2016,Ed Davis,PF,26,POR,81,1684,206,337,0,0,206,337,114,204,526
2016,Branden Dawson,PF,22,LAC,6,29,2,5,0,0,2,5,1,1,5
2016,Dewayne Dedmon,C,26,ORL,58,705,99,177,0,0,99,177,57,76,255
2016,Bryce Dejean-Jones,SG,23,NOP,14,279,28,69,12,32,16,37,11,21,79
2016,Sam Dekker,SF,21,HOU,3,6,0,0,0,0,0,0,0,0,0
2016,Matthew Dellavedova,PG,25,CLE,76,1867,207,511,98,239,109,272,57,66,569
2016,Luol Deng,PF,30,MIA,74,2394,339,745,88,256,251,489,145,192,911
2016,DeMar DeRozan,SG,26,TOR,78,2804,614,1377,47,139,567,1238,555,653,1830
2016,Boris Diaw,PF,33,SAS,76,1386,202,383,25,69,177,314,56,76,485
2016,Gorgui Dieng,C,26,MIN,82,2220,308,579,6,20,302,559,205,248,827
2016,Spencer Dinwiddie,PG,22,DET,12,159,19,54,1,10,18,44,19,33,58
2016,Toney Douglas,PG,29,NOP,61,1262,183,445,81,203,102,242,84,99,531
2016,Goran Dragic,PG,29,MIA,72,2363,417,875,64,205,353,670,120,165,1018
2016,Andre Drummond,C,22,DET,81,2666,552,1060,2,6,550,1054,208,586,1314
2016,Jared Dudley,PF,30,WAS,81,2098,233,487,100,238,133,249,72,98,638
2016,Duje Dukan,SF,24,SAC,1,24,2,10,2,5,0,5,0,0,6
2016,Tim Duncan,C,39,SAS,61,1536,215,441,0,2,215,439,92,131,522
2016,Mike Dunleavy,SF,35,CHI,31,703,77,188,39,99,38,89,29,37,222
2016,Kevin Durant,SF,27,OKC,72,2578,698,1381,186,481,512,900,447,498,2029
2016,Cleanthony Early,SF,24,NYK,17,154,12,40,4,15,8,25,3,4,31
2016,Jarell Eddie,SF,24,WAS,26,147,20,65,15,47,5,18,8,8,63
2016,Wayne Ellington,SG,28,BRK,76,1615,218,561,96,268,122,293,54,63,586
2016,Monta Ellis,SG,30,IND,81,2734,436,1021,87,282,349,739,162,206,1121
2016,James Ennis,SF,25,TOT,22,329,54,113,26,58,28,55,25,34,159
2016,James Ennis,SF,25,MIA,3,7,0,0,0,0,0,0,0,0,0
2016,James Ennis,SF,25,MEM,10,40,4,13,2,8,2,5,6,10,16
2016,James Ennis,SF,25,NOP,9,282,50,100,24,50,26,50,19,24,143
2016,Tyler Ennis,PG,21,MIL,46,654,84,187,13,39,71,148,25,34,206
2016,Jeremy Evans,SF,28,DAL,30,251,26,48,4,16,22,32,15,21,71
2016,Tyreke Evans,SG,26,NOP,25,765,136,314,33,85,103,229,74,93,379
2016,Festus Ezeli,C,26,GSW,46,770,125,228,0,0,125,228,70,132,320
2016,Kenneth Faried,PF,26,DEN,67,1694,349,626,1,2,348,624,136,222,835
2016,Jordan Farmar,PG,29,MEM,12,291,42,100,16,45,26,55,10,10,110
2016,Derrick Favors,PF,24,UTA,62,1983,418,811,0,4,418,807,180,254,1016
2016,Cristiano Felicio,C,23,CHI,31,321,40,72,0,4,40,68,25,35,105
2016,Raymond Felton,PG,31,DAL,80,2192,277,682,60,213,217,469,149,176,763
2016,Evan Fournier,SF,23,ORL,79,2566,429,929,156,390,273,539,199,238,1213
2016,Randy Foye,SG,32,TOT,81,1642,169,482,75,250,94,232,61,74,474
2016,Randy Foye,SG,32,DEN,54,1070,117,333,50,169,67,164,39,47,323
2016,Randy Foye,SG,32,OKC,27,572,52,149,25,81,27,68,22,27,151
2016,Tim Frazier,PG,25,TOT,51,741,96,229,16,48,80,181,53,74,261
2016,Tim Frazier,PG,25,POR,35,272,20,60,3,17,17,43,8,15,51
2016,Tim Frazier,PG,25,NOP,16,469,76,169,13,31,63,138,45,59,210
2016,Jimmer Fredette,SG,26,TOT,6,18,2,5,1,2,1,3,4,5,9
2016,Jimmer Fredette,SG,26,NOP,4,13,1,4,0,1,1,3,0,0,2
2016,Jimmer Fredette,SG,26,NYK,2,5,1,1,1,1,0,0,4,5,7
2016,Channing Frye,PF-C,32,TOT,70,1200,152,347,91,235,61,112,30,35,425
2016,Channing Frye,PF,32,ORL,44,754,81,186,48,121,33,65,19,21,229
2016,Channing Frye,C,32,CLE,26,446,71,161,43,114,28,47,11,14,196
2016,Danilo Gallinari,SF,27,DEN,53,1839,287,700,87,239,200,461,375,432,1036
2016,Langston Galloway,PG,24,NYK,82,2033,231,588,77,224,154,364,86,114,625
2016,Kevin Garnett,PF,39,MIN,38,556,54,115,0,1,54,114,14,21,122
2016,Marc Gasol,C,31,MEM,52,1791,328,707,2,3,326,704,203,245,861
2016,Pau Gasol,C,35,CHI,72,2291,467,995,24,69,443,926,229,289,1187
2016,Rudy Gay,SF,29,SAC,70,2379,466,1007,74,215,392,792,198,254,1204
2016,Alonzo Gee,SF,28,NOP,73,1632,132,255,17,60,115,195,44,66,325
2016,Paul George,SF,25,IND,81,2819,605,1449,210,566,395,883,454,528,1874
2016,Taj Gibson,PF,30,CHI,73,1936,263,500,0,3,263,497,101,146,627
2016,Manu Ginobili,SG,38,SAS,58,1134,197,435,70,179,127,256,91,112,555
2016,Rudy Gobert,C,23,UTA,61,1932,198,354,0,0,198,354,161,283,557
2016,Drew Gooden,PF,34,WAS,30,305,33,103,7,41,26,62,9,14,82
2016,Archie Goodwin,PG,21,PHO,57,1114,176,422,23,99,153,323,130,193,505
2016,Aaron Gordon,PF,20,ORL,78,1863,274,579,42,142,232,437,129,193,719
2016,Eric Gordon,SG,27,NOP,45,1481,231,552,113,294,118,258,111,125,686
2016,Marcin Gortat,C,31,WAS,75,2256,433,764,0,1,433,763,146,207,1012
2016,Andrew Goudelock,PG,27,HOU,8,50,9,20,1,9,8,11,3,4,22
2016,Jerami Grant,SF,21,PHI,77,2066,251,599,35,146,216,453,212,322,749
2016,Jerian Grant,PG,23,NYK,76,1265,154,391,22,100,132,291,96,123,426
2016,Danny Green,SG,28,SAS,79,2062,211,561,116,349,95,212,34,46,572
2016,Draymond Green,PF,25,GSW,81,2808,401,819,100,258,301,561,229,329,1131
2016,Erick Green,PG,24,TOT,9,42,5,13,1,5,4,8,2,2,13
2016,Erick Green,PG,24,DEN,3,7,0,1,0,1,0,0,0,0,0
2016,Erick Green,PG,24,UTA,6,35,5,12,1,4,4,8,2,2,13
2016,Gerald Green,SG,30,MIA,69,1557,230,587,84,260,146,327,72,92,616
2016,JaMychal Green,PF,25,MEM,78,1446,230,495,15,45,215,450,103,137,578
2016,Jeff Green,SF,29,TOT,80,2253,354,824,67,213,287,611,164,220,939
2016,Jeff Green,SF,29,MEM,53,1544,240,557,42,136,198,421,124,155,646
2016,Jeff Green,SF,29,LAC,27,709,114,267,25,77,89,190,40,65,293
2016,Blake Griffin,PF,26,LAC,35,1170,301,603,6,18,295,585,141,194,749
2016,Jorge Gutierrez,PG,27,CHO,12,63,6,11,0,2,6,9,10,11,22
2016,P.J. Hairston,SF,23,TOT,66,1313,145,408,70,241,75,167,50,64,410
2016,P.J. Hairston,SF,23,CHO,48,938,99,276,54,172,45,104,34,42,286
2016,P.J. Hairston,SF,23,MEM,18,375,46,132,16,69,30,63,16,22,124
2016,Jordan Hamilton,SF,25,NOP,11,304,49,116,13,45,36,71,14,21,125
2016,Tyler Hansbrough,PF,30,CHO,44,343,32,71,2,3,30,68,38,65,104
2016,Tim Hardaway,SG,23,ATL,51,864,114,265,48,142,66,123,50,56,326
2016,James Harden,SG,26,HOU,82,3125,710,1617,236,657,474,960,720,837,2376
2016,Maurice Harkless,SF,22,POR,78,1457,195,411,39,140,156,271,69,111,498
2016,Justin Harper,PF,26,DET,5,35,4,10,4,9,0,1,1,2,13
2016,Montrezl Harrell,PF,22,HOU,39,379,58,90,0,1,58,89,24,46,140
2016,Devin Harris,PG,32,DAL,64,1280,167,374,52,158,115,216,101,140,487
2016,Gary Harris,SG,21,DEN,76,2439,359,765,105,297,254,468,109,133,932
2016,Joe Harris,SG,24,CLE,5,15,1,4,1,4,0,0,0,0,3
2016,Tobias Harris,PF,23,TOT,76,2513,417,889,80,239,337,650,202,243,1116
2016,Tobias Harris,PF,23,ORL,49,1610,251,541,47,151,204,390,120,153,669
2016,Tobias Harris,PF,23,DET,27,903,166,348,33,88,133,260,82,90,447
2016,Aaron Harrison,SG,21,CHO,21,93,5,19,3,10,2,9,5,12,18
2016,Udonis Haslem,PF,35,MIA,37,260,23,61,1,9,22,52,12,16,59
2016,Spencer Hawes,PF,27,CHO,57,1035,124,306,38,102,86,204,54,65,340
2016,Chuck Hayes,C,32,HOU,2,24,1,2,0,0,1,2,2,2,4
2016,Gordon Hayward,SF,25,UTA,80,2893,521,1202,143,410,378,792,393,477,1578
2016,Gerald Henderson,SG,28,POR,72,1431,232,529,48,136,184,393,112,146,624
2016,John Henson,C,25,MIL,57,960,164,291,0,1,164,290,69,117,397
2016,Mario Hezonja,SF,20,ORL,79,1413,181,418,67,192,114,226,49,54,478
2016,Roy Hibbert,C,29,LAL,81,1878,182,411,0,2,182,409,117,145,481
2016,J.J. Hickson,C,27,TOT,35,436,80,155,0,1,80,154,46,103,206
2016,J.J. Hickson,C,27,DEN,20,305,55,109,0,0,55,109,27,59,137
2016,J.J. Hickson,C,27,WAS,15,131,25,46,0,1,25,45,19,44,69
2016,Nene Hilario,PF,33,WAS,57,1094,209,384,0,3,209,381,107,185,525
2016,George Hill,PG,29,IND,74,2524,326,739,128,314,198,425,114,150,894
2016,Jordan Hill,C,28,IND,73,1513,278,549,0,1,278,548,89,125,645
2016,Solomon Hill,SF,24,IND,59,866,93,208,24,74,69,134,36,42,246
2016,Darrun Hilliard,SG,22,DET,38,383,52,131,19,50,33,81,29,40,152
2016,Kirk Hinrich,PG,35,TOT,46,631,49,129,24,62,25,67,15,16,137
2016,Kirk Hinrich,PG,35,CHI,35,555,47,118,23,56,24,62,15,16,132
2016,Kirk Hinrich,PG,35,ATL,11,76,2,11,1,6,1,5,0,0,5
2016,Jrue Holiday,PG,25,NOP,65,1831,410,935,87,259,323,676,182,216,1089
2016,Justin Holiday,SG,26,TOT,53,773,88,228,36,105,52,123,27,37,239
2016,Justin Holiday,SG,26,ATL,26,263,24,73,10,45,14,28,5,10,63
2016,Justin Holiday,SG,26,CHI,27,510,64,155,26,60,38,95,22,27,176
2016,Ryan Hollins,C,31,TOT,37,460,49,79,0,0,49,79,26,42,124
2016,Ryan Hollins,C,31,WAS,5,48,4,7,0,0,4,7,0,0,8
2016,Ryan Hollins,C,31,MEM,32,412,45,72,0,0,45,72,26,42,116
2016,Rondae Hollis-Jefferson,SF,21,BRK,29,615,63,138,4,14,59,124,37,52,167
2016,Richaun Holmes,PF,22,PHI,51,702,114,222,8,44,106,178,51,74,287
2016,Rodney Hood,SG,23,UTA,79,2541,408,972,161,449,247,523,172,200,1149
2016,Al Horford,C,29,ATL,82,2631,529,1048,88,256,441,792,103,129,1249
2016,Dwight Howard,C,30,HOU,71,2280,372,600,0,6,372,594,232,474,976
2016,Marcelo Huertas,PG,32,LAL,53,869,97,230,16,61,81,169,27,29,237
2016,Josh Huestis,PF,24,OKC,5,55,5,12,4,6,1,6,0,4,14
2016,Kris Humphries,PF,30,TOT,53,835,121,295,34,108,87,187,67,84,343
2016,Kris Humphries,PF,30,WAS,28,466,64,158,23,67,41,91,29,31,180
2016,Kris Humphries,PF,30,PHO,4,74,10,36,3,10,7,26,6,8,29
2016,Kris Humphries,PF,30,ATL,21,295,47,101,8,31,39,70,32,45,134
2016,R.J. Hunter,SG,22,BOS,36,315,36,98,19,63,17,35,6,7,97
2016,Serge Ibaka,PF,26,OKC,78,2500,416,869,60,184,356,685,91,121,983
2016,Andre Iguodala,SF,32,GSW,65,1732,176,368,54,154,122,214,51,83,457
2016,Ersan Ilyasova,PF,28,TOT,74,1881,280,661,96,259,184,402,111,154,767
2016,Ersan Ilyasova,PF,28,DET,52,1434,216,508,78,215,138,293,79,109,589
2016,Ersan Ilyasova,PF,28,ORL,22,447,64,153,18,44,46,109,32,45,178
2016,Joe Ingles,SF,28,UTA,81,1241,124,291,81,210,43,81,13,18,342
2016,Damien Inglis,SF,20,MIL,20,156,13,37,3,13,10,24,7,8,36
2016,Kyrie Irving,PG,23,CLE,53,1667,394,879,84,262,310,617,169,191,1041
2016,Jarrett Jack,PG,32,BRK,32,1027,140,358,31,102,109,256,100,112,411
2016,Reggie Jackson,PG,25,DET,79,2424,540,1244,118,334,422,910,291,337,1489
2016,LeBron James,SF,31,CLE,76,2709,737,1416,87,282,650,1134,359,491,1920
2016,Al Jefferson,C,31,CHO,47,1096,245,505,0,0,245,505,72,111,562
2016,Cory Jefferson,PF,25,PHO,8,50,9,22,0,1,9,21,4,6,22
2016,Richard Jefferson,SF,35,CLE,74,1326,143,312,66,173,77,139,58,87,410
2016,John Jenkins,SG,24,TOT,43,480,71,160,16,51,55,109,20,24,178
2016,John Jenkins,SG,24,DAL,21,193,29,70,3,19,26,51,8,9,69
2016,John Jenkins,SG,24,PHO,22,287,42,90,13,32,29,58,12,15,109
2016,Brandon Jennings,PG,26,TOT,48,868,112,304,51,155,61,149,57,78,332
2016,Brandon Jennings,PG,26,DET,23,416,53,143,24,77,29,66,27,38,157
2016,Brandon Jennings,PG,26,ORL,25,452,59,161,27,78,32,83,30,40,175
2016,Jonas Jerebko,PF,28,BOS,78,1176,118,286,43,108,75,178,61,78,340
2016,Amir Johnson,PF,28,BOS,79,1800,249,426,10,43,239,383,69,121,577
2016,Chris Johnson,SF,25,UTA,70,857,72,194,27,99,45,95,34,42,205
2016,James Johnson,PF,28,TOR,57,926,114,240,20,66,94,174,39,68,287
2016,Joe Johnson,SF,34,TOT,81,2703,377,859,120,313,257,546,118,142,992
2016,Joe Johnson,SF,34,BRK,57,1934,247,608,85,229,162,379,92,108,671
2016,Joe Johnson,SF,34,MIA,24,769,130,251,35,84,95,167,26,34,321
2016,Orlando Johnson,SG,26,TOT,7,101,9,34,2,10,7,24,6,8,26
2016,Orlando Johnson,SG,26,PHO,2,47,5,17,1,5,4,12,5,6,16
2016,Orlando Johnson,SG,26,NOP,5,54,4,17,1,5,3,12,1,2,10
2016,Stanley Johnson,SF,19,DET,73,1687,225,600,63,205,162,395,80,102,593
2016,Tyler Johnson,SG,23,MIA,36,863,118,243,27,71,91,172,51,64,314
2016,Wesley Johnson,SF,28,LAC,80,1666,208,515,103,309,105,206,30,46,549
2016,Nikola Jokic,C,20,DEN,80,1733,307,600,28,84,279,516,154,190,796
2016,Dahntay Jones,SF,35,CLE,1,42,6,14,1,2,5,12,0,0,13
2016,James Jones,SF,35,CLE,48,463,58,142,41,104,17,38,21,26,178
2016,Terrence Jones,PF,24,HOU,50,1044,166,367,25,79,141,288,77,116,434
2016,Tyus Jones,PG,19,MIN,37,573,56,156,16,53,40,103,28,39,156
2016,DeAndre Jordan,C,27,LAC,77,2598,357,508,0,1,357,507,266,619,980
2016,Cory Joseph,SG,24,TOR,80,2046,257,585,30,110,227,475,133,174,677
2016,Chris Kaman,C,33,POR,16,112,20,43,1,4,19,39,3,3,44
2016,Frank Kaminsky,C,22,CHO,81,1708,215,525,68,202,147,323,108,148,606
2016,Enes Kanter,C,23,OKC,82,1721,414,719,10,21,404,698,200,251,1038
2016,Sergey Karasev,SF,22,BRK,40,399,30,74,11,37,19,37,26,28,97
2016,Sasha Kaun,C,30,CLE,25,95,9,17,0,0,9,17,5,11,23
2016,Ryan Kelly,PF,24,LAL,36,470,55,149,5,37,50,112,37,54,152
2016,Michael Kidd-Gilchrist,SF,22,CHO,7,205,33,61,3,7,30,54,20,29,89
2016,Sean Kilpatrick,SG,26,TOT,31,616,123,270,39,114,84,156,60,67,345
2016,Sean Kilpatrick,SG,26,DEN,8,82,8,21,4,17,4,4,7,8,27
2016,Sean Kilpatrick,SG,26,BRK,23,534,115,249,35,97,80,152,53,59,318
2016,Brandon Knight,SG,24,PHO,52,1870,371,895,120,351,251,544,156,183,1018
2016,Kyle Korver,SG,34,ATL,80,2401,268,616,158,397,110,219,45,54,739
2016,Kosta Koufos,C,26,SAC,78,1482,236,444,0,0,236,444,57,104,529
2016,Jeremy Lamb,SG,23,CHO,66,1227,230,510,56,181,174,329,64,88,580
2016,Carl Landry,PF,32,PHI,36,569,139,250,6,13,133,237,67,91,351
2016,Shane Larkin,PG,23,BRK,78,1751,222,502,39,108,183,394,83,107,566
2016,Joffrey Lauvergne,C,24,DEN,59,1041,195,380,13,53,182,327,62,69,465
2016,Zach LaVine,SG,20,MIN,82,2294,433,959,123,316,310,643,161,203,1150
2016,Ty Lawson,PG,28,TOT,66,1411,139,354,36,108,103,246,59,86,373
2016,Ty Lawson,PG,28,HOU,53,1176,111,287,31,94,80,193,56,80,309
2016,Ty Lawson,PG,28,IND,13,235,28,67,5,14,23,53,3,6,64
2016,Courtney Lee,SG,30,TOT,79,2334,290,639,82,217,208,422,99,118,761
2016,Courtney Lee,SG,30,MEM,51,1489,192,419,51,138,141,281,76,92,511
2016,Courtney Lee,SG,30,CHO,28,845,98,220,31,79,67,141,23,26,250
2016,David Lee,PF,32,TOT,55,903,178,335,0,1,178,334,71,93,427
2016,David Lee,PF,32,BOS,30,470,87,192,0,1,87,191,40,51,214
2016,David Lee,PF,32,DAL,25,433,91,143,0,0,91,143,31,42,213
2016,Alex Len,C,22,PHO,78,1821,264,624,1,7,263,617,174,239,703
2016,Kawhi Leonard,SF,24,SAS,72,2380,551,1090,129,291,422,799,292,334,1523
2016,Meyers Leonard,PF,23,POR,61,1333,195,435,86,228,109,207,35,46,511
2016,Jon Leuer,PF,26,PHO,67,1255,224,466,42,110,182,356,77,101,567
2016,Damian Lillard,PG,25,POR,75,2676,618,1474,229,610,389,864,414,464,1879
2016,Jeremy Lin,SG,27,CHO,78,2048,300,728,76,226,224,502,238,292,914
2016,Shaun Livingston,PG,30,GSW,78,1520,203,379,2,12,201,367,80,93,488
2016,Kevon Looney,PF,19,GSW,5,21,4,7,1,2,3,5,0,0,9
2016,Brook Lopez,C,27,BRK,73,2457,591,1157,2,14,589,1143,317,403,1501
2016,Robin Lopez,C,27,NYK,82,2219,357,662,0,1,357,661,128,161,842
2016,Kevin Love,PF,27,CLE,77,2424,409,977,158,439,251,538,258,314,1234
2016,Kyle Lowry,PG,29,TOR,77,2851,512,1198,212,547,300,651,398,491,1634
2016,Trey Lyles,PF,20,UTA,80,1382,191,436,49,128,142,308,57,82,488
2016,Shelvin Mack,PG,25,TOT,52,1058,182,415,39,125,143,290,45,61,448
2016,Shelvin Mack,PG,25,ATL,24,179,40,95,4,27,36,68,9,12,93
2016,Shelvin Mack,PG,25,UTA,28,879,142,320,35,98,107,222,36,49,355
2016,Ian Mahinmi,C,29,IND,71,1816,264,448,0,0,264,448,132,225,660
2016,Devyn Marble,SG,23,ORL,28,249,21,71,8,32,13,39,10,24,60
2016,Boban Marjanovic,C,27,SAS,54,508,105,174,0,0,105,174,87,114,297
2016,Kendall Marshall,PG,24,PHI,30,400,43,118,16,49,27,69,9,13,111
2016,Jarell Martin,PF,21,MEM,27,380,54,116,0,2,54,114,45,62,153
2016,Kevin Martin,SG,32,TOT,55,1095,156,419,49,136,107,283,153,172,514
2016,Kevin Martin,SG,32,MIN,39,834,126,334,38,103,88,231,125,142,415
2016,Kevin Martin,SG,32,SAS,16,261,30,85,11,33,19,52,28,30,99
2016,Wesley Matthews,SF,29,DAL,78,2644,331,854,189,525,142,329,126,146,977
2016,O.J. Mayo,SG,28,MIL,41,1090,119,321,52,162,67,159,31,40,321
2016,Luc Mbah,PF,29,LAC,75,1274,94,207,13,40,81,167,30,57,231
2016,James Michael,PF,23,GSW,41,262,45,84,1,2,44,82,26,49,117
2016,Ray McCallum,PG,24,TOT,41,475,55,146,15,42,40,104,12,15,137
2016,Ray McCallum,PG,24,SAS,31,256,27,67,5,16,22,51,9,10,68
2016,Ray McCallum,PG,24,MEM,10,219,28,79,10,26,18,53,3,5,69
2016,C.J. McCollum,SG,24,POR,80,2780,641,1431,197,472,444,959,187,226,1666
2016,T.J. McConnell,PG,23,PHI,81,1606,218,464,31,89,187,375,26,41,493
2016,Chris McCullough,PF,20,BRK,24,362,44,109,13,34,31,75,11,23,112
2016,K.J. McDaniels,SF,22,HOU,37,235,29,72,7,25,22,47,24,30,89
2016,Doug McDermott,SF,24,CHI,81,1861,291,644,110,259,181,385,72,84,764
2016,Mitch McGary,PF,23,OKC,20,72,11,23,0,4,11,19,4,10,26
2016,JaVale McGee,C,28,DAL,34,370,77,134,0,1,77,133,18,36,172
2016,Ben McLemore,SG,22,SAC,68,1443,195,455,67,185,128,270,74,103,531
2016,Jordan McRae,PG,24,TOT,22,195,34,78,10,22,24,56,21,28,99
2016,Jordan McRae,PG,24,PHO,7,82,11,26,3,11,8,15,12,15,37
2016,Jordan McRae,PG,24,CLE,15,113,23,52,7,11,16,41,9,13,62
2016,Josh McRoberts,PF,28,MIA,42,595,55,148,12,49,43,99,28,40,150
2016,Jodie Meeks,SG,28,DET,3,43,7,20,4,9,3,11,4,4,22
2016,Salah Mejri,C,29,DAL,34,397,49,78,0,1,49,77,27,46,125
2016,Jordan Mickey,PF,21,BOS,16,57,8,22,0,0,8,22,5,10,21
2016,Khris Middleton,SG,24,MIL,79,2852,507,1142,143,361,364,781,277,312,1434
2016,C.J. Miles,SF,28,IND,64,1464,259,634,142,387,117,247,93,124,753
2016,Andre Miller,PG,39,TOT,39,461,59,106,2,8,57,98,24,32,144
2016,Andre Miller,PG,39,MIN,26,280,36,58,1,4,35,54,15,19,88
2016,Andre Miller,PG,39,SAS,13,181,23,48,1,4,22,44,9,13,56
2016,Mike Miller,SF,35,DEN,47,373,22,62,19,52,3,10,0,0,63
2016,Patty Mills,PG,27,SAS,81,1662,260,612,123,320,137,292,47,58,690
2016,Elijah Millsap,SG,28,UTA,20,173,11,39,1,12,10,27,13,18,36
2016,Paul Millsap,PF,30,ATL,81,2647,501,1066,74,232,427,834,309,408,1385
2016,Nikola Mirotic,PF,24,CHI,66,1646,248,609,135,346,113,263,146,181,777
2016,Nazr Mohammed,C,38,OKC,5,19,3,5,0,0,3,5,2,2,8
2016,Greg Monroe,C,25,MIL,79,2314,491,941,0,1,491,940,228,308,1210
2016,Luis Montero,SG,22,POR,12,42,5,19,1,9,4,10,3,4,14
2016,E'Twaun Moore,SG,26,CHI,59,1263,187,389,47,104,140,285,22,35,443
2016,Eric Moreland,PF,24,SAC,8,48,3,6,0,0,3,6,2,4,8
2016,Marcus Morris,SF,26,DET,80,2856,410,945,108,298,302,647,203,271,1131
2016,Markieff Morris,PF,26,TOT,64,1629,305,718,47,155,258,563,108,147,765
2016,Markieff Morris,PF,26,PHO,37,917,171,431,22,76,149,355,66,92,430
2016,Markieff Morris,PF,26,WAS,27,712,134,287,25,79,109,208,42,55,335
2016,Anthony Morrow,SG,30,OKC,68,926,136,333,79,204,57,129,29,39,380
2016,Donatas Motiejunas,PF,25,HOU,37,547,90,205,16,57,74,148,34,53,230
2016,Timofey Mozgov,C,29,CLE,76,1326,203,359,1,7,202,352,68,95,475
2016,Emmanuel Mudiay,PG,19,DEN,68,2068,329,905,74,232,255,673,140,209,872
2016,Shabazz Muhammad,SF,23,MIN,82,1682,317,681,44,152,273,529,185,242,863
2016,Xavier Munford,SG,23,MEM,14,244,32,77,9,23,23,54,7,14,80
2016,Mike Muscala,C,24,ATL,60,565,76,152,12,39,64,113,31,39,195
2016,Larry Nance,PF,23,LAL,63,1266,158,300,1,10,157,290,32,47,349
2016,Shabazz Napier,PG,24,ORL,55,600,68,201,34,104,34,97,33,45,203
2016,Gary Neal,SG,31,WAS,40,807,151,325,41,100,110,225,47,55,390
2016,Jameer Nelson,PG,33,DEN,39,1036,113,307,43,144,70,163,30,35,299
2016,Raul Neto,PG,23,UTA,81,1499,180,418,64,162,116,256,52,70,476
2016,Andrew Nicholson,PF,26,ORL,56,823,146,310,41,114,105,196,51,65,384
2016,Joakim Noah,C,30,CHI,29,635,51,133,0,1,51,132,22,45,124
2016,Nerlens Noel,C,21,PHI,67,1965,306,587,1,2,305,585,134,227,747
2016,Lucas Nogueira,C,23,TOR,29,225,28,44,1,3,27,41,8,15,65
2016,Steve Novak,PF,32,TOT,10,44,8,18,7,15,1,3,1,1,24
2016,Steve Novak,PF,32,OKC,7,24,6,12,5,9,1,3,0,0,17
2016,Steve Novak,PF,32,MIL,3,20,2,6,2,6,0,0,1,1,7
2016,Dirk Nowitzki,PF,37,DAL,75,2364,498,1112,126,342,372,770,250,280,1372
2016,Jusuf Nurkic,C,21,DEN,32,547,101,242,0,3,101,239,61,99,263
2016,J.J. O'Brien,SF,23,UTA,2,6,0,1,0,0,0,1,0,0,0
2016,Johnny O'Bryant,PF,22,MIL,66,857,86,209,1,1,85,208,27,40,200
2016,Kyle O'Quinn,PF,25,NYK,65,764,129,271,5,22,124,249,46,60,309
2016,Jahlil Okafor,C,20,PHI,53,1591,397,781,1,6,396,775,133,194,928
2016,Victor Oladipo,SG,23,ORL,72,2379,425,970,98,282,327,688,205,247,1153
2016,Kelly Olynyk,C,24,BOS,69,1395,253,556,85,210,168,346,96,128,687
2016,Kelly Oubre,SF,20,WAS,63,671,90,211,25,79,65,132,31,49,236
2016,Zaza Pachulia,C,31,DAL,76,2004,219,470,0,3,219,467,212,276,650
2016,Kostas Papanikolaou,SF,25,DEN,26,294,24,66,10,32,14,34,9,14,67
2016,Jabari Parker,PF,20,MIL,76,2408,443,899,9,35,434,864,175,228,1070
2016,Tony Parker,PG,33,SAS,72,1980,350,710,27,65,323,645,130,171,857
2016,Chandler Parsons,SF,27,DAL,61,1799,320,651,104,251,216,400,93,136,837
2016,Lamar Patterson,SG,24,ATL,35,395,28,80,12,49,16,31,16,22,84
2016,Patrick Patterson,PF,26,TOR,79,2020,204,493,106,293,98,200,29,34,543
2016,Chris Paul,PG,30,LAC,74,2420,515,1114,122,329,393,785,294,328,1446
2016,Adreian Payne,PF,24,MIN,52,486,53,145,9,32,44,113,17,26,132
2016,Cameron Payne,PG,21,OKC,57,698,114,278,36,111,78,167,19,24,283
2016,Elfrid Payton,PG,21,ORL,73,2145,318,730,30,92,288,638,112,190,778
2016,Nikola Pekovic,C,30,MIN,12,156,19,50,0,0,19,50,16,20,54
2016,Kendrick Perkins,C,31,NOP,37,542,40,75,0,0,40,75,11,25,91
2016,Paul Pierce,SF,38,LAC,68,1231,144,397,75,242,69,155,54,66,417
2016,Tibor Pleiss,C,26,UTA,12,82,11,25,0,2,11,23,2,2,24
2016,Mason Plumlee,C,25,POR,82,2084,267,517,0,4,267,513,215,335,749
2016,Miles Plumlee,C,27,MIL,61,870,140,233,0,0,140,233,34,59,314
2016,Otto Porter,SF,22,WAS,75,2276,339,717,98,267,241,450,95,126,871
2016,Bobby Portis,PF,20,CHI,62,1102,186,436,16,52,170,384,48,66,436
2016,Kristaps Porzingis,PF,20,NYK,72,2047,373,886,81,243,292,643,201,240,1028
2016,Dwight Powell,PF,24,DAL,69,992,146,296,2,16,144,280,105,142,399
2016,Norman Powell,SG,22,TOR,49,725,97,229,36,89,61,140,43,53,273
2016,Phil Pressey,PG,24,TOT,23,283,30,78,4,18,26,60,13,25,77
2016,Phil Pressey,PG,24,PHI,14,170,21,55,4,13,17,42,9,18,55
2016,Phil Pressey,PG,24,PHO,9,113,9,23,0,5,9,18,4,7,22
2016,Ronnie Price,PG,32,PHO,62,1211,116,302,68,196,48,106,31,41,331
2016,Pablo Prigioni,PG,38,LAC,59,823,55,147,28,95,27,52,7,8,145
2016,Tayshaun Prince,SF,35,MIN,77,1462,102,229,4,23,98,206,13,19,221
2016,Julius Randle,PF,21,LAL,81,2286,358,835,10,36,348,799,193,270,919
2016,Zach Randolph,PF,34,MEM,68,2016,431,907,6,26,425,881,172,216,1040
2016,J.J. Redick,SG,31,LAC,75,2097,422,880,200,421,222,459,182,205,1226
2016,Willie Reed,C,25,BRK,39,426,76,133,0,0,76,133,30,55,182
2016,Josh Richardson,SG,22,MIA,52,1107,123,272,53,115,70,157,42,63,341
2016,Austin Rivers,SG,23,LAC,67,1464,226,516,62,185,164,331,79,116,593
2016,Andre Roberson,SG,24,OKC,70,1553,136,274,32,103,104,171,33,54,337
2016,Brian Roberts,PG,30,TOT,51,470,74,165,15,42,59,123,42,47,205
2016,Brian Roberts,PG,30,CHO,30,333,51,115,9,27,42,88,34,37,145
2016,Brian Roberts,PG,30,POR,21,137,23,50,6,15,17,35,8,10,60
2016,Glenn Robinson,SF,22,IND,45,508,65,151,14,37,51,114,27,39,171
2016,Nate Robinson,PG,31,NOP,2,23,0,1,0,1,0,0,0,0,0
2016,Thomas Robinson,PF,24,BRK,71,917,130,291,0,1,130,290,47,109,307
2016,Rajon Rondo,PG,29,SAC,72,2537,355,782,62,170,293,612,87,150,859
2016,Derrick Rose,PG,27,CHI,66,2097,447,1048,44,150,403,898,142,179,1080
2016,Terrence Ross,SF,24,TOR,73,1747,270,626,131,339,139,287,49,62,720
2016,Terry Rozier,PG,21,BOS,39,311,29,106,6,27,23,79,8,10,72
2016,Ricky Rubio,PG,25,MIN,76,2323,219,586,62,190,157,396,266,314,766
2016,Damjan Rudez,SF,29,MIN,33,277,25,62,17,50,8,12,8,8,75
2016,Brandon Rush,SG,30,GSW,72,1055,111,260,65,157,46,103,18,28,305
2016,D'Angelo Russell,PG,19,LAL,80,2259,392,956,130,370,262,586,140,190,1054
2016,Robert Sacre,C,26,LAL,25,320,31,75,0,0,31,75,25,38,87
2016,JaKarr Sampson,SF,22,TOT,73,1160,140,317,14,63,126,254,80,122,374
2016,JaKarr Sampson,SF,22,PHI,47,691,86,202,6,34,80,168,62,97,240
2016,JaKarr Sampson,SF,22,DEN,26,469,54,115,8,29,46,86,18,25,134
2016,Dennis Schroder,PG,22,ATL,80,1621,329,781,77,239,252,542,144,182,879
2016,Luis Scola,PF,35,TOR,76,1636,269,598,65,161,204,437,61,84,664
2016,Mike Scott,PF,27,ATL,75,1146,176,376,62,158,114,218,50,63,464
2016,Thabo Sefolosha,SF,31,ATL,75,1758,188,372,42,124,146,248,62,99,480
2016,Kevin Seraphin,C,26,NYK,48,526,84,205,0,2,84,203,19,23,187
2016,Ramon Sessions,PG,29,WAS,82,1667,280,592,36,111,244,481,214,283,810
2016,Iman Shumpert,SG,25,CLE,54,1316,114,305,43,146,71,159,40,51,311
2016,Jonathon Simmons,SG,26,SAS,55,813,122,242,18,47,104,195,69,92,331
2016,Henry Sims,C,25,BRK,14,263,33,77,0,0,33,77,25,30,91
2016,Kyle Singler,SF,27,OKC,68,977,86,221,30,97,56,124,29,44,231
2016,Donald Sloan,PG,28,BRK,61,1318,154,350,38,99,116,251,78,104,424
2016,Marcus Smart,PG,21,BOS,61,1667,184,529,61,241,123,288,129,166,558
2016,Greg Smith,PF,25,MIN,18,192,18,32,0,0,18,32,7,17,43
2016,Ish Smith,PG,27,TOT,77,2239,397,967,56,170,341,797,122,176,972
2016,Ish Smith,PG,27,NOP,27,617,98,228,10,33,88,195,33,43,239
2016,Ish Smith,PG,27,PHI,50,1622,299,739,46,137,253,602,89,133,733
2016,J.R. Smith,SG,30,CLE,77,2362,353,850,204,510,149,340,45,71,955
2016,Jason Smith,C,29,ORL,76,1181,244,503,4,16,240,487,54,67,546
2016,Josh Smith,PF,30,TOT,55,880,127,349,41,143,86,206,37,67,332
2016,Josh Smith,PF,30,LAC,32,459,69,180,18,58,51,122,25,42,181
2016,Josh Smith,PF,30,HOU,23,421,58,169,23,85,35,84,12,25,151
2016,Russ Smith,PG,24,MEM,15,66,7,22,1,5,6,17,8,13,23
2016,Tony Snell,SF,24,CHI,64,1301,126,339,56,155,70,184,30,33,338
2016,Marreese Speights,C,28,GSW,72,832,197,456,24,62,173,394,94,114,512
2016,Tiago Splitter,C,31,ATL,36,579,81,155,0,2,81,153,39,48,201
2016,Nik Stauskas,SG,22,PHI,73,1809,210,545,106,325,104,220,91,118,617
2016,Lance Stephenson,SF,25,TOT,69,1372,228,474,30,78,198,396,87,111,573
2016,Lance Stephenson,SF,25,LAC,43,680,82,166,19,47,63,119,21,30,204
2016,Lance Stephenson,SF,25,MEM,26,692,146,308,11,31,135,277,66,81,369
2016,Alex Stepheson,PF,28,TOT,8,73,9,27,0,0,9,27,4,12,22
2016,Alex Stepheson,PF,28,LAC,4,12,1,1,0,0,1,1,0,2,2
2016,Alex Stepheson,PF,28,MEM,4,61,8,26,0,0,8,26,4,10,20
2016,Jarnell Stokes,C,22,TOT,7,18,3,5,0,0,3,5,1,2,7
2016,Jarnell Stokes,C,22,MEM,2,4,0,0,0,0,0,0,0,0,0
2016,Jarnell Stokes,C,22,MIA,5,14,3,5,0,0,3,5,1,2,7
2016,Amar'e Stoudemire,C,33,MIA,52,762,125,221,0,0,125,221,50,67,300
2016,Rodney Stuckey,PG,29,IND,58,1275,183,443,20,83,163,360,131,158,517
2016,Jared Sullinger,PF,23,BOS,81,1915,351,806,29,103,322,703,103,161,834
2016,Walter Tavares,C,23,ATL,11,73,11,19,0,0,11,19,3,8,25
2016,Jeff Teague,PG,27,ATL,79,2255,434,988,110,275,324,713,261,312,1239
2016,Mirza Teletovic,PF,30,PHO,79,1686,332,777,181,460,151,317,120,155,965
2016,Garrett Temple,SF,29,WAS,80,1951,201,505,89,258,112,247,91,125,582
2016,Jason Terry,SG,38,HOU,72,1258,151,376,93,261,58,115,27,33,422
2016,Isaiah Thomas,PG,26,BOS,82,2644,591,1382,167,465,424,917,474,544,1823
2016,Lance Thomas,PF,27,NYK,59,1313,169,382,44,109,125,273,102,119,484
2016,Hollis Thompson,SG,24,PHI,77,2154,270,680,149,392,121,288,69,96,758
2016,Jason Thompson,C,29,TOT,47,471,52,108,5,15,47,93,38,54,147
2016,Jason Thompson,C,29,GSW,28,179,20,42,0,0,20,42,20,32,60
2016,Jason Thompson,C,29,TOR,19,292,32,66,5,15,27,51,18,22,87
2016,Klay Thompson,SG,25,GSW,80,2666,651,1386,276,650,375,736,193,221,1771
2016,Tristan Thompson,PF,24,CLE,82,2269,247,420,0,0,247,420,149,242,643
2016,Marcus Thornton,SG,28,TOT,61,1109,216,542,91,270,125,272,67,79,590
2016,Marcus Thornton,SG,28,HOU,47,885,174,435,73,216,101,219,51,58,472
2016,Marcus Thornton,SG,28,WAS,14,224,42,107,18,54,24,53,16,21,118
2016,Anthony Tolliver,PF,30,DET,72,1341,128,332,98,272,30,60,29,47,383
2016,Axel Toupane,SF,23,DEN,21,305,25,70,13,40,12,30,13,17,76
2016,Karl-Anthony Towns,C,20,MIN,82,2627,625,1153,30,88,595,1065,223,275,1503
2016,P.J. Tucker,SF,30,PHO,82,2540,239,582,68,206,171,376,106,142,652
2016,Evan Turner,SG,27,BOS,81,2271,343,753,20,83,323,670,148,179,854
2016,Myles Turner,C,19,IND,60,1367,264,530,3,14,261,516,88,121,619
2016,Beno Udrih,PG,33,TOT,44,707,86,198,15,44,71,154,18,20,205
2016,Beno Udrih,PG,33,MEM,8,120,20,46,4,11,16,35,3,3,47
2016,Beno Udrih,PG,33,MIA,36,587,66,152,11,33,55,119,15,17,158
2016,Jonas Valanciunas,C,23,TOR,60,1557,303,536,0,0,303,536,162,213,768
2016,Anderson Varejao,C,33,TOT,53,496,53,124,0,1,53,123,32,50,138
2016,Anderson Varejao,C,33,CLE,31,310,32,76,0,1,32,75,16,21,80
2016,Anderson Varejao,C,33,GSW,22,186,21,48,0,0,21,48,16,29,58
2016,Greivis Vasquez,PG,29,MIL,23,460,45,138,18,73,27,65,22,26,130
2016,Rashad Vaughn,SG,19,MIL,70,1001,81,266,43,147,38,119,12,15,217
2016,Charlie Villanueva,PF,31,DAL,62,665,125,327,47,172,78,155,22,24,319
2016,Noah Vonleh,PF,20,POR,78,1174,117,278,11,46,106,232,38,51,283
2016,Nikola Vucevic,C,25,ORL,65,2037,533,1046,2,9,531,1037,113,150,1181
2016,Sasha Vujacic,SG,31,NYK,61,908,106,277,52,143,54,134,32,39,296
2016,Dwyane Wade,SG,34,MIA,74,2258,540,1183,7,44,533,1139,322,406,1409
2016,Dion Waiters,SG,24,OKC,78,2152,282,706,86,240,196,466,112,157,762
2016,Kemba Walker,PG,25,CHO,81,2885,568,1331,182,490,386,841,371,438,1689
2016,John Wall,PG,25,WAS,77,2784,572,1349,115,328,457,1021,272,344,1531
2016,T.J. Warren,SF,22,PHO,47,1070,221,441,28,70,193,371,45,64,515
2016,C.J. Watson,PG,31,ORL,33,656,47,137,14,48,33,89,34,39,142
2016,Briante Weber,PG,23,TOT,7,169,14,39,0,5,14,34,3,4,31
2016,Briante Weber,PG,23,MEM,6,166,13,38,0,5,13,33,3,4,29
2016,Briante Weber,PG,23,MIA,1,3,1,1,0,0,1,1,0,0,2
2016,Sonny Weems,SG-SF,29,TOT,43,499,42,110,15,41,27,69,8,15,107
2016,Sonny Weems,SG,29,PHO,36,421,35,89,13,32,22,57,7,13,90
2016,Sonny Weems,SF,29,PHI,7,78,7,21,2,9,5,12,1,2,17
2016,David West,PF,35,SAS,78,1404,244,448,3,7,241,441,63,80,554
2016,Russell Westbrook,PG,27,OKC,80,2750,656,1444,101,341,555,1103,465,573,1878
2016,Hassan Whiteside,C,26,MIA,73,2125,413,682,0,0,413,682,214,329,1040
2016,Shayne Whittington,PF,24,IND,7,41,5,11,0,2,5,9,1,2,11
2016,Andrew Wiggins,SF,20,MIN,81,2845,594,1294,57,190,537,1104,430,565,1675
2016,C.J. Wilcox,SG,25,LAC,23,167,26,66,9,23,17,43,9,12,70
2016,Alan Williams,PF,23,PHO,10,68,10,24,0,0,10,24,9,14,29
2016,Deron Williams,PG,31,DAL,65,2106,321,775,97,282,224,493,179,206,918
2016,Derrick Williams,SF,24,NYK,80,1435,254,565,44,150,210,415,194,256,746
2016,Elliot Williams,PG,26,MEM,5,45,2,10,1,4,1,6,3,4,8
2016,Lou Williams,SG,29,LAL,67,1907,283,693,110,320,173,373,352,424,1028
2016,Marvin Williams,PF,29,CHO,81,2338,338,747,152,378,186,369,120,144,948
2016,Mo Williams,PG,33,CLE,41,748,132,302,36,102,96,200,38,42,338
2016,Justise Winslow,SF,19,MIA,78,2232,195,462,32,116,163,346,80,117,502
2016,Jeff Withey,C,25,UTA,51,658,87,162,0,2,87,160,43,59,217
2016,Christian Wood,PF,20,PHI,17,145,22,53,4,11,18,42,13,21,61
2016,Metta World,SF,36,LAL,35,590,55,177,26,84,29,93,40,57,176
2016,Brandan Wright,PF,28,MEM,12,212,35,52,0,0,35,52,13,24,83
2016,Delon Wright,PG,23,TOR,27,229,36,80,5,13,31,67,26,35,103
2016,Tony Wroten,PG,22,PHI,8,144,22,65,3,17,19,48,20,37,67
2016,James Young,SG,20,BOS,29,199,11,36,6,26,5,10,1,4,29
2016,Joe Young,PG,23,IND,41,384,62,169,10,46,52,123,20,25,154
2016,Nick Young,SG,30,LAL,54,1033,126,372,77,237,49,135,63,76,392
2016,Thaddeus Young,PF,27,BRK,73,2407,495,963,7,30,488,933,105,163,1102
2016,Cody Zeller,C,23,CHO,73,1774,231,437,1,10,230,427,175,232,638
2016,Tyler Zeller,C,26,BOS,60,710,138,290,0,0,138,290,88,108,364
,,,,,,,,,,,,,,,
2017,Alex Abrines,SG,23,OKC,68,1055,134,341,94,247,40,94,44,49,406
2017,Quincy Acy,PF,26,TOT,38,558,70,170,37,90,33,80,45,60,222
2017,Quincy Acy,PF,26,DAL,6,48,5,17,1,7,4,10,2,3,13
2017,Quincy Acy,PF,26,BRK,32,510,65,153,36,83,29,70,43,57,209
2017,Steven Adams,C,23,OKC,80,2389,374,655,0,1,374,654,157,257,905
2017,Arron Afflalo,SG,31,SAC,61,1580,185,420,62,151,123,269,83,93,515
2017,Alexis Ajinca,C,28,NOP,39,584,89,178,0,4,89,174,29,40,207
2017,Cole Aldrich,C,28,MIN,62,531,45,86,0,0,45,86,15,22,105
2017,LaMarcus Aldridge,PF,31,SAS,72,2335,500,1049,23,56,477,993,220,271,1243
2017,Lavoy Allen,PF,27,IND,61,871,77,168,0,1,77,167,23,33,177
2017,Tony Allen,SG,35,MEM,71,1914,274,595,15,54,259,541,80,130,643
2017,Al-Farouq Aminu,SF,26,POR,61,1773,183,466,70,212,113,254,96,136,532
2017,Chris Andersen,C,38,CLE,12,114,9,22,0,3,9,19,10,14,28
2017,Alan Anderson,SF,34,LAC,30,308,30,80,14,44,16,36,12,16,86
2017,Justin Anderson,SF,23,TOT,75,1228,186,439,58,194,128,245,102,129,532
2017,Justin Anderson,SF,23,DAL,51,710,111,277,37,122,74,155,70,88,329
2017,Justin Anderson,SF,23,PHI,24,518,75,162,21,72,54,90,32,41,203
2017,Kyle Anderson,SG,23,SAS,72,1020,93,209,15,40,78,169,45,57,246
2017,Ryan Anderson,PF,28,HOU,72,2116,323,773,204,506,119,267,129,150,979
2017,Giannis Antetokounmpo,SF,22,MIL,80,2845,656,1259,49,180,607,1079,471,612,1832
2017,Carmelo Anthony,SF,32,NYK,74,2538,602,1389,151,421,451,968,304,365,1659
2017,Joel Anthony,C,34,SAS,19,122,10,16,0,0,10,16,5,8,25
2017,Trevor Ariza,SF,31,HOU,80,2773,326,798,191,555,135,243,93,126,936
2017,Darrell Arthur,PF,28,DEN,41,639,95,215,53,117,42,98,19,22,262
2017,Omer Asik,C,30,NOP,31,482,31,65,0,0,31,65,23,39,85
2017,D.J. Augustin,PG,29,ORL,78,1538,195,517,95,274,100,243,131,161,616
2017,Luke Babbitt,SF,27,MIA,68,1065,113,281,87,210,26,71,11,15,324
2017,Ron Baker,SG,23,NYK,52,857,82,217,23,86,59,131,28,43,215
2017,Wade Baldwin,PG,20,MEM,33,405,36,115,3,22,33,93,31,37,106
2017,Leandro Barbosa,SG,34,PHO,67,963,172,392,35,98,137,294,40,45,419
2017,J.J. Barea,PG,32,DAL,35,771,142,343,53,148,89,195,44,51,381
2017,Harrison Barnes,PF,24,DAL,79,2803,599,1280,78,222,521,1058,242,281,1518
2017,Matt Barnes,SF,36,TOT,74,1777,185,473,87,263,98,210,70,89,527
2017,Matt Barnes,SF,36,SAC,54,1367,147,383,69,211,78,172,50,66,413
2017,Matt Barnes,SF,36,GSW,20,410,38,90,18,52,20,38,20,23,114
2017,Will Barton,SG,26,DEN,60,1705,295,666,87,235,208,431,143,190,820
2017,Brandon Bass,PF,31,LAC,52,577,107,186,1,3,106,183,77,88,292
2017,Nicolas Batum,SG,28,CHO,77,2617,393,975,135,405,258,570,243,284,1164
2017,Jerryd Bayless,PG,28,PHI,3,71,11,32,2,5,9,27,9,10,33
2017,Aron Baynes,C,30,DET,75,1163,143,279,0,0,143,279,79,94,365
2017,Kent Bazemore,SF,27,ATL,73,1963,295,721,92,266,203,455,119,168,801
2017,Bradley Beal,SG,23,WAS,77,2684,637,1322,223,552,414,770,282,342,1779
2017,Malik Beasley,SG,20,DEN,22,165,33,73,9,28,24,45,8,10,83
2017,Michael Beasley,PF,28,MIL,56,935,216,406,18,43,198,363,78,105,528
2017,Marco Belinelli,SG,30,CHO,74,1778,264,615,102,283,162,332,150,168,780
2017,DeAndre' Bembry,SF,22,ATL,38,371,47,98,1,18,46,80,6,16,101
2017,Dragan Bender,PF,19,PHO,43,574,57,161,28,101,29,60,4,11,146
2017,Anthony Bennett,PF,23,BRK,23,264,38,92,13,48,25,44,26,36,115
2017,Ben Bentil,PF,21,DAL,3,10,0,3,0,1,0,2,0,0,0
2017,Davis Bertans,PF,24,SAS,67,808,103,234,69,173,34,61,28,34,303
2017,Patrick Beverley,SG,28,HOU,67,2058,228,543,110,288,118,255,73,95,639
2017,Bismack Biyombo,C,24,ORL,81,1793,179,339,0,0,179,339,125,234,483
2017,Nemanja Bjelica,PF,28,MIN,65,1190,151,356,56,177,95,179,45,61,403
2017,Tarik Black,C,25,LAL,67,1091,150,294,1,2,149,292,82,109,383
2017,Eric Bledsoe,PG,27,PHO,66,2176,449,1034,104,310,345,724,388,458,1390
2017,Bojan Bogdanovic,SF,27,TOT,81,2083,376,845,144,392,232,453,217,243,1113
2017,Bojan Bogdanovic,SF,27,BRK,55,1482,269,611,99,277,170,334,146,167,783
2017,Bojan Bogdanovic,SF,27,WAS,26,601,107,234,45,115,62,119,71,76,330
2017,Andrew Bogut,C,32,TOT,27,583,38,81,0,1,38,80,3,11,79
2017,Andrew Bogut,C,32,DAL,26,582,38,81,0,1,38,80,3,11,79
2017,Andrew Bogut,C,32,CLE,1,1,0,0,0,0,0,0,0,0,0
2017,Joel Bolomboy,PF,23,UTA,12,53,9,16,1,4,8,12,3,6,22
2017,Devin Booker,SG,20,PHO,78,2730,606,1431,147,405,459,1026,367,441,1726
2017,Trevor Booker,PF,29,BRK,71,1754,305,591,25,78,280,513,74,110,709
2017,Avery Bradley,SG,26,BOS,55,1835,359,775,108,277,251,498,68,93,894
2017,Corey Brewer,SF,30,TOT,82,1281,147,348,27,118,120,230,50,68,371
2017,Corey Brewer,SF,30,HOU,58,923,94,227,22,94,72,133,32,44,242
2017,Corey Brewer,SF,30,LAL,24,358,53,121,5,24,48,97,18,24,129
2017,Malcolm Brogdon,SG,24,MIL,75,1982,290,635,78,193,212,442,109,126,767
2017,Aaron Brooks,PG,32,IND,65,894,121,300,48,128,73,172,32,40,322
2017,Anthony Brown,SF,24,TOT,11,159,18,50,7,27,11,23,0,0,43
2017,Anthony Brown,SF,24,NOP,9,143,14,41,6,24,8,17,0,0,34
2017,Anthony Brown,SF,24,ORL,2,16,4,9,1,3,3,6,0,0,9
2017,Bobby Brown,PG,32,HOU,25,123,23,60,14,35,9,25,2,2,62
2017,Jaylen Brown,SF,20,BOS,78,1341,192,423,46,135,146,288,85,124,515
2017,Nicolas Brussino,SF,23,DAL,54,521,52,141,29,95,23,46,17,22,150
2017,Reggie Bullock,SF,25,DET,31,467,54,128,28,73,26,55,5,7,141
2017,Trey Burke,PG,24,WAS,57,703,116,255,31,70,85,185,22,29,285
2017,Alec Burks,SG,25,UTA,42,653,99,248,25,76,74,172,60,78,283
2017,Jimmy Butler,SF,27,CHI,76,2809,570,1252,91,248,479,1004,585,676,1816
2017,Bruno Caboclo,SF,21,TOR,9,40,6,16,2,6,4,10,0,0,14
2017,Jose Calderon,PG,35,TOT,41,539,55,134,20,64,35,70,11,12,141
2017,Jose Calderon,PG,35,LAL,24,292,32,77,12,34,20,43,4,4,80
2017,Jose Calderon,PG,35,ATL,17,247,23,57,8,30,15,27,7,8,61
2017,Kentavious Caldwell-Pope,SG,23,DET,76,2529,370,928,153,437,217,491,154,185,1047
2017,Isaiah Canaan,SG,25,CHI,39,592,63,173,25,94,38,79,30,33,181
2017,Clint Capela,C,22,HOU,65,1551,362,563,0,0,362,563,94,177,818
2017,DeMarre Carroll,SF,30,TOR,72,1882,220,549,109,320,111,229,89,117,638
2017,Vince Carter,SF,40,MEM,73,1799,193,490,112,296,81,194,88,115,586
2017,Michael Carter-Williams,PG,25,CHI,45,846,112,306,15,64,97,242,58,77,297
2017,Omri Casspi,SF,28,TOT,36,643,77,165,15,43,62,122,17,29,186
2017,Omri Casspi,SF,28,SAC,22,397,53,117,11,29,42,88,12,21,129
2017,Omri Casspi,SF,28,NOP,1,24,5,9,2,4,3,5,0,0,12
2017,Omri Casspi,SF,28,MIN,13,222,19,39,2,10,17,29,5,8,45
2017,Willie Cauley-Stein,C,23,SAC,75,1421,255,481,0,2,255,479,101,151,611
2017,Tyson Chandler,C,34,PHO,47,1298,153,228,0,0,153,228,91,124,397
2017,Wilson Chandler,SF,29,DEN,71,2197,433,939,110,326,323,613,141,194,1117
2017,Marquese Chriss,PF,19,PHO,82,1743,284,632,72,224,212,408,113,181,753
2017,Rakeem Christmas,PF,25,IND,29,219,19,43,0,0,19,43,21,29,59
2017,Semaj Christon,PG,24,OKC,64,973,77,223,12,63,65,160,17,31,183
2017,Ian Clark,SG,25,GSW,77,1137,211,433,61,163,150,270,44,58,527
2017,Jordan Clarkson,SG,24,LAL,82,2397,477,1071,117,356,360,715,134,168,1205
2017,Norris Cole,PG,28,OKC,13,125,16,52,3,13,13,39,8,10,43
2017,Darren Collison,PG,29,SAC,68,2063,340,714,73,175,267,539,147,171,900
2017,Nick Collison,PF,36,OKC,20,128,14,23,0,1,14,22,5,8,33
2017,Mike Conley,PG,29,MEM,69,2292,464,1009,171,419,293,590,316,368,1415
2017,Pat Connaughton,SG,24,POR,39,316,37,72,17,33,20,39,7,9,98
2017,Quinn Cook,PG,23,TOT,14,188,33,66,11,26,22,40,2,5,79
2017,Quinn Cook,PG,23,DAL,5,77,11,25,5,14,6,11,0,2,27
2017,Quinn Cook,PG,23,NOP,9,111,22,41,6,12,16,29,2,3,52
2017,DeMarcus Cousins,C,26,TOT,72,2465,647,1433,131,364,516,1069,517,670,1942
2017,DeMarcus Cousins,C,26,SAC,55,1891,505,1119,95,268,410,851,423,549,1528
2017,DeMarcus Cousins,C,26,NOP,17,574,142,314,36,96,106,218,94,121,414
2017,Robert Covington,SF,26,PHI,67,2119,292,732,137,412,155,320,143,174,864
2017,Allen Crabbe,SG,24,POR,79,2254,303,647,134,302,169,345,105,124,845
2017,Jamal Crawford,SG,36,LAC,82,2157,359,869,116,322,243,547,174,203,1008
2017,Jordan Crawford,SG,28,NOP,19,442,105,218,37,95,68,123,20,26,267
2017,Jae Crowder,SF,26,BOS,72,2335,333,720,157,394,176,326,176,217,999
2017,Dante Cunningham,SF,29,NOP,66,1649,174,359,71,181,103,178,16,27,435
2017,Seth Curry,PG,26,DAL,70,2029,338,703,137,322,201,381,85,100,898
2017,Stephen Curry,PG,28,GSW,79,2638,675,1443,324,789,351,654,325,362,1999
2017,Troy Daniels,SG,25,MEM,67,1183,185,495,138,355,47,140,43,54,551
2017,Anthony Davis,C,23,NOP,75,2708,770,1527,40,134,730,1393,519,647,2099
2017,Deyonta Davis,C,20,MEM,36,238,24,47,0,0,24,47,10,18,58
2017,Ed Davis,PF,27,POR,46,789,75,142,0,0,75,142,50,81,200
2017,Dewayne Dedmon,C,27,SAS,76,1330,161,259,0,0,161,259,65,93,387
2017,Sam Dekker,SF,22,HOU,77,1419,203,429,60,187,143,242,38,68,504
2017,Malcolm Delaney,PG,27,ATL,73,1248,145,388,26,110,119,278,75,93,391
2017,Matthew Dellavedova,PG,26,MIL,76,1986,208,534,79,215,129,319,82,96,577
2017,Luol Deng,SF,31,LAL,56,1486,164,424,51,165,113,259,46,63,425
2017,DeMar DeRozan,SG,27,TOR,74,2620,721,1545,33,124,688,1421,545,647,2020
2017,Cheick Diallo,PF,20,NOP,17,199,36,76,0,0,36,76,15,21,87
2017,Boris Diaw,PF,34,UTA,73,1283,146,327,20,81,126,246,26,35,338
2017,Gorgui Dieng,PF,27,MIN,82,2653,332,661,16,43,316,618,136,167,816
2017,Spencer Dinwiddie,PG,23,BRK,59,1334,134,302,38,101,96,201,126,159,432
2017,Toney Douglas,PG,30,MEM,24,394,43,117,7,42,36,75,24,29,117
2017,Goran Dragic,PG,30,MIA,73,2459,534,1124,117,289,417,835,298,377,1483
2017,Andre Drummond,C,23,DET,81,2409,483,911,2,7,481,904,137,355,1105
2017,Jared Dudley,PF,31,PHO,64,1362,157,346,77,203,80,143,43,65,434
2017,Mike Dunleavy,SF,36,TOT,53,841,93,220,53,134,40,86,36,45,275
2017,Mike Dunleavy,SF,36,CLE,23,366,36,90,20,57,16,33,14,19,106
2017,Mike Dunleavy,SF,36,ATL,30,475,57,130,33,77,24,53,22,26,169
2017,Kris Dunn,PG,22,MIN,78,1333,118,313,21,73,97,240,36,59,293
2017,Kevin Durant,SF,28,GSW,62,2070,551,1026,117,312,434,714,336,384,1555
2017,Jarell Eddie,SF,25,PHO,5,62,6,19,4,16,2,3,8,9,24
2017,Henry Ellenson,PF,20,DET,19,146,23,64,10,35,13,29,4,8,60
2017,Wayne Ellington,SG,29,MIA,62,1500,231,555,149,394,82,161,37,43,648
2017,Monta Ellis,SG,31,IND,74,1998,247,557,43,135,204,422,93,128,630
2017,Joel Embiid,C,22,PHI,31,786,200,429,36,98,164,331,191,244,627
2017,James Ennis,SF,26,MEM,64,1501,146,321,51,137,95,184,86,110,429
2017,Tyler Ennis,PG,22,TOT,53,588,90,208,27,70,63,138,21,25,228
2017,Tyler Ennis,PG,22,HOU,31,196,25,64,6,16,19,48,2,3,58
2017,Tyler Ennis,PG,22,LAL,22,392,65,144,21,54,44,90,19,22,170
2017,Tyreke Evans,SF,27,TOT,40,788,150,370,42,118,108,252,69,92,411
2017,Tyreke Evans,SF,27,NOP,26,474,91,227,21,70,70,157,45,58,248
2017,Tyreke Evans,SF,27,SAC,14,314,59,143,21,48,38,95,24,34,163
2017,Dante Exum,PG,21,UTA,66,1228,155,363,44,149,111,214,58,73,412
2017,Kenneth Faried,PF,27,DEN,61,1296,228,416,0,6,228,410,131,189,587
2017,Jordan Farmar,PG,30,SAC,2,35,4,12,4,9,0,3,0,0,12
2017,Derrick Favors,PF,25,UTA,50,1186,203,417,3,10,200,407,67,109,476
2017,Kay Felder,PG,21,CLE,42,386,62,158,7,22,55,136,35,49,166
2017,Cristiano Felicio,C,24,CHI,66,1040,128,222,0,0,128,222,60,93,316
2017,Raymond Felton,PG,32,LAC,80,1700,221,514,46,144,175,370,50,64,538
2017,Yogi Ferrell,PG,23,TOT,46,1197,160,394,68,176,92,218,74,89,462
2017,Yogi Ferrell,PG,23,BRK,10,151,18,49,8,27,10,22,10,16,54
2017,Yogi Ferrell,PG,23,DAL,36,1046,142,345,60,149,82,196,64,73,408
2017,Dorian Finney-Smith,PF,23,DAL,81,1642,124,333,56,191,68,142,46,61,350
2017,Bryn Forbes,SG,23,SAS,36,285,36,99,17,53,19,46,5,6,94
2017,Evan Fournier,SG,24,ORL,68,2234,408,930,128,360,280,570,223,277,1167
2017,Randy Foye,SG,33,BRK,69,1284,118,325,67,203,51,122,54,63,357
2017,Tim Frazier,PG,26,NOP,65,1525,163,404,40,128,123,276,98,129,464
2017,Channing Frye,C,33,CLE,74,1398,238,520,137,335,101,185,63,74,676
2017,Danilo Gallinari,SF,28,DEN,63,2134,335,750,126,324,209,426,349,387,1145
2017,Langston Galloway,PG,25,TOT,74,1495,207,545,120,308,87,237,51,64,585
2017,Langston Galloway,PG,25,NOP,55,1120,165,441,101,268,64,173,40,52,471
2017,Langston Galloway,PG,25,SAC,19,375,42,104,19,40,23,64,11,12,114
2017,Patricio Garino,SG,23,ORL,5,43,0,7,0,5,0,2,0,0,0
2017,Marc Gasol,C,32,MEM,74,2531,532,1160,104,268,428,892,278,332,1446
2017,Pau Gasol,C,36,SAS,64,1627,303,604,56,104,247,500,130,184,792
2017,Rudy Gay,SF,30,SAC,30,1013,201,442,42,113,159,329,118,138,562
2017,Michael Gbinije,SG,24,DET,9,32,1,10,0,4,1,6,2,2,4
2017,Alonzo Gee,SF,29,DEN,13,89,3,14,0,3,3,11,5,9,11
2017,Paul George,SF,26,IND,75,2689,622,1349,195,496,427,853,336,374,1775
2017,Marcus Georges-Hunt,SG,22,ORL,5,48,2,7,1,2,1,5,9,10,14
2017,Jonathan Gibson,PG,29,DAL,17,231,35,95,15,45,20,50,21,29,106
2017,Taj Gibson,PF,31,TOT,78,1989,365,709,3,13,362,696,113,158,846
2017,Taj Gibson,PF,31,CHI,55,1502,276,530,2,12,274,518,85,119,639
2017,Taj Gibson,PF,31,OKC,23,487,89,179,1,1,88,178,28,39,207
2017,Manu Ginobili,SG,39,SAS,69,1291,171,439,89,227,82,212,86,107,517
2017,Rudy Gobert,C,24,UTA,81,2744,413,624,0,1,413,623,311,476,1137
2017,Archie Goodwin,SG,22,TOT,15,214,36,66,5,15,31,51,33,42,110
2017,Archie Goodwin,SG,22,NOP,3,30,2,5,1,2,1,3,10,10,15
2017,Archie Goodwin,SG,22,BRK,12,184,34,61,4,13,30,48,23,32,95
2017,Aaron Gordon,SF,21,ORL,80,2298,393,865,77,267,316,598,156,217,1019
2017,Eric Gordon,SG,28,HOU,75,2323,412,1016,246,661,166,355,147,175,1217
2017,Marcin Gortat,C,32,WAS,82,2556,390,674,0,2,390,672,103,159,883
2017,Treveon Graham,SG,23,CHO,27,189,19,40,9,15,10,25,10,15,57
2017,Jerami Grant,SF,22,TOT,80,1531,152,328,43,116,109,212,90,147,437
2017,Jerami Grant,SF,22,PHI,2,41,6,17,0,2,6,15,4,8,16
2017,Jerami Grant,SF,22,OKC,78,1490,146,311,43,114,103,197,86,139,421
2017,Jerian Grant,PG,24,CHI,63,1028,128,301,49,134,79,167,65,73,370
2017,Danny Green,SG,29,SAS,68,1807,176,449,118,311,58,138,27,32,497
2017,Draymond Green,PF,26,GSW,76,2471,272,650,81,263,191,387,151,213,776
2017,Gerald Green,SF,31,BOS,47,538,95,232,39,111,56,121,33,41,262
2017,JaMychal Green,PF,26,MEM,77,2101,250,500,55,145,195,355,134,167,689
2017,Jeff Green,PF,30,ORL,69,1534,220,558,53,193,167,365,145,168,638
2017,Blake Griffin,PF,27,LAC,61,2076,479,971,38,113,441,858,320,421,1316
2017,Justin Hamilton,C,26,BRK,64,1177,174,379,55,181,119,198,39,52,442
2017,A.J. Hammons,C,24,DAL,22,163,17,42,5,10,12,32,9,20,48
2017,Tim Hardaway,SG,24,ATL,79,2154,415,912,149,417,266,495,164,214,1143
2017,James Harden,PG,27,HOU,81,2947,674,1533,262,756,412,777,746,881,2356
2017,Maurice Harkless,SF,23,POR,77,2223,314,624,68,194,246,430,77,124,773
2017,Justin Harper,PF,27,PHI,3,31,5,12,2,7,3,5,0,0,12
2017,Montrezl Harrell,C,23,HOU,58,1064,225,345,1,7,224,338,76,121,527
2017,Devin Harris,PG,33,DAL,65,1087,136,341,58,177,78,164,107,129,437
2017,Gary Harris,SG,22,DEN,57,1782,320,637,107,255,213,382,104,134,851
2017,Joe Harris,SG,25,BRK,52,1138,154,362,85,221,69,141,35,49,428
2017,Manny Harris,SG,27,DAL,4,25,3,15,0,2,3,13,2,4,8
2017,Tobias Harris,PF,24,DET,82,2567,511,1063,109,314,402,749,190,226,1321
2017,Aaron Harrison,SG,22,CHO,5,17,0,4,0,2,0,2,1,2,1
2017,Andrew Harrison,PG,22,MEM,72,1474,117,360,43,156,74,204,148,194,425
2017,Udonis Haslem,C,36,MIA,17,130,11,23,0,3,11,20,9,15,31
2017,Spencer Hawes,PF,28,TOT,54,797,134,277,25,81,109,196,44,52,337
2017,Spencer Hawes,PF,28,CHO,35,626,104,218,16,55,88,163,30,34,254
2017,Spencer Hawes,PF,28,MIL,19,171,30,59,9,26,21,33,14,18,83
2017,Gordon Hayward,SF,26,UTA,73,2516,545,1156,149,374,396,782,362,429,1601
2017,Gerald Henderson,SG,29,PHI,72,1667,234,553,61,173,173,380,133,165,662
2017,John Henson,C,26,MIL,58,1123,159,309,0,1,159,308,74,107,392
2017,Juan Hernangomez,PF,21,DEN,62,842,101,224,46,113,55,111,57,76,305
2017,Willy Hernangomez,C,22,NYK,72,1324,246,465,4,15,242,450,91,125,587
2017,Mario Hezonja,SF,21,ORL,65,960,117,330,43,144,74,186,40,50,317
2017,Roy Hibbert,C,30,TOT,48,682,80,147,0,0,80,147,61,75,221
2017,Roy Hibbert,C,30,CHO,42,671,78,144,0,0,78,144,61,75,217
2017,Roy Hibbert,C,30,DEN,6,11,2,3,0,0,2,3,0,0,4
2017,Buddy Hield,SG,23,TOT,82,1888,327,768,148,379,179,389,64,76,866
2017,Buddy Hield,SG,23,NOP,57,1161,185,472,89,241,96,231,29,33,488
2017,Buddy Hield,SG,23,SAC,25,727,142,296,59,138,83,158,35,43,378
2017,Nene Hilario,C,34,HOU,67,1198,245,397,3,9,242,388,116,197,609
2017,George Hill,PG,30,UTA,49,1544,289,606,94,233,195,373,157,196,829
2017,Jordan Hill,C,29,MIN,7,47,5,13,0,0,5,13,2,2,12
2017,Solomon Hill,SF,25,NOP,80,2374,183,477,94,270,89,207,103,128,563
2017,Darrun Hilliard,SG,23,DET,39,381,47,126,12,46,35,80,21,28,127
2017,Jrue Holiday,PG,26,NOP,67,2190,405,894,100,281,305,613,119,168,1029
2017,Justin Holiday,SG,27,NYK,82,1639,233,538,97,273,136,265,66,80,629
2017,Rondae Hollis-Jefferson,SF,22,BRK,78,1761,235,542,15,67,220,475,190,253,675
2017,Richaun Holmes,C,23,PHI,57,1193,230,412,27,77,203,335,72,103,559
2017,Rodney Hood,SG,24,UTA,59,1593,272,666,114,307,158,359,90,115,748
2017,Al Horford,C,30,BOS,68,2193,379,801,86,242,293,559,108,135,952
2017,Danuel House,SG,23,WAS,1,1,0,0,0,0,0,0,0,0,0
2017,Dwight Howard,C,31,ATL,74,2199,388,613,0,2,388,611,226,424,1002
2017,Marcelo Huertas,PG,33,LAL,23,237,25,68,4,19,21,49,9,17,63
2017,Josh Huestis,PF,25,OKC,2,31,6,11,2,4,4,7,0,1,14
2017,Kris Humphries,PF,31,ATL,56,689,87,214,19,54,68,160,64,82,257
2017,R.J. Hunter,SG,23,CHI,3,9,0,1,0,1,0,0,0,0,0
2017,Serge Ibaka,PF,27,TOT,79,2422,471,982,124,317,347,665,107,125,1173
2017,Serge Ibaka,PF,27,ORL,56,1710,343,703,83,214,260,489,77,91,846
2017,Serge Ibaka,PF,27,TOR,23,712,128,279,41,103,87,176,30,34,327
2017,Andre Iguodala,SF,33,GSW,76,1998,219,415,64,177,155,238,72,102,574
2017,Ersan Ilyasova,PF,29,TOT,82,2142,384,890,142,402,242,488,161,207,1071
2017,Ersan Ilyasova,PF,29,OKC,3,62,6,16,3,12,3,4,0,0,15
2017,Ersan Ilyasova,PF,29,PHI,53,1447,285,648,107,298,178,350,109,142,786
2017,Ersan Ilyasova,PF,29,ATL,26,633,93,226,32,92,61,134,52,65,270
2017,Joe Ingles,SF,29,UTA,82,1972,204,451,123,279,81,172,50,68,581
2017,Brandon Ingram,SF,19,LAL,79,2279,276,686,55,187,221,499,133,214,740
2017,Kyrie Irving,PG,24,CLE,72,2525,671,1420,177,441,494,979,297,328,1816
2017,Jarrett Jack,PG,33,NOP,2,33,2,3,0,1,2,2,2,2,6
2017,Demetrius Jackson,PG,22,BOS,5,17,3,4,1,1,2,3,3,6,10
2017,Pierre Jackson,PG,25,DAL,8,84,13,39,3,11,10,28,6,7,35
2017,Reggie Jackson,PG,26,DET,52,1424,284,677,66,184,218,493,118,136,752
2017,LeBron James,SF,32,CLE,74,2794,736,1344,124,342,612,1002,358,531,1954
2017,Al Jefferson,C,32,IND,66,931,235,471,0,1,235,470,65,85,535
2017,Richard Jefferson,SF,36,CLE,79,1614,153,343,62,186,91,157,80,108,448
2017,John Jenkins,SG,25,PHO,4,13,2,5,1,2,1,3,2,2,7
2017,Brandon Jennings,PG,27,TOT,81,1802,192,535,79,252,113,283,114,152,577
2017,Brandon Jennings,PG,27,NYK,58,1428,163,429,68,200,95,229,102,135,496
2017,Brandon Jennings,PG,27,WAS,23,374,29,106,11,52,18,54,12,17,81
2017,Jonas Jerebko,PF,29,BOS,78,1232,114,262,45,130,69,132,26,37,299
2017,Amir Johnson,PF,29,BOS,80,1608,213,370,27,66,186,304,67,100,520
2017,Brice Johnson,PF,22,LAC,3,9,2,7,0,0,2,7,0,0,4
2017,James Johnson,PF,29,MIA,76,2085,368,769,87,256,281,513,152,215,975
2017,Joe Johnson,SF,35,UTA,78,1843,273,626,106,258,167,368,63,77,715
2017,Stanley Johnson,SF,20,DET,77,1371,129,365,45,154,84,211,36,53,339
2017,Tyler Johnson,PG,24,MIA,73,2178,357,824,93,250,264,574,195,254,1002
2017,Wesley Johnson,SF,29,LAC,68,810,73,200,29,118,44,82,11,17,186
2017,Nikola Jokic,C,21,DEN,73,2038,494,854,45,139,449,715,188,228,1221
2017,Dahntay Jones,SF,36,CLE,1,12,3,8,0,2,3,6,3,4,9
2017,Damian Jones,C,21,GSW,10,85,8,16,0,0,8,16,3,10,19
2017,Derrick Jones,SF,19,PHO,32,545,68,121,3,11,65,110,29,41,168
2017,James Jones,SF,36,CLE,48,381,44,92,31,66,13,26,13,20,132
2017,Terrence Jones,PF,25,TOT,54,1270,231,491,19,75,212,416,103,170,584
2017,Terrence Jones,PF,25,NOP,51,1264,231,488,19,75,212,413,103,170,584
2017,Terrence Jones,PF,25,MIL,3,6,0,3,0,0,0,3,0,0,0
2017,Tyus Jones,PG,20,MIN,60,774,75,181,26,73,49,108,33,43,209
2017,DeAndre Jordan,C,28,LAC,81,2570,412,577,0,2,412,575,205,425,1029
2017,Cory Joseph,SG,25,TOR,80,2003,299,661,48,135,251,526,94,122,740
2017,Frank Kaminsky,C,23,CHO,75,1954,320,802,116,354,204,448,118,156,874
2017,Enes Kanter,C,24,OKC,72,1533,402,737,5,38,397,699,224,285,1033
2017,Ryan Kelly,PF,25,ATL,16,110,8,28,4,10,4,18,5,6,25
2017,Michael Kidd-Gilchrist,SF,23,CHO,81,2349,295,618,1,9,294,609,152,194,743
2017,Sean Kilpatrick,SG,27,BRK,70,1754,305,735,105,308,200,427,204,242,919
2017,Brandon Knight,SG,25,PHO,54,1140,209,525,45,139,164,386,132,154,595
2017,Kyle Korver,SG,35,TOT,67,1753,239,515,162,359,77,156,38,42,678
2017,Kyle Korver,SG,35,ATL,32,894,108,246,65,159,43,87,24,27,305
2017,Kyle Korver,SG,35,CLE,35,859,131,269,97,200,34,69,14,15,373
2017,Kosta Koufos,C,27,SAC,71,1419,216,392,0,1,216,391,38,62,470
2017,Mindaugas Kuzminskas,SF,27,NYK,68,1016,158,369,54,168,104,201,55,68,425
2017,Skal Labissiere,PF,20,SAC,33,612,117,218,3,8,114,210,52,74,289
2017,Jeremy Lamb,SG,24,CHO,62,1143,226,491,41,146,185,345,110,129,603
2017,Nicolas Laprovittola,PG,27,SAS,18,174,20,47,10,27,10,20,9,9,59
2017,Joffrey Lauvergne,PF-C,25,TOT,70,980,148,336,33,98,115,238,46,73,375
2017,Joffrey Lauvergne,PF,25,OKC,50,739,111,244,27,78,84,166,37,58,286
2017,Joffrey Lauvergne,C,25,CHI,20,241,37,92,6,20,31,72,9,15,89
2017,Zach LaVine,SG,21,MIN,47,1749,326,710,120,310,206,400,117,140,889
2017,Ty Lawson,PG,29,SAC,69,1732,237,522,34,118,203,404,173,217,681
2017,Jake Layman,SF,22,POR,35,249,26,89,13,51,13,38,13,17,78
2017,Courtney Lee,SG,31,NYK,77,2459,321,704,108,269,213,435,85,98,835
2017,David Lee,PF,33,SAS,79,1477,248,420,0,0,248,420,80,113,576
2017,Alex Len,C,23,PHO,77,1560,230,463,3,12,227,451,150,208,613
2017,Kawhi Leonard,SF,25,SAS,74,2474,636,1311,147,386,489,925,469,533,1888
2017,Meyers Leonard,PF,24,POR,74,1222,146,378,74,213,72,165,35,40,401
2017,Jon Leuer,PF,27,DET,75,1944,310,646,49,167,261,479,98,113,767
2017,Caris LeVert,SF,22,BRK,57,1237,171,380,59,184,112,196,67,93,468
2017,DeAndre Liggins,SG,28,TOT,62,777,55,142,17,46,38,96,25,40,152
2017,DeAndre Liggins,SG,28,CLE,61,752,52,136,17,45,35,91,23,37,144
2017,DeAndre Liggins,SG,28,DAL,1,25,3,6,0,1,3,5,2,3,8
2017,Damian Lillard,PG,26,POR,75,2694,661,1488,214,578,447,910,488,545,2024
2017,Jeremy Lin,PG,28,BRK,36,883,175,400,58,156,117,244,115,141,523
2017,Shaun Livingston,PG,31,GSW,76,1345,173,316,1,3,172,313,42,60,389
2017,Shawn Long,C,24,PHI,18,234,61,109,7,19,54,90,19,35,148
2017,Kevon Looney,C,20,GSW,53,447,56,107,2,9,54,98,21,34,135
2017,Brook Lopez,C,28,BRK,75,2222,555,1172,134,387,421,785,295,364,1539
2017,Robin Lopez,C,28,CHI,81,2271,382,775,0,2,382,773,75,104,839
2017,Kevin Love,PF,28,CLE,60,1885,370,867,145,389,225,478,257,295,1142
2017,Kyle Lowry,PG,30,TOR,60,2244,426,918,193,468,233,450,299,365,1344
2017,John Lucas,PG,34,MIN,5,11,1,4,0,1,1,3,0,0,2
2017,Timothe Luwawu-Cabarrot,SF,21,PHI,69,1190,145,361,50,161,95,200,105,123,445
2017,Trey Lyles,PF,21,UTA,71,1158,159,439,65,204,94,235,57,79,440
2017,Shelvin Mack,PG,26,UTA,55,1205,170,381,37,120,133,261,53,77,430
2017,Ian Mahinmi,C,30,WAS,31,555,65,111,0,0,65,111,43,75,173
2017,Thon Maker,C,19,MIL,57,562,83,181,28,74,55,107,32,49,226
2017,Boban Marjanovic,C,28,DET,35,293,72,132,0,0,72,132,47,58,191
2017,Jarell Martin,PF,22,MEM,42,558,58,151,9,25,49,126,40,50,165
2017,Wesley Matthews,SG,30,DAL,73,2495,333,847,174,479,159,368,146,179,986
2017,Luc Mbah,SF,30,LAC,80,1787,191,378,43,110,148,268,59,87,484
2017,James Michael,PF,24,GSW,52,457,62,117,2,8,60,109,21,42,147
2017,Patrick McCaw,SG,21,GSW,71,1074,106,245,41,123,65,122,29,37,282
2017,Sheldon McClellan,SG,24,WAS,30,287,30,75,7,30,23,45,23,27,90
2017,C.J. McCollum,SG,25,POR,80,2796,692,1441,185,440,507,1001,268,294,1837
2017,T.J. McConnell,PG,24,PHI,81,2133,236,512,11,55,225,457,73,90,556
2017,Chris McCullough,PF,21,TOT,16,80,16,32,1,7,15,25,3,5,36
2017,Chris McCullough,PF,21,BRK,14,72,16,31,1,6,15,25,2,3,35
2017,Chris McCullough,PF,21,WAS,2,8,0,1,0,1,0,0,1,2,1
2017,K.J. McDaniels,SF,23,TOT,49,505,77,169,20,66,57,103,32,38,206
2017,K.J. McDaniels,SF,23,HOU,29,212,31,68,9,27,22,41,9,10,80
2017,K.J. McDaniels,SF,23,BRK,20,293,46,101,11,39,35,62,23,28,126
2017,Doug McDermott,SF,25,TOT,66,1508,222,497,77,207,145,290,71,84,592
2017,Doug McDermott,SF,25,CHI,44,1078,166,373,56,149,110,224,59,67,447
2017,Doug McDermott,SF,25,OKC,22,430,56,124,21,58,35,66,12,17,145
2017,JaVale McGee,C,29,GSW,77,739,208,319,0,4,208,315,56,111,472
2017,Rodney McGruder,SG,25,MIA,78,1966,190,460,73,220,117,240,44,71,497
2017,Ben McLemore,SG,23,SAC,61,1176,180,419,65,170,115,249,70,93,495
2017,Jordan McRae,SG,25,CLE,37,384,58,150,18,51,40,99,27,34,161
2017,Josh McRoberts,PF,29,MIA,22,381,44,118,13,31,31,87,6,9,107
2017,Jodie Meeks,SG,29,ORL,36,738,103,256,56,137,47,119,65,74,327
2017,Salah Mejri,C,30,DAL,73,905,88,137,1,3,87,134,36,61,213
2017,Jordan Mickey,PF,22,BOS,25,141,15,34,0,1,15,33,8,14,38
2017,Khris Middleton,SF,25,MIL,29,889,150,333,45,104,105,229,81,92,426
2017,C.J. Miles,SF,29,IND,76,1776,281,647,169,409,112,238,84,93,815
2017,Mike Miller,SF,36,DEN,20,151,9,23,8,20,1,3,2,2,28
2017,Patty Mills,PG,28,SAS,80,1754,273,622,147,356,126,266,66,80,759
2017,Elijah Millsap,SG,29,PHO,2,23,1,7,0,2,1,5,1,2,3
2017,Paul Millsap,PF,31,ATL,69,2343,430,972,75,241,355,731,311,405,1246
2017,Nikola Mirotic,PF,25,CHI,70,1679,258,625,129,377,129,248,99,128,744
2017,Greg Monroe,C,26,MIL,81,1823,387,726,0,4,387,722,177,239,951
2017,E'Twaun Moore,SG,27,NOP,73,1820,283,619,77,208,206,411,57,74,700
2017,Marcus Morris,SF,27,DET,79,2565,421,1007,118,357,303,650,145,185,1105
2017,Markieff Morris,PF,27,WAS,76,2374,406,889,71,196,335,693,180,215,1063
2017,Anthony Morrow,SG,31,TOT,49,714,98,252,41,133,57,119,34,37,271
2017,Anthony Morrow,SG,31,OKC,40,627,86,223,35,119,51,104,23,26,230
2017,Anthony Morrow,SG,31,CHI,9,87,12,29,6,14,6,15,11,11,41
2017,Donatas Motiejunas,PF,26,NOP,34,479,57,138,11,47,46,91,25,49,150
2017,Timofey Mozgov,C,30,LAL,54,1104,169,328,0,1,169,327,63,78,401
2017,Emmanuel Mudiay,PG,20,DEN,55,1406,208,551,56,178,152,373,131,167,603
2017,Shabazz Muhammad,SF,24,MIN,78,1516,288,598,49,146,239,452,147,190,772
2017,Dejounte Murray,PG,20,SAS,38,322,50,116,9,23,41,93,21,30,130
2017,Jamal Murray,SG,19,DEN,82,1764,295,730,115,344,180,386,106,120,811
2017,Mike Muscala,C,25,ATL,70,1237,170,337,46,110,124,227,49,64,435
2017,Larry Nance,PF,24,LAL,63,1442,190,361,10,36,180,325,59,80,449
2017,Shabazz Napier,PG,25,POR,53,512,73,183,34,92,39,91,38,49,218
2017,Maurice Ndour,PF,24,NYK,32,331,39,86,1,7,38,79,19,26,98
2017,Gary Neal,SG,32,ATL,2,18,0,7,0,2,0,5,4,4,4
2017,Jameer Nelson,PG,34,DEN,75,2045,268,604,106,273,162,331,45,63,687
2017,Raul Neto,PG,24,UTA,40,346,41,91,10,31,31,60,8,9,100
2017,Georges Niang,PF,23,IND,23,93,9,36,1,12,8,24,2,2,21
2017,Andrew Nicholson,PF,27,TOT,38,342,43,111,5,27,38,84,9,14,100
2017,Andrew Nicholson,PF,27,WAS,28,231,30,77,3,16,27,61,7,12,70
2017,Andrew Nicholson,PF,27,BRK,10,111,13,34,2,11,11,23,2,2,30
2017,Joakim Noah,C,31,NYK,46,1015,99,201,0,1,99,200,34,78,232
2017,Nerlens Noel,C,22,TOT,51,1047,184,309,0,1,184,308,77,111,445
2017,Nerlens Noel,C,22,PHI,29,564,107,175,0,1,107,174,43,63,257
2017,Nerlens Noel,C,22,DAL,22,483,77,134,0,0,77,134,34,48,188
2017,Lucas Nogueira,C,24,TOR,57,1088,103,156,3,12,100,144,44,67,253
2017,Steve Novak,PF,33,MIL,8,22,2,7,1,6,1,1,0,0,5
2017,Dirk Nowitzki,PF,38,DAL,54,1424,296,678,79,209,217,469,98,112,769
2017,Jusuf Nurkic,C,22,TOT,65,1391,271,534,0,1,271,533,120,210,662
2017,Jusuf Nurkic,C,22,DEN,45,807,151,298,0,0,151,298,56,113,358
2017,Jusuf Nurkic,C,22,POR,20,584,120,236,0,1,120,235,64,97,304
2017,David Nwaba,SG,24,LAL,20,397,47,81,1,5,46,76,25,39,120
2017,Johnny O'Bryant,PF,23,TOT,11,80,15,30,3,6,12,24,5,6,38
2017,Johnny O'Bryant,PF,23,DEN,7,46,7,15,2,3,5,12,4,4,20
2017,Johnny O'Bryant,PF,23,CHO,4,34,8,15,1,3,7,12,1,2,18
2017,Kyle O'Quinn,C,26,NYK,79,1229,215,413,2,17,213,396,64,83,496
2017,Daniel Ochefu,C,23,WAS,19,75,12,27,0,0,12,27,0,2,24
2017,Jahlil Okafor,C,21,PHI,50,1134,242,471,0,0,242,471,106,158,590
2017,Victor Oladipo,SG,24,OKC,67,2222,412,932,127,352,285,580,116,154,1067
2017,Kelly Olynyk,C,25,BOS,75,1538,260,508,68,192,192,316,90,123,678
2017,Arinze Onuaku,C,29,ORL,8,28,2,4,0,0,2,4,0,0,4
2017,Chinanu Onuaku,C,20,HOU,5,52,5,7,0,0,5,7,4,4,14
2017,Kelly Oubre,SF,21,WAS,79,1605,186,442,54,188,132,254,75,99,501
2017,Zaza Pachulia,C,32,GSW,70,1268,164,307,0,2,164,305,98,126,426
2017,Georgios Papagiannis,C,19,SAC,22,355,56,102,0,2,56,100,12,14,124
2017,Jabari Parker,PF,21,MIL,51,1728,399,814,65,178,334,636,162,218,1025
2017,Tony Parker,PG,34,SAS,63,1587,265,569,23,69,242,500,85,117,638
2017,Chandler Parsons,SF,28,MEM,34,675,75,222,25,93,50,129,35,43,210
2017,Lamar Patterson,SG,25,ATL,5,40,3,15,1,6,2,9,2,3,9
2017,Patrick Patterson,PF,27,TOR,65,1599,154,384,94,253,60,131,43,60,445
2017,Chris Paul,PG,31,LAC,61,1921,374,785,124,302,250,483,232,260,1104
2017,Adreian Payne,PF,25,MIN,18,135,23,54,3,15,20,39,14,19,63
2017,Cameron Payne,PG,22,TOT,31,462,64,193,27,86,37,107,5,8,160
2017,Cameron Payne,PG,22,OKC,20,320,43,130,16,52,27,78,4,4,106
2017,Cameron Payne,PG,22,CHI,11,142,21,63,11,34,10,29,1,4,54
2017,Elfrid Payton,PG,22,ORL,82,2412,430,912,40,146,390,766,146,211,1046
2017,Gary Payton,PG,24,MIL,6,99,8,22,1,9,7,13,3,5,20
2017,Paul Pierce,SF,39,LAC,25,277,28,70,15,43,13,27,10,13,81
2017,Marshall Plumlee,C,24,NYK,21,170,16,30,0,0,16,30,8,19,40
2017,Mason Plumlee,C,26,TOT,81,2148,334,623,0,6,334,617,174,300,842
2017,Mason Plumlee,C,26,POR,54,1516,235,442,0,5,235,437,127,224,597
2017,Mason Plumlee,C,26,DEN,27,632,99,181,0,1,99,180,47,76,245
2017,Miles Plumlee,C,28,TOT,45,484,44,92,0,0,44,92,25,39,113
2017,Miles Plumlee,C,28,MIL,32,310,30,68,0,0,30,68,22,35,82
2017,Miles Plumlee,C,28,CHO,13,174,14,24,0,0,14,24,3,4,31
2017,Jakob Poeltl,C,21,TOR,54,626,67,115,0,0,67,115,31,57,165
2017,Otto Porter,SF,23,WAS,80,2605,414,803,148,341,266,462,99,119,1075
2017,Bobby Portis,PF,21,CHI,64,1000,183,375,32,96,151,279,39,59,437
2017,Kristaps Porzingis,PF,21,NYK,66,2164,443,985,112,314,331,671,198,252,1196
2017,Dwight Powell,C,25,DAL,77,1333,194,377,21,74,173,303,107,141,516
2017,Norman Powell,SG,23,TOR,76,1368,227,506,56,173,171,333,126,159,636
2017,Alex Poythress,PF,23,PHI,6,157,25,54,6,19,19,35,8,10,64
2017,Ronnie Price,PG,33,PHO,14,134,4,24,3,17,1,7,3,4,14
2017,Tim Quarterman,SG,22,POR,16,80,13,29,5,13,8,16,0,3,31
2017,Chasson Randle,PG,23,TOT,26,299,40,98,16,47,24,51,41,43,137
2017,Chasson Randle,PG,23,PHI,8,74,12,26,6,15,6,11,12,12,42
2017,Chasson Randle,PG,23,NYK,18,225,28,72,10,32,18,40,29,31,95
2017,Julius Randle,PF,22,LAL,74,2132,377,773,17,63,360,710,204,282,975
2017,Zach Randolph,PF,35,MEM,73,1786,433,964,21,94,412,870,141,193,1028
2017,J.J. Redick,SG,32,LAC,78,2198,396,890,201,468,195,422,180,202,1173
2017,Willie Reed,C,26,MIA,71,1031,162,285,1,4,161,281,49,88,374
2017,Josh Richardson,SG,23,MIA,53,1614,202,513,75,227,127,286,60,77,539
2017,Malachi Richardson,SG,21,SAC,22,198,28,68,8,28,20,40,15,19,79
2017,Austin Rivers,SG,24,LAC,74,2054,323,731,111,299,212,432,132,191,889
2017,Andre Roberson,SF,25,OKC,79,2376,215,463,45,184,170,279,47,111,522
2017,Brian Roberts,PG,31,CHO,41,416,46,122,17,44,29,78,33,39,142
2017,Glenn Robinson,SF,23,IND,69,1426,158,338,49,125,109,213,54,76,419
2017,Thomas Robinson,PF,25,LAL,48,560,105,196,0,1,105,195,31,66,241
2017,Sergio Rodriguez,PG,30,PHI,68,1518,210,536,92,252,118,284,18,27,530
2017,Rajon Rondo,PG,30,CHI,69,1843,229,561,50,133,179,428,30,50,538
2017,Derrick Rose,PG,28,NYK,64,2082,460,977,13,60,447,917,221,253,1154
2017,Terrence Ross,SF,25,TOT,78,1955,326,746,142,391,184,355,64,77,858
2017,Terrence Ross,SF,25,TOR,54,1207,211,479,96,256,115,223,41,50,559
2017,Terrence Ross,SF,25,ORL,24,748,115,267,46,135,69,132,23,27,299
2017,Terry Rozier,PG,22,BOS,74,1263,151,411,57,179,94,232,51,66,410
2017,Ricky Rubio,PG,26,MIN,75,2469,261,650,60,196,201,454,254,285,836
2017,Damjan Rudez,SF,30,ORL,45,314,31,88,20,64,11,24,0,0,82
2017,Brandon Rush,SG,31,MIN,47,1030,70,187,44,114,26,73,13,18,197
2017,D'Angelo Russell,PG,20,LAL,63,1811,351,867,135,384,216,483,147,188,984
2017,Domantas Sabonis,PF,20,OKC,81,1632,192,481,51,159,141,322,44,67,479
2017,Larry Sanders,C,28,CLE,5,13,1,4,0,0,1,4,2,2,4
2017,Dario Saric,PF,22,PHI,81,2129,381,927,106,341,275,586,172,220,1040
2017,Tomas Satoransky,SG,25,WAS,57,719,61,146,9,37,52,109,23,33,154
2017,Dennis Schroder,PG,23,ATL,79,2485,548,1215,100,294,448,921,218,255,1414
2017,Luis Scola,PF,36,BRK,36,461,71,151,17,50,54,101,25,37,184
2017,Mike Scott,PF,28,ATL,18,195,17,59,4,27,13,32,7,8,45
2017,Thabo Sefolosha,SF,32,ATL,62,1596,174,395,41,120,133,275,55,75,444
2017,Wayne Selden,SG,22,TOT,14,236,25,58,7,28,18,30,14,22,71
2017,Wayne Selden,SG,22,NOP,3,47,5,8,4,7,1,1,2,4,16
2017,Wayne Selden,SG,22,MEM,11,189,20,50,3,21,17,29,12,18,55
2017,Kevin Seraphin,PF,27,IND,49,559,109,198,0,2,109,196,14,22,232
2017,Ramon Sessions,PG,30,CHO,50,811,100,263,21,62,79,201,91,118,312
2017,Iman Shumpert,SG,26,CLE,76,1937,201,489,94,261,107,228,71,90,567
2017,Pascal Siakam,PF,22,TOR,55,859,103,205,1,7,102,198,22,32,229
2017,Jonathon Simmons,SG,27,SAS,78,1392,177,421,30,102,147,319,99,132,483
2017,Kyle Singler,SF,28,OKC,32,385,34,83,7,37,27,46,13,17,88
2017,Marcus Smart,SG,22,BOS,79,2399,269,749,94,332,175,417,203,250,835
2017,Ish Smith,PG,28,DET,81,1955,329,749,28,105,301,644,72,102,758
2017,J.R. Smith,SG,31,CLE,41,1187,123,356,95,271,28,85,10,15,351
2017,Jason Smith,C,30,WAS,74,1068,174,329,37,78,137,251,35,51,420
2017,Tony Snell,SG,25,MIL,80,2336,246,541,144,355,102,186,47,58,683
2017,Marreese Speights,C,29,LAC,82,1286,244,548,103,277,141,271,120,137,711
2017,Tiago Splitter,C,32,PHI,8,76,14,31,2,6,12,25,9,11,39
2017,Nik Stauskas,SG,23,PHI,80,2188,251,634,132,359,119,275,122,150,756
2017,Lance Stephenson,SG,26,TOT,18,361,54,120,6,20,48,100,8,13,122
2017,Lance Stephenson,SG,26,NOP,6,162,26,55,1,10,25,45,5,8,58
2017,Lance Stephenson,SG,26,MIN,6,67,10,21,0,2,10,19,1,2,21
2017,Lance Stephenson,SG,26,IND,6,132,18,44,5,8,13,36,2,3,43
2017,Jarnell Stokes,C,23,DEN,2,7,1,1,0,0,1,1,1,2,3
2017,Diamond Stone,C,19,LAC,7,24,3,13,0,0,3,13,4,4,10
2017,Rodney Stuckey,PG,30,IND,39,696,91,244,19,60,72,184,80,107,281
2017,Jared Sullinger,PF,24,TOR,11,118,15,48,3,18,12,30,4,8,37
2017,Edy Tavares,C,24,TOT,2,28,4,5,0,0,4,5,0,3,8
2017,Edy Tavares,C,24,ATL,1,4,1,1,0,0,1,1,0,2,2
2017,Edy Tavares,C,24,CLE,1,24,3,4,0,0,3,4,0,1,6
2017,Isaiah Taylor,PG,22,HOU,4,52,1,7,0,2,1,5,1,2,3
2017,Jeff Teague,PG,28,IND,82,2657,402,909,90,252,312,657,360,415,1254
2017,Mirza Teletovic,PF,31,MIL,70,1133,156,418,104,305,52,113,35,45,451
2017,Garrett Temple,SG,30,SAC,65,1728,183,432,82,220,101,212,58,74,506
2017,Jason Terry,SG,39,MIL,74,1365,105,243,73,171,32,72,24,29,307
2017,Isaiah Thomas,PG,27,BOS,76,2569,682,1473,245,646,437,827,590,649,2199
2017,Lance Thomas,PF,28,NYK,46,968,97,244,38,85,59,159,43,51,275
2017,Hollis Thompson,SG,25,TOT,40,752,77,200,32,95,45,105,19,29,205
2017,Hollis Thompson,SG,25,PHI,31,561,66,159,26,71,40,88,13,20,171
2017,Hollis Thompson,SG,25,NOP,9,191,11,41,6,24,5,17,6,9,34
2017,Klay Thompson,SG,26,GSW,78,2649,644,1376,268,647,376,729,186,218,1742
2017,Tristan Thompson,C,25,CLE,78,2336,262,437,0,3,262,434,106,213,630
2017,Marcus Thornton,SG,29,WAS,33,575,84,210,28,80,56,130,23,27,219
2017,Mike Tobey,C,22,CHO,2,25,1,4,0,0,1,4,0,0,2
2017,Anthony Tolliver,PF,31,SAC,65,1477,155,351,90,230,65,121,61,82,461
2017,Axel Toupane,SF,24,TOT,4,47,5,9,1,4,4,5,0,0,11
2017,Axel Toupane,SF,24,MIL,2,6,0,1,0,1,0,0,0,0,0
2017,Axel Toupane,SF,24,NOP,2,41,5,8,1,3,4,5,0,0,11
2017,Karl-Anthony Towns,C,21,MIN,82,3030,802,1479,101,275,701,1204,356,428,2061
2017,P.J. Tucker,SF,31,TOT,81,2236,199,482,70,196,129,286,72,93,540
2017,P.J. Tucker,SF,31,PHO,57,1627,147,354,46,136,101,218,61,77,401
2017,P.J. Tucker,SF,31,TOR,24,609,52,128,24,60,28,68,11,16,139
2017,Evan Turner,SF,28,POR,65,1658,235,552,31,118,204,434,85,103,586
2017,Myles Turner,C,20,IND,81,2541,444,869,40,115,404,754,245,303,1173
2017,Beno Udrih,PG,34,DET,39,560,92,197,11,32,81,165,32,34,227
2017,Tyler Ulis,PG,21,PHO,61,1123,184,437,21,79,163,358,55,71,444
2017,Jarrod Uthoff,PF,23,DAL,9,115,16,38,3,9,13,29,5,7,40
2017,Jonas Valanciunas,C,24,TOR,80,2066,391,702,1,2,390,700,176,217,959
2017,Denzel Valentine,SG,23,CHI,57,976,102,288,73,208,29,80,14,18,291
2017,Fred VanVleet,PG,22,TOR,37,294,39,111,11,29,28,82,18,22,107
2017,Anderson Varejao,C,34,GSW,14,92,5,14,0,0,5,14,8,11,18
2017,Greivis Vasquez,PG,30,BRK,3,39,2,8,1,3,1,5,2,3,7
2017,Rashad Vaughn,SG,20,MIL,41,458,57,156,26,81,31,75,2,5,142
2017,Noah Vonleh,PF,21,POR,74,1265,130,270,7,20,123,250,60,94,327
2017,Nikola Vucevic,C,26,ORL,75,2163,483,1031,23,75,460,956,107,160,1096
2017,Sasha Vujacic,SG,32,NYK,42,408,42,136,23,74,19,62,17,24,124
2017,Dwyane Wade,SG,35,CHI,60,1792,414,955,45,145,369,810,223,281,1096
2017,Dion Waiters,SG,25,MIA,46,1384,281,663,85,215,196,448,82,127,729
2017,Kemba Walker,PG,26,CHO,79,2739,643,1449,240,602,403,847,304,359,1830
2017,John Wall,PG,26,WAS,78,2836,647,1435,89,272,558,1163,422,527,1805
2017,Taurean Waller-Prince,SF,22,ATL,59,981,114,285,33,102,81,183,74,94,335
2017,T.J. Warren,SF,23,PHO,66,2048,403,814,26,98,377,716,119,154,951
2017,C.J. Watson,PG,32,ORL,62,1012,96,248,32,105,64,143,57,66,281
2017,Briante Weber,PG,24,TOT,20,205,25,60,1,10,24,50,11,16,62
2017,Briante Weber,PG,24,GSW,7,46,5,14,0,3,5,11,2,3,12
2017,Briante Weber,PG,24,CHO,13,159,20,46,1,7,19,39,9,13,50
2017,David West,C,36,GSW,68,854,135,252,3,8,132,244,43,56,316
2017,Russell Westbrook,PG,28,OKC,81,2802,824,1941,200,583,624,1358,710,840,2558
2017,Okaro White,PF,24,MIA,35,471,33,87,12,34,21,53,20,22,98
2017,Isaiah Whitehead,PG,21,BRK,73,1643,204,508,44,149,160,359,91,113,543
2017,Hassan Whiteside,C,27,MIA,77,2513,542,973,0,0,542,973,225,358,1309
2017,Andrew Wiggins,SF,21,MIN,82,3048,709,1570,103,289,606,1281,412,542,1933
2017,C.J. Wilcox,SG,26,ORL,22,108,8,31,3,15,5,16,2,2,21
2017,Alan Williams,C,24,PHO,47,708,138,267,0,1,138,266,70,112,346
2017,Deron Williams,PG,32,TOT,64,1657,263,600,85,234,178,366,90,109,701
2017,Deron Williams,PG,32,DAL,40,1171,195,453,63,181,132,272,69,84,522
2017,Deron Williams,PG,32,CLE,24,486,68,147,22,53,46,94,21,25,179
2017,Derrick Williams,PF,25,TOT,50,804,108,244,30,97,78,147,58,89,304
2017,Derrick Williams,PF,25,MIA,25,377,54,137,9,45,45,92,31,50,148
2017,Derrick Williams,PF,25,CLE,25,427,54,107,21,52,33,55,27,39,156
2017,Lou Williams,SG,30,TOT,81,1994,428,998,163,446,265,552,402,457,1421
2017,Lou Williams,SG,30,LAL,58,1403,326,734,122,317,204,417,304,344,1078
2017,Lou Williams,SG,30,HOU,23,591,102,264,41,129,61,135,98,113,343
2017,Marvin Williams,PF,30,CHO,76,2295,297,704,124,354,173,350,131,150,849
2017,Reggie Williams,SF,30,NOP,6,79,8,23,5,11,3,12,6,7,27
2017,Troy Williams,SF,22,TOT,30,557,73,167,18,62,55,105,21,32,185
2017,Troy Williams,SF,22,MEM,24,418,51,123,10,41,41,82,15,25,127
2017,Troy Williams,SF,22,HOU,6,139,22,44,8,21,14,23,6,7,58
2017,Kyle Wiltjer,PF,24,HOU,14,44,4,14,4,13,0,1,1,2,13
2017,Justise Winslow,SF,20,MIA,18,625,80,225,7,35,73,190,29,47,196
2017,Jeff Withey,C,26,UTA,51,432,55,103,0,1,55,102,36,48,146
2017,Christian Wood,PF,21,CHO,13,107,12,23,0,5,12,18,11,15,35
2017,Metta World,SF,37,LAL,25,160,19,68,9,38,10,30,10,16,57
2017,Brandan Wright,PF,29,MEM,28,447,83,135,0,1,83,134,23,35,189
2017,Delon Wright,PG,24,TOR,27,446,49,116,10,30,39,86,42,55,150
2017,James Young,SG,21,BOS,29,220,25,58,12,35,13,23,6,9,68
2017,Joe Young,PG,24,IND,33,135,26,72,5,23,21,49,11,15,68
2017,Nick Young,SG,31,LAL,60,1556,272,633,170,421,102,212,77,90,791
2017,Thaddeus Young,PF,28,IND,74,2237,362,687,45,118,317,569,45,86,814
2017,Cody Zeller,PF,24,CHO,62,1725,253,443,0,1,253,442,133,196,639
2017,Tyler Zeller,C,27,BOS,51,525,78,158,0,1,78,157,22,39,178
2017,Stephen Zimmerman,C,20,ORL,19,108,10,31,0,0,10,31,3,5,23
2017,Paul Zipser,SF,22,CHI,44,843,88,221,33,99,55,122,31,40,240
2017,Ivica Zubac,C,19,LAL,38,609,126,238,0,3,126,235,32,49,284